Ngày,Thay đổi,Số lệnh mua,Kl mua,KLTB 1 lệnh mua,Số lệnh bán,Kl bán,KLTB 1 lệnh bán,Kl ròng
2025-05-09,0 ( 0 %),0,0,0,0,0,0,0
2025-05-07,13.15 ( 2.73 %),0,0,0,0,0,0,0
2025-05-06,12.8 ( -4.48 %),0,0,0,0,0,0,0
2025-05-05,13.4 ( 2.29 %),0,0,0,0,0,0,0
2025-04-29,13.1 ( -1.5 %),2009,21907400,10904.63,3447,29634000,8597,-7726600
2025-04-28,13.3 ( 6.83 %),3928,64006100,16294.83,6272,34888300,5563,29117800
2025-04-25,12.45 ( 1.63 %),1611,17180800,10664.68,3788,25857400,6826,-8676600
2025-04-24,12.25 ( 2.08 %),2082,17109500,8217.82,3821,19724600,5162,-2615100
2025-04-23,12 ( 1.27 %),1552,8603300,5543.36,1999,13345800,6676,-4742500
2025-04-22,11.85 ( -1.25 %),5701,28087500,4926.77,3345,29793100,8907,-1705600
2025-04-21,12 ( -3.23 %),3917,17465200,4458.82,1860,29679700,15957,-12214500
2025-04-18,12.4 ( 0 %),1833,13366600,7292.2,2657,21265000,8003,-7898400
2025-04-17,12.4 ( -0.8 %),2130,11566600,5430.33,2351,17681500,7521,-6114900
2025-04-16,12.5 ( 2.88 %),2674,24540500,9177.45,4614,23166400,5021,1374100
2025-04-15,12.15 ( 6.58 %),2927,31657900,10815.82,2218,13339600,6014,18318300
2025-04-14,11.4 ( 2.24 %),2202,10275300,4666.35,1621,11639900,7181,-1364600
2025-04-11,11.15 ( 6.7 %),3145,20118600,6397.01,1615,13303000,8237,6815600
2025-04-10,10.45 ( 6.52 %),2853,18504300,6485.91,82,244300,2979,18260000
2025-04-09,9.81 ( -4.29 %),4514,21984900,4870.38,2186,19062300,8720,2922600
2025-04-08,10.25 ( -6.82 %),1394,5859200,4203.16,1297,26802200,20665,-20943000
2025-04-04,11 ( -4.76 %),3125,25892700,8285.66,2457,28783500,11715,-2890800
2025-04-03,11.55 ( -6.85 %),2953,19988100,6768.74,2239,29911000,13359,-9922900
2025-04-02,12.4 ( 0.81 %),1199,4637500,3867.81,957,4241200,4432,396300
2025-04-01,12.3 ( 0.82 %),1075,6955800,6470.51,1157,6098600,5271,857200
2025-03-31,12.2 ( -1.61 %),2212,12877400,5821.61,1338,13096500,9788,-219100
2025-03-28,12.4 ( -1.59 %),1622,5786900,3567.76,1662,12062000,7258,-6275100
2025-03-27,12.6 ( -0.79 %),1003,5033000,5017.95,1784,11346100,6360,-6313100
2025-03-26,12.7 ( 0 %),2156,18695900,8671.57,4712,26191700,5559,-7495800
2025-03-25,12.7 ( 2.83 %),1921,22195000,11553.88,3399,17942800,5279,4252200
2025-03-24,12.35 ( 0 %),1830,15900300,8688.69,2682,18699200,6972,-2798900
2025-03-21,12.35 ( -0.4 %),945,10128100,10717.57,1548,15023700,9705,-4895600
2025-03-20,12.4 ( 0 %),1657,17570600,10603.86,1472,12291300,8350,5279300
2025-03-19,12.4 ( -0.8 %),2790,14718500,5275.45,1390,11636200,8371,3082300
2025-03-18,12.5 ( 0.4 %),1474,16822500,11412.82,1631,9709300,5953,7113200
2025-03-17,12.45 ( 0 %),1711,8219000,4803.62,1328,7718800,5812,500200
2025-03-14,12.45 ( 0.81 %),1784,8802700,4934.25,1304,6648500,5099,2154200
2025-03-12,12.7 ( 1.6 %),2401,29350900,12224.45,3441,20263700,5889,9087200
2025-03-11,12.5 ( -0.4 %),2198,8079200,3675.71,1435,7752100,5402,327100
2025-03-10,12.55 ( 0 %),1833,7484500,4083.2,1658,11114500,6704,-3630000
2025-03-07,0 ( 0 %),1768,10751800,6081.33,1843,13269000,7200,-2517200
2025-03-06,12.55 ( 0.4 %),2465,12460300,5054.89,1598,11217500,7020,1242800
2025-03-05,12.5 ( -1.19 %),2010,8104100,4031.89,1492,11511800,7716,-3407700
2025-03-04,12.65 ( -0.39 %),3269,24406300,7465.98,1966,28619200,14557,-4212900
2025-03-03,12.7 ( -2.31 %),3509,26487200,7548.36,2350,28487800,12122,-2000600
2025-02-28,13 ( -1.89 %),2443,11272300,4614.12,2325,15824000,6806,-4551700
2025-02-27,13.25 ( 4.33 %),3637,27534100,7570.55,2964,43410700,14646,-15876600
2025-02-26,12.7 ( -2.31 %),2117,20050600,9471.23,2529,21501200,8502,-1450600
2025-02-25,13 ( 0 %),1661,14892500,8965.98,2611,17397400,6663,-2504900
2025-02-24,13 ( 0.39 %),2171,23438200,10796.04,4443,21929900,4936,1508300
2025-02-21,12.95 ( 1.57 %),1859,22989500,12366.59,2448,16321300,6667,6668200
2025-02-20,12.75 ( 0 %),1324,22097700,16690.11,2609,15246200,5844,6851500
2025-02-19,12.75 ( 1.19 %),1270,15905000,12523.62,3118,15618400,5009,286600
2025-02-18,12.6 ( 1.2 %),1365,21108500,15464.1,4078,18494000,4535,2614500
2025-02-17,12.45 ( 0.4 %),1525,9866100,6469.57,2961,15615600,5274,-5749500
2025-02-14,12.4 ( 0 %),1036,9624800,9290.35,1935,10085100,5212,-460300
2025-02-13,12.4 ( 0.81 %),1204,12068600,10023.75,1679,10024400,5970,2044200
2025-02-12,12.3 ( -1.99 %),1113,7251000,6514.82,1997,10728600,5372,-3477600
2025-02-11,12.55 ( 0.8 %),1156,12481900,10797.49,3062,13320900,4350,-839000
2025-02-10,12.45 ( 1.22 %),1592,17475800,10977.26,3303,19004500,5754,-1528700
2025-02-07,12.3 ( 2.5 %),1194,14046600,11764.32,2797,14522700,5192,-476100
2025-02-06,12 ( 0 %),1284,15983500,12448.21,2338,17680800,7562,-1697300
2025-02-05,12 ( 0.84 %),1216,16333300,13431.99,2063,19240100,9326,-2906800
2025-02-04,11.9 ( 0.42 %),1745,7405100,4243.61,1488,10553200,7092,-3148100
2025-02-03,0 ( 0 %),2781,19716400,7089.68,1520,12450000,8191,7266400
2025-01-24,12.2 ( 0 %),1008,10685200,10600.4,2174,10015600,4607,669600
2025-01-23,12.2 ( 0.83 %),1061,6116300,5764.66,1889,9186600,4863,-3070300
2025-01-22,12.1 ( 1.26 %),1952,9847400,5044.77,3743,16743100,4473,-6895700
2025-01-21,11.95 ( 1.27 %),972,6739100,6933.23,1928,8575300,4448,-1836200
2025-01-20,11.8 ( 0 %),1023,7384500,7218.48,1375,8010100,5826,-625600
2025-01-17,11.8 ( 0.43 %),785,7269900,9261.02,1608,7701300,4789,-431400
2025-01-16,11.75 ( 0.86 %),1223,10786300,8819.54,1795,10767500,5999,18800
2025-01-15,11.65 ( 0.87 %),1600,10109900,6318.69,1170,6067300,5186,4042600
2025-01-14,11.55 ( -2.12 %),1270,5067800,3990.39,1238,7970900,6439,-2903100
2025-01-13,11.8 ( 1.29 %),1888,16471100,8724.1,1390,11922800,8578,4548300
2025-01-10,11.65 ( -2.51 %),1384,9454900,6831.58,1528,8872000,5806,582900
2025-01-09,11.95 ( 0.84 %),1050,5527400,5264.19,1539,7663400,4979,-2136000
2025-01-08,11.85 ( 1.72 %),1837,12461700,6783.72,2190,11533800,5267,927900
2025-01-07,11.65 ( 0.43 %),1657,11102200,6700.18,1510,16992300,11253,-5890100
2025-01-06,11.6 ( -2.11 %),2169,7847900,3618.21,1647,9039400,5488,-1191500
2025-01-03,11.85 ( -3.66 %),3887,12429800,3197.79,1706,15290100,8963,-2860300
2025-01-02,12.3 ( 2.07 %),2392,13245100,5537.25,3132,14983600,4784,-1738500
2024-12-31,12.05 ( 0.42 %),2741,19399500,7077.53,1926,14204000,7375,5195500
2024-12-30,12 ( 0 %),2645,10652700,4027.49,1623,9893100,6096,759600
2024-12-27,12 ( -4 %),6409,29270000,4567.02,3120,40001200,12821,-10731200
2024-12-26,12.5 ( 0 %),1544,11527700,7466.13,1994,12921100,6480,-1393400
2024-12-25,12.5 ( -1.96 %),2622,13463400,5134.78,2901,17067600,5883,-3604200
2024-12-24,12.75 ( -0.78 %),2276,16078900,7064.54,3702,18035200,4872,-1956300
2024-12-23,12.85 ( 4.9 %),3232,18574500,5747.06,3849,16642300,4324,1932200
2024-12-20,12.25 ( -0.81 %),2666,19544600,7331.06,2481,14637900,5900,4906700
2024-12-19,12.35 ( -0.4 %),3422,17724600,5179.6,1878,15744800,8384,1979800
2024-12-18,12.4 ( -0.4 %),3602,29286600,8130.65,3353,21901500,6532,7385100
2024-12-17,12.45 ( -0.4 %),1927,10385800,5389.62,1800,8997000,4998,1388800
2024-12-16,12.5 ( 0.81 %),1638,9994700,6101.77,2502,12853200,5137,-2858500
2024-12-13,12.4 ( 0 %),1937,9967200,5145.69,2434,13277200,5455,-3310000
2024-12-12,12.4 ( -0.8 %),1712,8730900,5099.82,2079,10145500,4880,-1414600
2024-12-11,12.5 ( 0.4 %),2833,14556900,5138.33,2609,13746600,5269,810300
2024-12-10,12.45 ( -1.19 %),3581,22060800,6160.51,2529,17148800,6781,4912000
2024-12-09,12.6 ( 5.88 %),5613,61192000,10901.84,5807,40740300,7016,20451700
2024-12-06,11.9 ( 1.71 %),2895,25477100,8800.38,4995,30529200,6112,-5052100
2024-12-05,11.7 ( 2.63 %),2672,13028200,4875.82,2135,12928300,6055,99900
2024-12-04,11.4 ( -3.39 %),2627,11494800,4375.64,1926,21994900,11420,-10500100
2024-12-03,11.8 ( 1.29 %),1663,8054500,4843.36,1656,16022700,9676,-7968200
2024-12-02,11.65 ( -2.51 %),2628,12343700,4696.99,2441,18188600,7451,-5844900
2024-11-29,11.95 ( 0 %),2353,17400200,7394.9,2149,15924900,7410,1475300
2024-11-28,11.95 ( 1.7 %),1821,13167400,7230.86,3222,17163600,5327,-3996200
2024-11-27,11.75 ( -3.29 %),3168,16047300,5065.44,2412,17894500,7419,-1847200
2024-11-26,12.15 ( 0.41 %),1877,14015800,7467.13,3124,17204600,5507,-3188800
2024-11-25,12.1 ( 3.42 %),1593,13280400,8336.72,2483,14075900,5669,-795500
2024-11-22,11.7 ( 0.43 %),2989,32961000,11027.43,4950,29590700,5978,3370300
2024-11-21,11.65 ( 0 %),1454,9742700,6700.62,1567,10077900,6431,-335200
2024-11-20,11.65 ( 2.19 %),1838,15849100,8623.01,2926,14856000,5077,993100
2024-11-19,11.4 ( 0 %),2075,19713100,9500.29,2725,15807000,5801,3906100
2024-11-18,11.4 ( -3.39 %),2509,17454100,6956.6,2996,17589500,5871,-135400
2024-11-14,11.75 ( 3.98 %),3086,38193600,12376.41,5870,31194900,5314,6998700
2024-11-13,11.3 ( 0.89 %),3049,20724600,6797.18,5441,31129400,5721,-10404800
2024-11-12,11.2 ( 6.67 %),3780,43746700,11573.2,6471,37748000,5833,5998700
2024-11-11,10.5 ( 1.45 %),1465,11572600,7899.39,1682,9909900,5892,1662700
2024-11-08,10.35 ( -0.48 %),1275,7504700,5886.04,1439,10205300,7092,-2700600
2024-11-07,10.4 ( -0.48 %),1297,6841400,5274.79,1510,9836600,6514,-2995200
2024-11-06,0 ( 0 %),1696,8028100,4733.55,1389,8223700,5921,-195600
2024-11-05,10.35 ( 0.49 %),1213,4317200,3559.11,1436,6080300,4234,-1763100
2024-11-04,10.3 ( 0.49 %),1493,9187900,6153.99,1714,10390400,6062,-1202500
2024-11-01,10.25 ( -0.97 %),1536,5757100,3748.11,1130,7663900,6782,-1906800
2024-10-31,10.35 ( 0 %),1075,6012000,5592.56,1519,8288700,5457,-2276700
2024-10-30,10.35 ( 1.47 %),1693,12062600,7124.99,2321,13570600,5847,-1508000
2024-10-29,10.2 ( 0.49 %),1798,6322700,3516.52,1131,6562500,5802,-239800
2024-10-28,10.15 ( 0 %),3151,10695700,3394.38,1079,8771100,8129,1924600
2024-10-25,10.15 ( -3.79 %),4963,20164300,4062.93,1691,20584300,12173,-420000
2024-10-24,10.55 ( -1.4 %),1776,16782400,9449.55,1734,13752300,7931,3030100
2024-10-23,10.7 ( 1.9 %),2171,13342200,6145.65,1661,11059600,6658,2282600
2024-10-22,10.5 ( -0.94 %),2147,9885400,4604.29,1270,10542400,8301,-657000
2024-10-21,10.6 ( 0 %),1942,6671700,3435.48,1204,8989800,7467,-2318100
2024-10-18,10.6 ( -1.85 %),1951,10951500,5613.28,1474,11431100,7755,-479600
2024-10-17,10.8 ( 0 %),3149,18561000,5894.25,1312,13191900,10055,5369100
2024-10-16,10.8 ( -1.82 %),2046,10117600,4945.06,1418,10611900,7484,-494300
2024-10-15,11 ( 0 %),1908,21758100,11403.62,2728,19260700,7060,2497400
2024-10-14,11 ( 0 %),1341,9391300,7003.21,1558,9616900,6173,-225600
2024-10-11,11 ( 0 %),1504,7169200,4766.76,1560,9171600,5879,-2002400
2024-10-10,11 ( -0.45 %),1893,26932600,14227.47,3597,22895000,6365,4037600
2024-10-09,11.05 ( 1.38 %),1260,18527100,14704.05,2635,14850000,5636,3677100
2024-10-08,10.9 ( 0 %),1653,12780200,7731.52,1946,9360500,4810,3419700
2024-10-07,10.9 ( -2.68 %),2425,19942600,8223.75,2204,15478600,7023,4464000
2024-10-04,11.2 ( 6.16 %),3431,32709100,9533.4,4247,30063300,7079,2645800
2024-10-03,10.55 ( -3.21 %),2224,14967800,6730.13,2527,18667300,7387,-3699500
2024-10-02,10.9 ( -2.24 %),1987,10860000,5465.53,2338,14717100,6295,-3857100
2024-10-01,11.15 ( 2.76 %),2406,24813500,10313.18,4567,23377500,5119,1436000
2024-09-30,10.85 ( 1.88 %),1567,13144700,8388.45,2317,11419500,4929,1725200
2024-09-27,10.65 ( 0 %),1856,11895200,6409.05,2553,15261500,5978,-3366300
2024-09-26,10.65 ( 0 %),2126,15360500,7225.07,4730,20827700,4403,-5467200
2024-09-25,10.65 ( 1.43 %),1771,14288800,8068.21,3191,16159200,5064,-1870400
2024-09-24,10.5 ( 0.96 %),1577,5779700,3665,1487,7772300,5227,-1992600
2024-09-23,10.4 ( -2.8 %),2799,9602300,3430.62,1302,12022800,9234,-2420500
2024-09-20,10.7 ( 1.42 %),1866,11808400,6328.19,2966,13520100,4558,-1711700
2024-09-19,10.55 ( 0 %),1477,6128900,4149.56,2262,12357700,5463,-6228800
2024-09-18,10.55 ( 0.96 %),1693,10402700,6144.54,3005,16443700,5472,-6041000
2024-09-17,10.45 ( 0.97 %),1722,6670400,3873.64,1441,9015500,6256,-2345100
2024-09-16,10.35 ( -0.96 %),1554,6861600,4415.44,1878,11451200,6098,-4589600
2024-09-13,10.45 ( 0 %),2055,6698400,3259.56,1446,10477600,7246,-3779200
2024-09-12,10.45 ( -1.42 %),1562,6858000,4390.52,1791,9825300,5486,-2967300
2024-09-11,10.6 ( -0.47 %),2003,8137900,4062.86,1964,10894800,5547,-2756900
2024-09-10,10.65 ( 2.4 %),3740,19016800,5084.71,5637,25839200,4584,-6822400
2024-09-09,10.4 ( 1.46 %),2057,7792900,3788.48,1645,8054400,4896,-261500
2024-09-06,10.25 ( 0.49 %),2585,9658800,3736.48,1653,8438900,5105,1219900
2024-09-05,10.2 ( -0.49 %),3111,11657100,3747.06,1752,10600400,6050,1056700
2024-09-04,10.25 ( -3.76 %),6642,21718300,3269.84,2502,21911800,8758,-193500
2024-08-30,10.65 ( -1.84 %),3695,12946400,3503.76,2115,14573300,6890,-1626900
2024-08-29,10.85 ( -1.36 %),3682,20804400,5650.3,2183,14737900,6751,6066500
2024-08-28,11 ( 4.76 %),8337,109528800,13137.68,6763,40940600,6054,68588200
2024-08-27,10.5 ( 0.48 %),2695,9660900,3584.75,1722,9378400,5446,282500
2024-08-26,10.45 ( 0.48 %),2967,23786700,8017.09,2796,13438400,4806,10348300
2024-08-23,10.4 ( -0.95 %),3431,14373300,4189.25,1659,13262300,7994,1111000
2024-08-22,10.5 ( -1.87 %),2585,7732600,2991.33,2085,10747500,5155,-3014900
2024-08-21,10.7 ( 0.94 %),2805,14361400,5119.93,2496,15808600,6334,-1447200
2024-08-20,10.6 ( 0.95 %),3499,19635100,5611.63,3759,18645100,4960,990000
2024-08-19,10.5 ( 0.96 %),2521,10258000,4069.02,2342,10228700,4368,29300
2024-08-16,10.4 ( 3.48 %),3938,26985600,6852.62,3212,14360400,4471,12625200
2024-08-15,10.05 ( 0 %),2978,17159800,5762.19,2148,16398100,7634,761700
2024-08-14,10.05 ( -3.83 %),5994,25195800,4203.5,3678,43292900,11771,-18097100
2024-08-13,10.45 ( -0.48 %),2270,7337900,3232.56,1940,12352900,6367,-5015000
2024-08-12,10.5 ( 0.48 %),2660,8449300,3176.43,1835,8834600,4814,-385300
2024-08-08,10.75 ( -6.93 %),11309,50597100,4474.06,4541,67698100,14908,-17101000
2024-08-07,11.55 ( -2.53 %),2923,13020900,4454.64,1382,10912700,7896,2108200
2024-08-06,11.85 ( 2.16 %),2555,15124200,5919.45,1661,8002000,4818,7122200
2024-08-05,11.6 ( -4.13 %),4345,16789300,3864.05,2301,19379600,8422,-2590300
2024-08-02,12.1 ( 2.54 %),3012,16925100,5619.22,2182,17771900,8145,-846800
2024-08-01,11.8 ( -2.88 %),3665,14369400,3920.71,2328,22586700,9702,-8217300
2024-07-31,12.15 ( 0 %),2988,20615300,6899.36,3742,25053000,6695,-4437700
2024-07-30,12.15 ( -2.02 %),2186,11082300,5069.67,2212,12108000,5474,-1025700
2024-07-29,12.4 ( 2.9 %),3353,40031000,11938.86,5995,31285300,5219,8745700
2024-07-26,12.05 ( 2.55 %),2316,24163300,10433.2,3546,26062200,7350,-1898900
2024-07-25,11.75 ( -0.84 %),1931,8342100,4320.09,1472,8044300,5465,297800
2024-07-24,11.85 ( 2.16 %),3446,29145800,8457.86,2755,18724800,6797,10421000
2024-07-22,11.95 ( 0 %),4489,28860200,6429.09,2972,28393100,9554,467100
2024-07-19,11.95 ( -3.24 %),3128,20215100,6462.63,3023,15537000,5140,4678100
2024-07-18,12.35 ( 4.22 %),3365,36975600,10988.29,3495,19526000,5587,17449600
2024-07-17,11.85 ( -1.66 %),3984,20801100,5221.16,3467,26032200,7509,-5231100
2024-07-16,12.05 ( 0 %),2568,8586000,3343.46,2180,13727800,6297,-5141800
2024-07-15,12.05 ( -1.23 %),2224,6826700,3069.56,2265,9565700,4223,-2739000
2024-07-12,12.2 ( 1.24 %),4606,31315000,6798.74,4543,24070300,5298,7244700
2024-07-11,0 ( 0 %),3645,11221800,3078.68,2340,12428200,5311,-1206400
2024-07-10,12 ( 0.42 %),2835,10532500,3715.17,2788,14135100,5070,-3602600
2024-07-09,11.95 ( 1.27 %),4927,30079900,6105.11,3310,20166100,6092,9913800
2024-07-08,11.8 ( -1.26 %),4414,13131500,2974.97,2576,13925700,5406,-794200
2024-07-05,11.95 ( -3.24 %),6828,29815700,4366.68,2720,27043600,9942,2772100
2024-07-04,12.35 ( 0.82 %),2597,17831000,6866,2157,16364100,7587,1466900
2024-07-03,12.25 ( -0.41 %),2860,10615000,3711.54,1815,10502500,5787,112500
2024-07-02,12.3 ( 0.82 %),2547,14103900,5537.46,2259,10286500,4554,3817400
2024-07-01,12.2 ( 0.83 %),3008,14370200,4777.33,1919,18379300,9578,-4009100
2024-06-28,12.1 ( -2.81 %),5260,24980100,4749.07,2703,35586300,13165,-10606200
2024-06-27,12.45 ( -1.97 %),3226,12722000,3943.58,2035,17244900,8474,-4522900
2024-06-26,12.7 ( 1.6 %),3066,15021600,4899.41,2818,16089200,5709,-1067600
2024-06-25,12.5 ( -0.79 %),3209,11027600,3436.46,2255,14829800,6576,-3802200
2024-06-24,12.6 ( 1.61 %),7514,40390800,5375.41,4535,38835900,8564,1554900
2024-06-21,12.4 ( -1.2 %),4815,21164000,4395.43,2590,14635800,5651,6528200
2024-06-20,12.55 ( -1.95 %),9017,50781900,5631.8,3874,36019700,9298,14762200
2024-06-19,12.8 ( -5.88 %),14930,77044000,5160.35,4388,48474900,11047,28569100
2024-06-18,13.6 ( 1.49 %),3044,14772200,4852.89,3224,11356900,3523,3415300
2024-06-17,13.4 ( 0.75 %),4735,18987700,4010.07,2746,13315300,4849,5672400
2024-06-14,13.3 ( -4.66 %),16083,60274100,3747.69,5627,77626500,13795,-17352400
2024-06-13,13.95 ( -1.76 %),5974,30738800,5145.43,3561,25748300,7231,4990500
2024-06-12,14.2 ( 0 %),3504,17045400,4864.55,3209,17014300,5302,31100
2024-06-11,14.2 ( 1.43 %),9477,32612300,3441.21,5199,37697700,7251,-5085400
2024-06-10,14 ( -2.78 %),7550,27851100,3688.89,4698,34774400,7402,-6923300
2024-06-07,14.4 ( 0.7 %),3610,20429400,5659.11,4183,22429500,5362,-2000100
2024-06-06,14.3 ( 0.35 %),4823,19233300,3987.83,3574,21650000,6058,-2416700
2024-06-05,14.25 ( -1.04 %),7409,21271100,2870.98,3744,25363200,6774,-4092100
2024-06-04,14.4 ( -4 %),8957,47158400,5264.98,5595,45680900,8165,1477500
2024-06-03,15 ( 3.45 %),5150,57383900,11142.5,7600,46653700,6139,10730200
2024-05-31,14.5 ( -1.02 %),4855,21838200,4498.08,3225,23802400,7381,-1964200
2024-05-30,14.65 ( 0.34 %),8628,46535600,5393.56,4794,42228900,8809,4306700
2024-05-29,14.6 ( -2.34 %),6055,49165800,8119.87,7338,44826100,6109,4339700
2024-05-28,14.95 ( 2.4 %),6566,60515400,9216.48,8875,54967800,6194,5547600
2024-05-27,14.6 ( 1.04 %),4169,34124400,8185.27,3364,22546300,6702,11578100
2024-05-24,14.45 ( -1.03 %),6631,57137200,8616.68,6258,53527200,8553,3610000
2024-05-23,14.6 ( 2.82 %),7558,67537600,8935.91,6080,46584900,7662,20952700
2024-05-22,14.2 ( -4.7 %),14108,67774800,4804,8018,77990400,9727,-10215600
2024-05-21,14.9 ( 1.02 %),7675,51477100,6707.11,5807,43231200,7445,8245900
2024-05-20,14.75 ( 1.03 %),9364,79566800,8497.1,6649,46799800,7039,32767000
2024-05-17,14.6 ( 6.96 %),13196,123890700,9388.5,8838,50949700,5765,72941000
2024-05-16,13.65 ( 0.74 %),4739,39994300,8439.4,4460,32971300,7393,7023000
2024-05-15,13.55 ( 0 %),3659,27501000,7515.99,4359,26411300,6059,1089700
2024-05-14,13.55 ( -1.09 %),3299,23209600,7035.34,4490,25740400,5733,-2530800
2024-05-13,13.7 ( 3.79 %),7579,58993700,7783.84,6266,43014300,6865,15979400
2024-05-10,13.2 ( -1.86 %),3230,18485400,5723.03,4859,24893000,5123,-6407600
2024-05-09,13.45 ( -0.37 %),3332,19904800,5973.83,4142,28746700,6940,-8841900
2024-05-08,13.5 ( 2.27 %),3706,45407100,12252.32,6020,43466700,7220,1940400
2024-05-07,13.2 ( 1.54 %),2486,15730700,6327.72,4804,25384000,5284,-9653300
2024-05-06,13 ( 4.42 %),2881,38478100,13355.81,5552,35330100,6363,3148000
2024-05-03,12.45 ( 1.63 %),1576,15848000,10055.84,2721,12487700,4589,3360300
2024-05-02,12.25 ( -1.21 %),1476,10143800,6872.49,1471,7558900,5139,2584900
2024-04-26,12.4 ( -0.8 %),1939,13317700,6868.33,2500,12803200,5121,514500
2024-04-25,12.5 ( 1.63 %),2051,19942900,9723.5,3646,16056500,4404,3886400
2024-04-24,12.3 ( 1.23 %),2198,13466000,6126.48,2834,14336200,5059,-870200
2024-04-23,12.15 ( 0.83 %),2386,23069100,9668.52,3348,22873400,6832,195700
2024-04-22,12.05 ( 2.12 %),2582,28650300,11096.17,2988,20160400,6747,8489900
2024-04-19,11.8 ( -0.42 %),7336,43481300,5927.11,4219,40594100,9622,2887200
2024-04-17,11.85 ( -5.95 %),8078,47940300,5934.67,2685,31614200,11774,16326100
2024-04-16,12.6 ( 0.8 %),7372,40196800,5452.63,4747,28510200,6006,11686600
2024-04-15,12.5 ( -6.72 %),8881,56390500,6349.57,6289,68245000,10851,-11854500
2024-04-12,13.4 ( 0.75 %),3710,32591500,8784.77,5988,29887900,4991,2703600
2024-04-11,13.3 ( -0.75 %),3735,21186700,5672.48,4394,23433700,5333,-2247000
2024-04-10,13.4 ( 1.9 %),6428,57956300,9016.23,10484,46817600,4466,11138700
2024-04-09,13.15 ( 1.15 %),2798,17412400,6223.16,3950,18106900,4584,-694500
2024-04-08,13 ( 0.78 %),7284,64691000,8881.25,10700,53041600,4957,11649400
2024-04-05,12.9 ( 1.98 %),4780,37039200,7748.79,6111,33912200,5549,3127000
2024-04-04,12.65 ( -1.17 %),2914,19461100,6678.48,3870,24195100,6252,-4734000
2024-04-03,12.8 ( 0.79 %),3599,37776800,10496.47,6470,34785000,5376,2991800
2024-04-02,12.7 ( 0.4 %),7076,35927100,5077.32,3797,30605000,8060,5322100
2024-04-01,12.65 ( -3.07 %),5949,32651300,5488.54,4566,30422300,6663,2229000
2024-03-29,13.05 ( 0.77 %),4167,33159800,7957.72,6452,44149300,6843,-10989500
2024-03-28,12.95 ( 3.19 %),6407,42723700,6668.28,10601,55703800,5255,-12980100
2024-03-27,12.55 ( -0.4 %),3631,10774100,2967.25,2916,14479900,4966,-3705800
2024-03-26,12.6 ( 1.2 %),3865,20765900,5372.81,4553,24506200,5382,-3740300
2024-03-25,12.45 ( 0 %),5007,21220800,4238.23,3667,22456900,6124,-1236100
2024-03-22,12.45 ( -1.97 %),7005,26064700,3720.87,4847,30561000,6305,-4496300
2024-03-21,12.7 ( 0.4 %),4046,29229800,7224.37,6696,31010800,4631,-1781000
2024-03-20,12.65 ( 6.75 %),7323,68613600,9369.6,7832,38626600,4932,29987000
2024-03-19,11.85 ( 0.85 %),4213,19103200,4534.35,2869,16234100,5658,2869100
2024-03-18,11.75 ( -4.47 %),13097,51562400,3936.96,5518,44871700,8132,6690700
2024-03-15,12.3 ( -1.6 %),5609,20922300,3730.13,3106,22881400,7367,-1959100
2024-03-14,12.5 ( 0.4 %),5420,47210400,8710.41,5220,35577000,6816,11633400
2024-03-13,12.45 ( 0.4 %),4173,30714300,7360.24,3669,24897300,6786,5817000
2024-03-12,12.4 ( 1.64 %),5416,37386100,6902.9,4484,41156000,9178,-3769900
2024-03-11,12.2 ( -2.79 %),7118,28945600,4066.54,3871,44196200,11417,-15250600
2024-03-08,12.55 ( -3.09 %),9952,36838300,3701.6,4791,44559500,9301,-7721200
2024-03-07,12.95 ( 0.39 %),4623,25265700,5465.22,5589,34177400,6115,-8911700
2024-03-06,12.95 ( -1.89 %),5429,21953700,4043.78,4744,26852900,5660,-4899200
2024-03-05,13.2 ( 3.12 %),10363,61609700,5945.16,9587,54268300,5661,7341400
2024-03-04,12.8 ( 0.79 %),7722,39500600,5115.33,8171,42662100,5221,-3161500
2024-03-01,12.7 ( -0.78 %),4647,15903000,3422.21,4596,25637400,5578,-9734400
2024-02-29,12.8 ( 1.99 %),8695,42837800,4926.72,6117,39757300,6499,3080500
2024-02-28,12.55 ( -0.79 %),5337,17466700,3272.76,4745,26767900,5641,-9301200
2024-02-27,12.65 ( 0.4 %),5171,20016900,3870.99,4928,27305400,5541,-7288500
2024-02-26,12.6 ( 3.28 %),5892,29598100,5023.44,4490,26427400,5886,3170700
2024-02-23,12.2 ( -3.17 %),8248,25224200,3058.22,4672,30793000,6591,-5568800
2024-02-22,12.6 ( -1.56 %),6804,33400700,4908.98,5662,37831700,6682,-4431000
2024-02-21,12.8 ( 1.59 %),6297,22605400,3589.87,4448,28244800,6350,-5639400
2024-02-20,12.6 ( -3.08 %),8660,23071400,2664.13,3287,27685100,8423,-4613700
2024-02-19,13 ( 1.96 %),12312,56421300,4582.63,5603,45012200,8034,11409100
2024-02-16,12.75 ( -5.2 %),18860,57975100,3073.97,5032,51945700,10323,6029400
2024-02-15,13.45 ( 2.28 %),5984,34424500,5752.76,3006,24155400,8036,10269100
2024-02-07,13.15 ( -1.13 %),0,0,0,0,0,0,0
2024-02-06,13.3 ( -0.37 %),5379,26458500,4918.85,1952,16324900,8363,10133600
2024-02-05,13.35 ( -4.64 %),8322,49487300,5946.56,5895,40163500,6813,9323800
2024-02-02,14 ( -2.44 %),4375,17462800,3991.5,2660,24579000,9240,-7116200
2024-02-01,14.35 ( 1.06 %),3354,22796000,6796.66,2672,19045500,7128,3750500
2024-01-31,14.2 ( -5.02 %),8472,40252300,4751.22,4516,40795100,9033,-542800
2024-01-30,14.95 ( 1.7 %),1965,35373300,18001.68,4002,21119300,5277,14254000
2024-01-29,14.7 ( 0 %),2443,16062700,6574.99,2757,17864100,6480,-1801400
2024-01-26,14.7 ( -0.34 %),3261,29147000,8938.06,4658,25707600,5519,3439400
2024-01-25,14.75 ( 3.15 %),2814,26854400,9543.14,5111,48479700,9485,-21625300
2024-01-24,14.3 ( -2.39 %),4432,38433000,8671.71,4661,30536500,6551,7896500
2024-01-23,14.65 ( 4.64 %),8344,65895400,7897.34,9190,48113000,5235,17782400
2024-01-22,14 ( 2.19 %),3004,27241200,9068.31,4539,25005400,5509,2235800
2024-01-19,13.7 ( 2.24 %),2352,15361800,6531.38,4926,25190700,5114,-9828900
2024-01-18,13.4 ( -0.74 %),2337,11133100,4763.84,2157,12283800,5695,-1150700
2024-01-17,13.5 ( 0 %),2998,14982900,4997.63,2216,13103600,5913,1879300
2024-01-16,13.5 ( 1.5 %),4416,20025800,4534.83,2198,15484600,7045,4541200
2024-01-15,13.3 ( -3.62 %),3682,22820600,6197.88,2987,20111500,6733,2709100
2024-01-12,13.8 ( -2.13 %),5111,24991100,4889.67,3602,25378200,7046,-387100
2024-01-11,14.1 ( 6.42 %),6702,83107400,12400.39,10570,55067000,5210,28040400
2024-01-10,13.25 ( -0.75 %),0,0,0,0,0,0,0
2024-01-09,13.35 ( 3.89 %),2921,32545000,11141.73,6889,40777300,5919,-8232300
2024-01-08,12.85 ( -1.91 %),5753,38229400,6645.12,4224,39202700,9281,-973300
2024-01-05,13.1 ( -1.5 %),10712,84050300,7846.37,5642,65367900,11586,18682400
2024-01-04,13.3 ( -2.92 %),4743,24909800,5251.91,5273,40643500,7708,-15733700
2024-01-03,13.7 ( 0.74 %),2774,26001300,9373.22,5932,32664900,5507,-6663600
2024-01-02,13.6 ( 3.03 %),3901,46919400,12027.53,6541,50669400,7746,-3750000
2023-12-29,13.2 ( -3.65 %),0,0,0,0,0,0,0
2023-12-28,13.7 ( -1.08 %),13320,79101300,5938.54,6509,82364000,12654,-3262700
2023-12-27,13.85 ( 1.47 %),4466,51686800,11573.4,6391,51885100,8118,-198300
2023-12-26,13.65 ( -0.73 %),6603,42828500,6486.22,6004,46291600,7710,-3463100
2023-12-25,13.75 ( 1.85 %),4736,59099200,12478.72,9393,59953400,6383,-854200
2023-12-22,13.5 ( 1.12 %),4766,54535500,11442.61,10031,63573700,6338,-9038200
2023-12-21,13.35 ( 6.8 %),4843,62849800,12977.45,5102,35934000,7043,26915800
2023-12-20,12.5 ( 0.81 %),11569,88341600,7636.06,7180,64959900,9047,23381700
2023-12-19,12.4 ( -6.77 %),7089,41695200,5881.68,6187,77209700,12479,-35514500
2023-12-18,13.3 ( 1.92 %),6576,65060100,9893.57,5019,48786900,9720,16273200
2023-12-15,13.05 ( -2.97 %),9502,93563600,9846.73,7918,70495900,8903,23067700
2023-12-14,13.45 ( -0.74 %),5004,42174100,8428.08,6423,43978900,6847,-1804800
2023-12-13,13.55 ( 3.44 %),7891,80077000,10147.89,9043,66263500,7328,13813500
2023-12-12,13.1 ( 0.77 %),6808,68188900,10016,8173,51222200,6267,16966700
2023-12-11,13 ( 7 %),6329,60090200,9494.42,8312,45403500,5462,14686700
2023-12-08,12.15 ( -2.02 %),4457,25812100,5791.36,4185,28480700,6805,-2668600
2023-12-07,12.4 ( -1.59 %),13032,104786300,8040.69,7410,87939300,11868,16847000
2023-12-06,12.6 ( 5.88 %),6039,85927300,14228.73,6968,53976200,7746,31951100
2023-12-05,11.9 ( -2.46 %),5211,28726400,5512.65,5072,28863700,5691,-137300
2023-12-04,12.2 ( 3.39 %),7999,70156200,8770.62,7701,55688300,7231,14467900
2023-12-01,11.8 ( 5.83 %),5783,72974500,12618.8,7666,59663900,7783,13310600
2023-11-30,11.15 ( -0.89 %),8405,51743400,6156.26,6643,51771200,7793,-27800
2023-11-29,11.25 ( 5.14 %),7105,92874100,13071.65,9046,67069800,7414,25804300
2023-11-28,10.7 ( 0.94 %),5433,48943500,9008.56,6127,46878400,7651,2065100
2023-11-27,10.6 ( 1.92 %),7499,83135300,11086.18,9195,73050900,7945,10084400
2023-11-24,10.4 ( 6.12 %),8540,81035200,9488.9,10206,57122600,5597,23912600
2023-11-23,9.8 ( 4.7 %),7973,86640400,10866.73,13588,70955300,5222,15685100
2023-11-22,9.36 ( 1.08 %),3244,25455900,7847.07,7602,35771200,4705,-10315300
2023-11-21,9.26 ( -1.49 %),4485,20161900,4495.41,6413,30176700,4706,-10014800
2023-11-20,9.4 ( 3.07 %),4211,49062600,11651.06,10454,51758700,4951,-2696100
2023-11-17,9.12 ( 1.33 %),8637,61771300,7151.94,12013,70865900,5899,-9094600
2023-11-16,9 ( 0.22 %),4844,18154900,3747.91,3048,20344500,6675,-2189600
2023-11-15,8.98 ( 0.9 %),6933,52485600,7570.4,8975,51284500,5714,1201100
2023-11-14,8.9 ( -1.11 %),5680,27848100,4902.83,6810,38284900,5622,-10436800
2023-11-13,9 ( 3.45 %),6031,47025800,7797.35,8162,43946600,5384,3079200
2023-11-10,8.7 ( 2.35 %),9958,97717300,9812.94,12018,65235600,5428,32481700
2023-11-09,8.5 ( -1.51 %),4017,17576000,4375.4,5288,27881900,5273,-10305900
2023-11-08,8.63 ( 2.98 %),4880,27502400,5635.74,3557,23951900,6734,3550500
2023-11-07,8.38 ( 0.96 %),2923,13654800,4671.5,4283,19993600,4668,-6338800
2023-11-06,8.3 ( 1.22 %),2628,12267500,4668,2199,12990700,5908,-723200
2023-11-03,8.2 ( -1.44 %),3978,16119200,4052.09,3060,19937500,6516,-3818300
2023-11-01,8.16 ( 1.62 %),3618,13249900,3662.22,1642,10037900,6113,3212000
2023-10-31,8.03 ( -3.6 %),4166,15101400,3624.92,2416,16924400,7005,-1823000
2023-10-30,8.33 ( -4.8 %),3117,15014200,4816.88,5000,26668700,5334,-11654500
2023-10-27,8.75 ( 0.69 %),3738,23616900,6318.06,6059,27633000,4561,-4016100
2023-10-26,8.69 ( -1.14 %),4754,28067400,5903.95,4333,29149900,6727,-1082500
2023-10-25,8.79 ( 0.8 %),2521,23428700,9293.42,7802,32896600,4216,-9467900
2023-10-24,8.72 ( 0.11 %),1867,12679300,6791.27,6914,25718500,3720,-13039200
2023-10-23,8.71 ( 6.87 %),3980,45493000,11430.4,13198,50456300,3823,-4963300
2023-10-20,8.15 ( 2.13 %),2399,12489200,5206,2417,10387300,4298,2101900
2023-10-19,7.98 ( 3.64 %),3604,15520000,4306.33,3131,12546900,4007,2973100
2023-10-18,0 ( 0 %),5759,18983400,3296.3,2580,16723700,6482,2259700
2023-10-17,8.03 ( -3.6 %),1586,7823900,4933.1,3004,12828200,4270,-5004300
2023-10-16,8.33 ( 0.12 %),1880,10175400,5412.45,2995,13449800,4491,-3274400
2023-10-13,8.32 ( 1.22 %),4105,18361700,4473.01,3126,16209600,5185,2152100
2023-10-12,8.22 ( -2.14 %),3968,14389700,3626.44,3171,18428400,5812,-4038700
2023-10-11,8.4 ( -0.36 %),2177,12692900,5830.45,2880,14208300,4933,-1515400
2023-10-10,8.43 ( -0.24 %),2259,17086800,7563.88,5827,24606800,4223,-7520000
2023-10-09,8.45 ( 3.05 %),2705,20034400,7406.43,5818,22013300,3784,-1978900
2023-10-06,8.2 ( 1.23 %),2536,16598400,6545.11,6084,20974600,3448,-4376200
2023-10-05,8.1 ( 4.92 %),4407,29631700,6723.78,7466,29622300,3968,9400
2023-10-04,7.72 ( 0.92 %),3271,17309800,5291.9,2448,11545400,4716,5764400
2023-10-03,7.65 ( -3.16 %),5101,17515500,3433.74,2635,16559000,6284,956500
2023-10-02,7.9 ( 2.33 %),2205,14047600,6370.79,2975,12461000,4189,1586600
2023-09-29,7.72 ( -1.03 %),3692,11615200,3146.05,2289,13431100,5868,-1815900
2023-09-28,7.8 ( -0.64 %),4256,10844000,2547.93,2722,13832800,5082,-2988800
2023-09-27,7.85 ( 4.53 %),4040,16751300,4146.36,3264,11808000,3618,4943300
2023-09-26,7.51 ( 0 %),6934,25984800,3747.45,3814,17808200,4669,8176600
2023-09-25,7.51 ( -6.94 %),5671,18481300,3258.91,3590,21701900,6045,-3220600
2023-09-22,8.07 ( -4.61 %),10278,30318200,2949.82,3874,26397400,6814,3920800
2023-09-21,8.46 ( -0.47 %),3586,11633100,3244.03,3293,15523600,4714,-3890500
2023-09-20,8.5 ( 2.41 %),4201,14045100,3343.28,2820,11227700,3981,2817400
2023-09-19,8.3 ( -1.66 %),6449,18948200,2938.16,3194,17346800,5431,1601400
2023-09-18,8.44 ( -0.82 %),5730,14444300,2520.82,2741,13511900,4930,932400
2023-09-15,8.51 ( 0.12 %),5477,16737800,3056.02,3153,16071500,5097,666300
2023-09-14,8.5 ( -3.08 %),12262,31729900,2587.66,5336,34106500,6392,-2376600
2023-09-13,8.77 ( -2.23 %),8725,25572200,2930.91,5461,33098800,6061,-7526600
2023-09-12,8.97 ( 0.79 %),10047,29595100,2945.67,4705,27084700,5757,2510400
2023-09-11,8.9 ( -3.16 %),12418,35124900,2828.55,7189,47203800,6566,-12078900
2023-09-08,9.19 ( -0.43 %),11743,55055100,4688.33,8385,57462400,6853,-2407300
2023-09-07,9.23 ( 0.98 %),11104,56911200,5125.29,10845,54628000,5037,2283200
2023-09-06,9.14 ( -0.65 %),8681,47050500,5419.94,7240,47726500,6592,-676000
2023-09-05,9.2 ( 0.22 %),5952,43398300,7291.38,6961,37436800,5378,5961500
2023-08-31,9.18 ( 3.15 %),7973,78667100,9866.69,14489,74897000,5169,3770100
2023-08-30,8.9 ( 0 %),6582,31383200,4768.03,4663,25660400,5503,5722800
2023-08-29,8.9 ( -1.55 %),7046,57050300,8096.84,6223,40296300,6475,16754000
2023-08-28,9.04 ( 1.35 %),5208,27340700,5249.75,4369,26610700,6091,730000
2023-08-25,8.92 ( -3.98 %),8044,34050800,4233.07,5374,36845300,6856,-2794500
2023-08-24,9.29 ( 5.57 %),4930,37424200,7591.12,8604,44447200,5166,-7023000
2023-08-23,8.8 ( -2.11 %),5474,23775900,4343.42,6037,30936600,5124,-7160700
2023-08-22,8.99 ( 4.53 %),7425,34595200,4659.29,6035,33341500,5525,1253700
2023-08-21,8.57 ( 0.82 %),6426,22708700,3533.88,5666,26995800,4765,-4287100
2023-08-18,8.47 ( -6.92 %),15245,51091500,3351.36,7795,63479200,8144,-12387700
2023-08-17,9.1 ( -1.09 %),7071,22205000,3140.29,4759,31166200,6549,-8961200
2023-08-16,9.2 ( 0 %),5962,21454500,3598.54,4279,24040000,5618,-2585500
2023-08-15,9.2 ( 0 %),6916,27344900,3953.86,6098,33346300,5468,-6001400
2023-08-14,9.2 ( -1.08 %),10105,44288100,4382.79,4305,34397400,7990,9890700
2023-08-11,9.27 ( 0.65 %),11086,38224800,3448.02,5013,35362600,7054,2862200
2023-08-10,9.21 ( -3.56 %),12064,38695800,3207.54,5797,44983800,7760,-6288000
2023-08-09,9.55 ( -2.65 %),11535,57232200,4961.61,8430,55558000,6591,1674200
2023-08-08,9.81 ( 6.86 %),9728,117692500,12098.32,16204,81601300,5036,36091200
2023-08-07,9.18 ( 0.33 %),7127,29173200,4093.34,7500,41045600,5473,-11872400
2023-08-04,9.15 ( 2.81 %),5987,41442900,6922.15,8140,45153100,5547,-3710200
2023-08-03,8.9 ( -2.2 %),6467,28485100,4404.69,7252,40406000,5572,-11920900
2023-08-02,9.1 ( 2.25 %),6998,50442400,7208.12,10937,49367100,4514,1075300
2023-08-01,8.9 ( 0 %),8149,42020600,5156.53,8336,47775600,5731,-5755000
2023-07-31,8.88 ( 0.91 %),9453,54675900,5783.97,12184,67591300,5548,-12915400
2023-07-28,8.8 ( 3.53 %),5558,23740200,4271.36,6535,27345900,4185,-3605700
2023-07-27,8.54 ( -0.7 %),9267,29403600,3172.94,5666,45447500,8021,-16043900
2023-07-26,8.64 ( -0.35 %),7368,21632800,2936.05,4376,24436000,5584,-2803200
2023-07-25,8.67 ( -1.48 %),6270,22147000,3532.22,5764,32296500,5603,-10149500
2023-07-24,8.79 ( 1.03 %),4863,27186500,5590.48,7473,34592600,4629,-7406100
2023-07-21,8.65 ( 1.76 %),4596,21480500,4673.74,5486,24608100,4486,-3127600
2023-07-20,8.49 ( -0.12 %),6626,21775600,3286.39,4003,20350000,5084,1425600
2023-07-19,8.5 ( -2.3 %),11464,32224200,2810.9,5495,37063400,6745,-4839200
2023-07-18,8.72 ( 0.23 %),7437,34659900,4660.47,8858,45199400,5103,-10539500
2023-07-17,8.68 ( -0.23 %),6514,22066000,3387.47,4985,27949300,5607,-5883300
2023-07-14,8.72 ( -0.91 %),10248,35669800,3480.66,6081,37781600,6213,-2111800
2023-07-13,8.81 ( 1.26 %),7551,37050700,4906.73,7395,37105000,5018,-54300
2023-07-12,8.71 ( -1.02 %),7392,29476700,3987.65,7948,38092400,4793,-8615700
2023-07-11,8.76 ( 6.83 %),12420,78210600,6297.15,16530,69355700,4196,8854900
2023-07-10,8.2 ( 0 %),4550,18605900,4089.21,5433,26265900,4835,-7660000
2023-07-07,8.19 ( -0.12 %),5240,18626100,3554.6,3858,21311900,5524,-2685800
2023-07-06,8.15 ( -1.81 %),8958,31360500,3500.84,5725,32155400,5617,-794900
2023-07-05,8.27 ( -1.55 %),7283,23654900,3247.96,6465,33027400,5109,-9372500
2023-07-04,8.39 ( 2.32 %),8128,41150200,5062.77,13314,52991700,3980,-11841500
2023-07-03,8.17 ( -0.37 %),5465,22066300,4037.75,4954,25021600,5051,-2955300
2023-06-30,8.15 ( -1.81 %),5572,21719600,3897.99,7646,33324100,4358,-11604500
2023-06-29,8.3 ( 3.75 %),11783,72436800,6147.57,19677,78408200,3985,-5971400
2023-06-28,7.95 ( -0.62 %),4914,17066700,3473.08,5017,24183500,4820,-7116800
2023-06-27,7.97 ( -0.38 %),5023,14314200,2849.73,3806,17191200,4517,-2877000
2023-06-26,7.95 ( -0.62 %),9031,22340500,2473.76,4541,23113100,5090,-772600
2023-06-23,8.04 ( -0.74 %),0,0,0,0,0,0,0
2023-06-22,8.08 ( 1.38 %),5707,19948700,3495.48,5454,24596600,4510,-4647900
2023-06-21,7.97 ( -0.38 %),5236,13821100,2639.63,4069,19328400,4750,-5507300
2023-06-20,7.96 ( 0.76 %),5548,16532300,2979.87,3620,17281400,4774,-749100
2023-06-19,7.9 ( -1.25 %),8975,25023800,2788.17,5559,31806900,5722,-6783100
2023-06-16,8.03 ( -2.07 %),7103,21071300,2966.54,6245,37719300,6040,-16648000
2023-06-15,8.19 ( 2.12 %),7995,36069400,4511.49,11119,47214100,4246,-11144700
2023-06-14,8.02 ( -1.11 %),6063,19523700,3220.14,4778,24876000,5206,-5352300
2023-06-13,8.11 ( 0.62 %),5439,18330700,3370.23,5217,26492900,5078,-8162200
2023-06-12,8.06 ( -0.49 %),7251,27160500,3745.76,4979,27406100,5504,-245600
2023-06-09,8.1 ( -0.98 %),9670,28152400,2911.31,5836,31090100,5327,-2937700
2023-06-08,8.18 ( -0.37 %),10118,37457700,3702.09,11036,52273900,4737,-14816200
2023-06-07,8.21 ( 0.24 %),7642,24393700,3192.06,7596,33064000,4353,-8670300
2023-06-06,8.19 ( 0.99 %),4926,16522400,3354.12,5867,25927800,4419,-9405400
2023-06-05,8.11 ( 1 %),8154,29810700,3655.96,8420,37034400,4398,-7223700
2023-06-02,8.03 ( -1.11 %),10461,29697800,2838.91,6011,34116800,5676,-4419000
2023-06-01,8.12 ( -0.73 %),7731,25022500,3236.64,6257,30335600,4848,-5313100
2023-05-31,8.18 ( 2.38 %),10403,41166600,3957.19,10423,53088100,5093,-11921500
2023-05-30,7.99 ( -0.75 %),8506,22976500,2701.21,6664,35131800,5272,-12155300
2023-05-29,8.05 ( 3.6 %),10039,44501200,4432.83,12337,51510800,4175,-7009600
2023-05-26,7.77 ( 1.3 %),4179,15049100,3601.12,5009,22999000,4592,-7949900
2023-05-25,7.67 ( -0.78 %),4983,14988800,3007.99,2799,16572600,5921,-1583800
2023-05-24,7.73 ( -1.28 %),5331,15527500,2912.68,4411,24141400,5473,-8613900
2023-05-23,7.83 ( 0.64 %),4000,17954600,4488.65,6197,26764400,4319,-8809800
2023-05-22,7.78 ( 1.04 %),3310,15644700,4726.5,5366,25403700,4734,-9759000
2023-05-19,7.7 ( 0.79 %),5258,15925600,3028.83,3142,19201200,6111,-3275600
2023-05-18,7.64 ( -0.78 %),7372,19581100,2656.14,3093,23036600,7448,-3455500
2023-05-17,7.7 ( -1.28 %),5772,21884800,3791.55,5976,29978400,5016,-8093600
2023-05-16,7.8 ( 1.96 %),7139,27786800,3892.25,5367,26357300,4911,1429500
2023-05-15,7.65 ( -4.97 %),11910,39839500,3345.05,6099,41953500,6879,-2114000
2023-05-12,8.05 ( 0.63 %),4427,21368200,4826.79,5574,27495400,4933,-6127200
2023-05-11,7.95 ( -1.85 %),4951,17607500,3556.35,4907,24476200,4988,-6868700
2023-05-10,8.05 ( 3.21 %),4486,39505900,8806.49,10094,42144000,4175,-2638100
2023-05-09,7.78 ( -0.26 %),3213,12703900,3953.91,4674,19381300,4147,-6677400
2023-05-08,7.83 ( 4.26 %),3703,29031600,7840.02,6788,29163100,4296,-131500
2023-05-05,7.51 ( -0.4 %),4248,21261100,5004.97,4517,20669200,4576,591900
2023-05-04,7.54 ( -1.05 %),4044,14669200,3627.4,3642,14118300,3877,550900
2023-04-28,7.62 ( 1.6 %),0,0,0,0,0,0,0
2023-04-27,7.5 ( -1.19 %),4078,11194200,2745.02,3570,14675200,4111,-3481000
2023-04-26,7.59 ( -1.43 %),0,0,0,0,0,0,0
2023-04-25,7.69 ( 1.18 %),7877,31731700,4028.4,4338,28768100,6632,2963600
2023-04-24,7.6 ( -3.8 %),7386,26435200,3579.1,3921,27647500,7051,-1212300
2023-04-21,7.89 ( -2.59 %),6165,22413100,3635.54,5256,26553600,5052,-4140500
2023-04-20,8.07 ( -1.59 %),3996,25053100,6269.54,6540,27296100,4174,-2243000
2023-04-19,8.15 ( 1.88 %),0,0,0,0,0,0,0
2023-04-18,7.97 ( -2.8 %),6151,19822600,3222.66,6304,25717400,4080,-5894800
2023-04-17,8.15 ( 5.84 %),6759,46952000,6946.59,10872,41382100,3806,5569900
2023-04-14,7.7 ( 0 %),5098,20652900,4051.18,7172,29977400,4180,-9324500
2023-04-13,7.7 ( 0 %),5428,16870700,3108.09,5484,23489600,4283,-6618900
2023-04-12,7.7 ( -1.28 %),6836,18234600,2667.44,5398,26061100,4828,-7826500
2023-04-11,7.82 ( 2.89 %),7414,31819900,4291.87,9314,39325300,4222,-7505400
2023-04-10,7.6 ( 1.33 %),5606,22597300,4030.91,5774,24314300,4211,-1717000
2023-04-07,7.45 ( -1.97 %),5519,15288600,2770.18,3499,17789800,5084,-2501200
2023-04-06,7.6 ( 0 %),6140,25035900,4077.51,7088,29080600,4103,-4044700
2023-04-05,7.56 ( -1.82 %),5648,15623600,2766.22,4863,22274100,4580,-6650500
2023-04-04,7.65 ( 3.38 %),6729,29479600,4380.98,7382,31923200,4324,-2443600
2023-04-03,7.39 ( 1.23 %),3565,10764700,3019.55,3559,16705200,4694,-5940500
2023-03-31,7.33 ( -0.95 %),3549,11255600,3171.48,2331,13186700,5657,-1931100
2023-03-30,7.36 ( -0.54 %),2791,9888200,3542.89,3073,14266200,4642,-4378000
2023-03-29,7.39 ( -0.14 %),2505,8151800,3254.21,2477,10678000,4311,-2526200
2023-03-28,7.44 ( 0.54 %),3189,13315200,4175.35,4609,16112300,3496,-2797100
2023-03-27,7.36 ( 0.82 %),3491,11617200,3327.76,2810,13834600,4923,-2217400
2023-03-24,7.3 ( 0 %),2621,9379600,3578.63,2752,10837800,3938,-1458200
2023-03-23,7.26 ( -0.55 %),4335,11678400,2693.98,2243,13020500,5805,-1342100
2023-03-22,7.34 ( 0.55 %),2166,6990000,3227.15,2601,9993000,3842,-3003000
2023-03-21,7.34 ( 0.55 %),3260,9788900,3002.73,2525,11136700,4411,-1347800
2023-03-20,7.33 ( -3.55 %),5206,13032000,2503.27,3174,17109800,5391,-4077800
2023-03-17,7.6 ( 2.7 %),3272,13402500,4096.12,3800,18771400,4940,-5368900
2023-03-16,7.39 ( -2.76 %),7534,20129600,2671.83,2998,16952200,5655,3177400
2023-03-15,7.55 ( 2.03 %),3733,12175100,3261.48,3598,15027100,4177,-2852000
2023-03-14,7.38 ( -1.6 %),6439,16284500,2529.04,2987,15661900,5243,622600
2023-03-13,7.49 ( -1.45 %),5723,16713400,2920.39,2622,13784500,5257,2928900
2023-03-10,7.64 ( -2.05 %),4811,14053300,2921.08,3276,15006100,4581,-952800
2023-03-09,7.81 ( 2.76 %),6168,24339400,3946.08,8178,28111500,3437,-3772100
2023-03-08,7.55 ( 0.67 %),5730,14724500,2569.72,2573,12657000,4919,2067500
2023-03-07,7.47 ( -0.4 %),4551,11499300,2526.76,2556,11794700,4615,-295400
2023-03-06,7.46 ( -0.53 %),3449,10258800,2974.43,3269,12082700,3696,-1823900
2023-03-03,7.45 ( -1.97 %),4736,10357800,2187.04,2654,10848400,4088,-490600
2023-03-02,7.62 ( -1.04 %),3193,9038400,2830.69,2836,9818300,3462,-779900
2023-03-01,7.7 ( 2.67 %),5116,15713100,3071.36,3422,11755000,3435,3958100
2023-02-28,7.45 ( 0.68 %),5097,12542600,2460.78,2931,10437100,3561,2105500
2023-02-27,7.4 ( -5.13 %),7671,17789400,2319.05,3341,15805600,4731,1983800
2023-02-24,7.79 ( -1.39 %),5402,14306000,2648.28,3076,12508500,4066,1797500
2023-02-23,7.92 ( 0.25 %),9411,24706800,2625.31,4094,19540200,4773,5166600
2023-02-22,7.85 ( -4.27 %),10320,24650300,2388.59,4652,28463000,6118,-3812700
2023-02-21,8.2 ( -1.2 %),6279,16922900,2695.16,5631,23046300,4093,-6123400
2023-02-20,8.3 ( 3.75 %),6296,22885600,3634.94,5749,21765500,3786,1120100
2023-02-17,7.96 ( -0.5 %),5598,14025200,2505.39,4217,16160800,3832,-2135600
2023-02-16,8 ( 0 %),5541,14327300,2585.69,3690,15065200,4083,-737900
2023-02-15,7.98 ( 3.64 %),7152,23275200,3254.36,5812,20354400,3502,2920800
2023-02-14,7.65 ( -0.65 %),6068,18119500,2986.07,3033,13990100,4613,4129400
2023-02-13,7.68 ( -7.47 %),13876,32447600,2338.4,6089,42869800,7041,-10422200
2023-02-10,8.25 ( -2.94 %),7957,18182300,2285.07,3605,23354600,6478,-5172300
2023-02-09,8.53 ( -0.81 %),5321,13484900,2534.28,3118,16526400,5300,-3041500
2023-02-08,8.55 ( -0.58 %),8316,21882400,2631.36,4627,20696800,4473,1185600
2023-02-07,8.6 ( -1.15 %),7058,29875900,4232.91,5545,30461300,5493,-585400
2023-02-06,8.73 ( 1.51 %),7754,22328000,2879.55,5236,21465600,4100,862400
2023-02-03,8.61 ( 0.12 %),7693,23609600,3068.97,4588,18637100,4062,4972500
2023-02-02,8.55 ( -3.93 %),16699,42659500,2554.61,7506,40974700,5459,1684800
2023-02-01,8.91 ( -6.21 %),10651,27827900,2612.7,7051,40562900,5753,-12735000
2023-01-31,9.52 ( 1.28 %),12191,34831200,2857.12,5372,29732800,5535,5098400
2023-01-30,9.41 ( -1.98 %),9211,26119800,2835.72,6231,29507200,4736,-3387400
2023-01-27,9.61 ( 0.1 %),6713,21431500,3192.54,5983,25229600,4217,-3798100
2023-01-19,9.63 ( 2.45 %),7623,29560300,3877.78,9377,38831400,4141,-9271100
2023-01-18,9.43 ( 3.63 %),9691,43255100,4463.43,10246,47362500,4623,-4107400
2023-01-17,9.07 ( 0.78 %),6425,23042800,3586.43,4155,20355900,4899,2686900
2023-01-16,8.95 ( -1.65 %),10196,30004800,2942.8,4575,30278300,6618,-273500
2023-01-13,9.14 ( -1.72 %),6662,26056500,3911.21,6516,32500200,4988,-6443700
2023-01-12,9.3 ( -1.06 %),6405,30866100,4819.06,7504,38010300,5065,-7144200
2023-01-11,9.4 ( 3.3 %),6337,40736900,6428.42,9871,45599700,4620,-4862800
2023-01-10,9.11 ( 0.11 %),8247,26767400,3245.71,6700,33338400,4976,-6571000
2023-01-09,9.1 ( -3.19 %),7595,24046400,3166.08,6062,28976900,4780,-4930500
2023-01-06,9.35 ( -0.53 %),7438,30587200,4112.29,8764,41072600,4687,-10485400
2023-01-05,9.35 ( 3.89 %),6424,30832300,4799.55,7588,35893700,4730,-5061400
2023-01-04,9.02 ( -5.05 %),16188,49425500,3053.22,8928,49027400,5491,398100
2023-01-03,9.49 ( 3.15 %),9869,53972300,5468.87,12691,56319800,4438,-2347500
2022-12-30,9.16 ( 2.92 %),6263,31856400,5086.44,9747,39306100,4033,-7449700
2022-12-29,8.9 ( 3.49 %),6526,28883000,4425.84,7317,32589800,4454,-3706800
2022-12-28,8.6 ( 0 %),6574,29091500,4425.24,7185,34967700,4867,-5876200
2022-12-27,8.59 ( 7.37 %),8718,53330400,6117.27,6326,23910100,3780,29420300
2022-12-26,8.03 ( -6.63 %),9599,30897200,3218.79,5654,34210800,6051,-3313600
2022-12-23,8.62 ( -3.15 %),8557,22335500,2610.2,5275,23497300,4454,-1161800
2022-12-22,8.9 ( 0 %),7978,31563900,3956.37,10625,38939800,3665,-7375900
2022-12-21,8.91 ( 7.35 %),13359,57424300,4298.55,7853,37943300,4832,19481000
2022-12-20,8.33 ( -7.44 %),19013,52533400,2763.03,9732,63854000,6561,-11320600
2022-12-19,8.95 ( -3.76 %),9053,28073500,3101.02,7746,47180100,6091,-19106600
2022-12-16,9.25 ( 1.65 %),10064,29697400,2950.85,6504,38433900,5909,-8736500
2022-12-15,9.13 ( -1.83 %),7957,20487900,2574.83,5494,40311000,7337,-19823100
2022-12-14,9.25 ( -1.6 %),7716,23290600,3018.48,7511,36389800,4845,-13099200
2022-12-13,9.4 ( 4.44 %),14281,43537600,3048.64,7077,41168700,5817,2368900
2022-12-12,9.01 ( -4.15 %),10196,34103900,3344.83,9056,45790700,5056,-11686800
2022-12-09,9.41 ( 2.28 %),8195,30338600,3702.09,8132,40397400,4968,-10058800
2022-12-08,9.2 ( 0 %),10490,36328100,3463.12,7603,41630000,5475,-5301900
2022-12-07,9.18 ( -3.37 %),14323,48522000,3387.7,13080,62724700,4795,-14202700
2022-12-06,9.52 ( 6.97 %),14564,75693500,5197.3,8641,48250600,5584,27442900
2022-12-05,8.9 ( -2.2 %),11803,35034700,2968.29,8553,44527500,5206,-9492800
2022-12-02,9.11 ( 3.52 %),13268,42227500,3182.66,8030,40410200,5032,1817300
2022-12-01,8.81 ( -3.19 %),13422,37726400,2810.79,8252,49241400,5967,-11515000
2022-11-30,9.05 ( 1.69 %),12389,37278700,3009.02,6539,37804900,5781,-526200
2022-11-29,8.92 ( -0.89 %),16922,46504000,2748.14,7547,52419400,6946,-5915400
2022-11-28,8.96 ( 6.67 %),10130,35246100,3479.38,5367,31354900,5842,3891200
2022-11-25,8.41 ( 6.46 %),8057,43401400,5386.79,4893,25181200,5146,18220200
2022-11-24,7.86 ( 6.94 %),5758,43684900,7586.82,2678,13780500,5146,29904400
2022-11-23,7.35 ( -5.77 %),7547,23985500,3178.15,4624,29713100,6426,-5727600
2022-11-22,7.8 ( 0 %),12298,41271600,3355.96,7483,44744900,5980,-3473300
2022-11-21,7.75 ( 6.16 %),9265,47079500,5081.44,3693,20744800,5617,26334700
2022-11-18,7.25 ( 6.62 %),10197,74929100,7348.15,4075,28790300,7065,46138800
2022-11-17,6.78 ( 7.62 %),6478,37375000,5769.53,538,1649800,3067,35725200
2022-11-16,6.34 ( 7.46 %),9361,47513700,5075.71,4133,19038100,4606,28475600
2022-11-15,5.93 ( -7.34 %),6788,26261500,3868.81,4565,30229100,6622,-3967600
2022-11-14,6.37 ( -6.32 %),7734,25790400,3334.68,4366,24580000,5630,1210400
2022-11-11,6.84 ( -7.57 %),8920,24980700,2800.53,5399,33513100,6207,-8532400
2022-11-10,7.35 ( -6.96 %),5671,12989900,2290.58,3174,26488500,8345,-13498600
2022-11-09,7.9 ( 1.28 %),4872,17826400,3658.95,4020,17308200,4306,518200
2022-11-08,7.8 ( 1.3 %),6932,21177500,3055.03,3646,17327800,4753,3849700
2022-11-07,7.71 ( -7.11 %),8570,23582100,2751.7,4579,33482000,7312,-9899900
2022-11-04,8.29 ( -5.8 %),11376,32805500,2883.75,4574,29811000,6517,2994500
2022-11-03,8.8 ( -2.22 %),6370,16698600,2621.44,3562,18821300,5284,-2122700
2022-11-02,8.99 ( 2.16 %),6616,23734700,3587.47,5112,22504500,4402,1230200
2022-11-01,8.76 ( 0.69 %),5873,17245300,2936.37,3496,15676100,4484,1569200
2022-10-31,8.66 ( -4.84 %),9762,27586800,2825.94,4456,27627600,6200,-40800
2022-10-28,9.1 ( -2.15 %),8351,24909900,2982.86,5463,28597300,5235,-3687400
2022-10-27,9.3 ( 6.9 %),7059,28225900,3998.57,5845,24564100,4203,3661800
2022-10-26,8.7 ( -3.33 %),6980,19027500,2726,4000,22405200,5601,-3377700
2022-10-25,9.03 ( 2.61 %),7990,27243300,3409.67,5921,27396400,4627,-153100
2022-10-24,8.83 ( 3.88 %),9008,48879400,5426.22,7731,34233600,4428,14645800
2022-10-21,8.5 ( -6.59 %),10421,39540900,3794.35,7086,38647600,5454,893300
2022-10-20,9.05 ( -4.74 %),13000,35856300,2758.18,5096,30757200,6036,5099100
2022-10-19,9.54 ( -2.65 %),7995,25445300,3182.65,4402,22615200,5137,2830100
2022-10-18,9.78 ( 2.95 %),6791,26622100,3920.2,5944,23849500,4012,2772600
2022-10-17,9.46 ( -6.34 %),13332,38046100,2853.74,6008,43983400,7321,-5937300
2022-10-14,10.05 ( 1.52 %),6537,35519500,5433.61,5714,29444400,5153,6075100
2022-10-13,9.9 ( 3.13 %),9706,41039700,4228.28,6452,35898000,5564,5141700
2022-10-12,9.63 ( -7.4 %),14116,49887500,3534.11,8787,61133400,6957,-11245900
2022-10-11,10.35 ( -6.76 %),7991,24021400,3006.06,4796,42920400,8949,-18899000
2022-10-10,11.1 ( 2.78 %),11242,73647500,6551.1,8652,48913300,5653,24734200
2022-10-07,10.75 ( -7.33 %),4629,11390100,2460.6,5437,60028300,11041,-48638200
2022-10-06,11.55 ( -6.85 %),14533,49526800,3407.89,6651,89710000,13488,-40183200
2022-10-05,12.4 ( 5.08 %),8263,49556300,5997.37,6117,30560900,4996,18995400
2022-10-04,11.8 ( -4.84 %),17732,72204500,4071.99,7745,76149900,9832,-3945400
2022-10-03,12.35 ( -7.14 %),16480,59363400,3602.15,6707,72066900,10745,-12703500
2022-09-30,13.25 ( 6.85 %),14828,73345200,4946.4,8552,52516500,6141,20828700
2022-09-29,12.4 ( -1.59 %),10369,51713700,4987.34,7013,48826100,6962,2887600
2022-09-28,12.55 ( -7.04 %),20815,78619000,3777.04,8623,95940000,11126,-17321000
2022-09-27,13.45 ( -1.82 %),6911,51632600,7471.08,9882,58480600,5918,-6848000
2022-09-26,13.7 ( -1.44 %),19908,89883100,4514.92,8491,80332600,9461,9550500
2022-09-23,13.9 ( 0 %),12638,72567600,5742.02,14954,85331800,5706,-12764200
2022-09-22,13.85 ( 1.09 %),13915,57034000,4098.74,6819,49972700,7328,7061300
2022-09-21,13.65 ( -1.8 %),6232,25191600,4042.3,5525,30633900,5545,-5442300
2022-09-20,13.85 ( -0.36 %),7190,33824900,4704.44,8011,42725600,5333,-8900700
2022-09-19,13.85 ( 1.84 %),15472,77218400,4990.85,14923,80138800,5370,-2920400
2022-09-16,13.6 ( 0 %),11098,68205900,6145.78,15900,79013800,4969,-10807900
2022-09-15,13.6 ( -0.73 %),8235,38270300,4647.27,10413,48027000,4612,-9756700
2022-09-14,13.7 ( 6.2 %),15591,85079700,5456.98,14779,74055000,5011,11024700
2022-09-13,12.85 ( 0.39 %),6204,23322700,3759.3,7457,36121100,4844,-12798400
2022-09-12,12.8 ( 3.23 %),7122,35154200,4936,7888,37133200,4708,-1979000
2022-09-09,12.4 ( 4.2 %),9247,57560300,6224.75,5182,41910400,8088,15649900
2022-09-08,11.9 ( -4.03 %),12821,56057700,4372.33,6290,49458500,7863,6599200
2022-09-07,12.35 ( -1.2 %),10429,42602000,4084.96,5588,38724400,6930,3877600
2022-09-06,12.45 ( -4.23 %),13346,51825400,3883.22,7589,61413800,8092,-9588400
2022-09-05,12.95 ( -0.38 %),4775,27474100,5753.74,6025,31915000,5297,-4440900
2022-08-31,12.95 ( -0.38 %),8013,47479100,5925.26,9354,51127100,5466,-3648000
2022-08-30,12.95 ( -1.15 %),6654,30214600,4540.82,8494,37694800,4438,-7480200
2022-08-29,13.05 ( 1.95 %),11993,71364600,5950.52,11208,58330100,5204,13034500
2022-08-26,12.75 ( 1.19 %),6560,41848900,6379.41,12539,53612600,4276,-11763700
2022-08-25,12.6 ( -0.79 %),5994,24003500,4004.59,7570,34331700,4535,-10328200
2022-08-24,12.65 ( 2.02 %),9804,54490400,5557.98,17258,65509200,3796,-11018800
2022-08-23,12.35 ( -0.4 %),6718,36959800,5501.61,10932,53745900,4916,-16786100
2022-08-22,12.4 ( 5.98 %),8196,67602000,8248.17,12964,60479300,4665,7122700
2022-08-19,11.65 ( -0.43 %),7929,30479200,3844.02,4779,28898000,6047,1581200
2022-08-18,11.65 ( -2.1 %),15349,50609300,3297.24,5791,48435000,8364,2174300
2022-08-17,11.9 ( -3.25 %),13700,52044500,3798.87,8796,61635800,7007,-9591300
2022-08-16,12.3 ( -0.81 %),7445,38327500,5148.09,10354,49426800,4774,-11099300
2022-08-15,12.35 ( 2.92 %),7557,52424600,6937.22,12018,54965600,4574,-2541000
2022-08-12,11.95 ( -2.05 %),6333,29217000,4613.45,6276,32041100,5105,-2824100
2022-08-11,12.2 ( 4.27 %),15078,73750100,4891.24,11266,63857500,5668,9892600
2022-08-10,11.7 ( -3.31 %),11119,44772300,4026.65,5132,42273600,8237,2498700
2022-08-09,12.05 ( 1.26 %),10357,42630400,4116.1,5948,31854700,5356,10775700
2022-08-08,11.85 ( -5.2 %),20095,69474300,3457.29,9422,68475000,7268,999300
2022-08-05,12.45 ( 0.4 %),7839,43749200,5580.97,8519,39833900,4676,3915300
2022-08-04,12.35 ( 0.41 %),7937,43995600,5543.1,8081,39769200,4921,4226400
2022-08-03,12.3 ( 1.65 %),9811,47534600,4845.03,10097,47623500,4717,-88900
2022-08-02,12.1 ( 6.14 %),13329,80927500,6071.54,13014,60638700,4659,20288800
2022-08-01,11.35 ( 1.34 %),6455,40795300,6319.95,8277,38397700,4639,2397600
2022-07-29,11.15 ( 1.36 %),6221,46119000,7413.44,9154,45453300,4965,665700
2022-07-28,11 ( -2.65 %),8156,51236500,6282.06,11263,53614300,4760,-2377800
2022-07-27,11.3 ( 2.73 %),6875,39191600,5700.6,5904,29925000,5069,9266600
2022-07-26,11 ( -3.51 %),6983,36071400,5165.6,7035,38281100,5442,-2209700
2022-07-25,11.4 ( 4.59 %),7684,50962800,6632.33,8258,38807400,4699,12155400
2022-07-22,10.85 ( -2.25 %),7752,26377900,3402.72,4828,26239100,5435,138800
2022-07-21,11.1 ( 1.83 %),15638,84292800,5390.25,9997,57169900,5719,27122900
2022-07-20,10.85 ( -7.26 %),18840,78439200,4163.44,16099,93976800,5837,-15537600
2022-07-19,11.65 ( -0.43 %),9884,51574800,5218.01,11663,59987500,5143,-8412700
2022-07-18,11.7 ( 5.41 %),7281,48318200,6636.2,9656,41731500,4322,6586700
2022-07-15,11.05 ( 1.38 %),6096,36738300,6026.62,8503,38556000,4534,-1817700
2022-07-14,10.9 ( -0.91 %),12260,55273200,4508.42,9486,54382300,5733,890900
2022-07-13,11 ( 4.76 %),9779,56577600,5785.62,8877,41418800,4666,15158800
2022-07-12,10.5 ( 1.94 %),8876,60493800,6815.43,8675,46577800,5369,13916000
2022-07-11,10.25 ( 6.77 %),7712,47817000,6200.34,6520,33673200,5165,14143800
2022-07-08,9.62 ( -0.82 %),6207,24722700,3983.04,5418,26153500,4827,-1430800
2022-07-07,9.7 ( 0 %),7978,36452000,4569.06,5765,34662200,6013,1789800
2022-07-06,9.65 ( 2.66 %),9326,63713200,6831.78,10396,48600100,4675,15113100
2022-07-05,9.42 ( -0.84 %),10346,47613200,4602.09,9732,44917200,4615,2696000
2022-07-04,9.52 ( 6.97 %),6723,48154400,7162.64,6749,29612500,4388,18541900
2022-07-01,8.9 ( 7.23 %),7390,53484500,7237.42,7779,33736100,4337,19748400
2022-06-30,8.32 ( -3.26 %),6729,30451400,4525.4,5430,31525300,5806,-1073900
2022-06-29,8.6 ( 0 %),5799,23842100,4111.42,4964,24810500,4998,-968400
2022-06-28,8.64 ( 0.47 %),7184,29656900,4128.19,7348,34474700,4692,-4817800
2022-06-27,8.64 ( 6.67 %),5798,38114700,6573.77,6024,26601800,4416,11512900
2022-06-24,8.08 ( -1.46 %),5150,25124700,4878.58,4881,21600900,4426,3523800
2022-06-23,8.24 ( 3 %),5618,24303400,4325.99,4700,22126200,4708,2177200
2022-06-22,8 ( 3.9 %),5583,22816500,4086.78,5194,25317200,4874,-2500700
2022-06-21,7.7 ( 6.94 %),4773,35669500,7473.18,2759,11259300,4081,24410200
2022-06-20,7.2 ( 2.86 %),6604,30509000,4619.78,6294,25716100,4086,4792900
2022-06-17,6.98 ( -6.93 %),6341,19631400,3095.95,3611,23116000,6402,-3484600
2022-06-16,7.5 ( -1.32 %),3351,11120800,3318.65,3138,15877400,5060,-4756600
2022-06-15,7.55 ( -3.21 %),5344,15459400,2892.85,3137,17222000,5490,-1762600
2022-06-14,7.83 ( 3.03 %),5484,20284900,3698.92,4606,19235500,4176,1049400
2022-06-13,7.62 ( -7.07 %),10310,31012100,3007.96,3878,30653700,7905,358400
2022-06-10,8.19 ( -4.77 %),7786,19381400,2489.26,2998,20391600,6802,-1010200
2022-06-09,8.56 ( -2.73 %),4458,10911600,2447.64,2502,14812600,5920,-3901000
2022-06-08,8.75 ( 2.94 %),4789,16598300,3465.92,4027,14502400,3601,2095900
2022-06-07,8.45 ( -0.59 %),7869,22374700,2843.4,3465,19890100,5740,2484600
2022-06-06,8.5 ( -2.3 %),5697,15193400,2666.91,3321,18213600,5484,-3020200
2022-06-03,8.72 ( -2.02 %),8780,22444200,2556.29,3875,21302100,5497,1142100
2022-06-02,8.9 ( -4.3 %),5594,19179800,3428.64,3669,23123100,6302,-3943300
2022-06-01,9.25 ( 0.54 %),4726,19797800,4189.12,3761,17118900,4552,2678900
2022-05-31,9.22 ( -1.91 %),5663,21132700,3731.71,4486,20620300,4597,512400
2022-05-30,9.36 ( -0.43 %),4488,15862500,3534.43,3814,15751500,4130,111000
2022-05-27,9.41 ( 3.41 %),4986,35808300,7181.77,7816,28833200,3689,6975100
2022-05-26,9.08 ( -2.37 %),6449,21560700,3343.26,5291,24291900,4591,-2731200
2022-05-25,9.3 ( 6.9 %),4703,25681700,5460.71,5963,23657600,3967,2024100
2022-05-24,8.72 ( -0.91 %),7644,22065900,2886.7,3702,20527300,5545,1538600
2022-05-23,8.81 ( -2.11 %),7914,31608500,3994,5073,29529200,5821,2079300
2022-05-20,8.99 ( -0.11 %),14155,63520700,4487.51,8059,35024200,4346,28496500
2022-05-19,9.03 ( 0.33 %),6864,23961100,3490.84,5042,22890500,4540,1070600
2022-05-18,9 ( 4.65 %),7927,29617000,3736.22,6023,27110700,4501,2506300
2022-05-17,8.61 ( 6.3 %),5273,27990700,5308.31,4146,14583200,3517,13407500
2022-05-16,8.05 ( 3.21 %),0,0,0,0,0,0,0
2022-05-13,7.76 ( -6.95 %),8620,36389000,4221.46,5576,37304900,6690,-915900
2022-05-12,8.34 ( -6.92 %),7669,16775400,2187.43,3225,23159500,7181,-6384100
2022-05-11,8.96 ( -1.1 %),6707,18109600,2700.1,3887,19477400,5011,-1367800
2022-05-10,9.06 ( 2.95 %),8068,34451200,4270.1,4725,23353800,4943,11097400
2022-05-09,8.75 ( -6.91 %),9376,26160100,2790.11,4515,35106300,7775,-8946200
2022-05-06,9.4 ( -6 %),8129,19438300,2391.23,3373,21095800,6254,-1657500
2022-05-05,9.99 ( 0.91 %),7882,20478400,2598.12,4447,23242100,5226,-2763700
2022-05-04,9.92 ( -2.75 %),7904,20441900,2586.27,4288,23984700,5593,-3542800
2022-04-29,10.2 ( 0.99 %),8454,33634400,3978.52,6067,29669900,4890,3964500
2022-04-28,10.05 ( -1.47 %),7733,20209400,2613.4,5701,25756200,4518,-5546800
2022-04-27,10.2 ( 5.15 %),9319,35300000,3787.96,6331,32936300,5202,2363700
2022-04-26,9.74 ( 7.03 %),0,0,0,0,0,0,0
2022-04-25,9.12 ( -6.94 %),9903,28772500,2905.43,5793,39621500,6840,-10849000
2022-04-22,9.8 ( -2.97 %),10070,29393300,2918.9,4796,27938300,5825,1455000
2022-04-21,10.1 ( 0 %),12841,55309800,4307.28,8580,44103100,5140,11206700
2022-04-20,10.1 ( -6.91 %),12197,38349400,3144.17,5664,42237100,7457,-3887700
2022-04-18,11.6 ( -4.13 %),10407,37683300,3620.96,5266,31850300,6048,5833000
2022-04-15,12.05 ( 6.64 %),10226,55148100,5392.93,7798,36918700,4734,18229400
2022-04-14,11.3 ( -7.38 %),14328,41425300,2891.21,5118,42632200,8330,-1206900
2022-04-13,12.15 ( 4.74 %),12505,53790700,4301.54,6394,30515100,4772,23275600
2022-04-12,0 ( 0 %),13573,45240300,3333.11,6792,49120600,7232,-3880300
2022-04-08,12.4 ( -6.77 %),23074,81169500,3517.79,12081,80433300,6658,736200
2022-04-07,13.3 ( 0 %),6281,29347400,4672.41,8082,31183200,3858,-1835800
2022-04-06,13.25 ( 0.38 %),8193,38363500,4682.47,9618,38272400,3979,91100
2022-04-05,13.2 ( -1.49 %),7602,26216500,3448.63,6620,27387500,4137,-1171000
2022-04-04,13.35 ( 1.14 %),7228,29980700,4147.86,8199,33021500,4028,-3040800
2022-04-01,13.15 ( 0.38 %),13667,50831400,3719.28,8344,43205700,5178,7625700
2022-03-31,13.1 ( -4.38 %),12528,39870700,3182.53,11312,51424200,4546,-11553500
2022-03-30,13.65 ( 1.87 %),14779,80913600,5474.9,18317,79418500,4336,1495100
2022-03-29,13.4 ( 0.75 %),9956,37530100,3769.6,8573,38912100,4539,-1382000
2022-03-28,13.3 ( 0.76 %),23603,77569000,3286.4,12901,77748200,6027,-179200
2022-03-25,13.15 ( -1.87 %),15707,48663700,3098.22,10476,48130100,4594,533600
2022-03-24,13.35 ( 1.14 %),15395,68865000,4473.21,14056,57789100,4111,11075900
2022-03-23,13.15 ( -0.38 %),13822,40644400,2940.56,13553,51556600,3804,-10912200
2022-03-22,13.15 ( 6.91 %),20458,87488400,4276.49,15214,64675600,4251,22812800
2022-03-21,12.3 ( 2.5 %),10024,50571400,5045.03,11204,49537300,4421,1034100
2022-03-18,11.95 ( -1.24 %),8026,27381600,3411.61,9203,41467000,4506,-14085400
2022-03-17,12.1 ( 5.22 %),15327,61573600,4017.33,9056,54120100,5976,7453500
2022-03-16,11.5 ( -2.54 %),11744,45722600,3893.27,6103,51512400,8441,-5789800
2022-03-15,11.75 ( 0.43 %),9551,36830300,3856.17,5388,39156100,7267,-2325800
2022-03-14,11.7 ( -5.65 %),0,0,0,0,0,0,0
2022-03-11,12.4 ( 1.64 %),12616,75450900,5980.57,15087,69218300,4588,6232600
2022-03-10,12.15 ( 1.25 %),7966,37224900,4672.97,9807,49325500,5030,-12100600
2022-03-09,11.95 ( 2.14 %),18285,77228300,4223.59,10487,70826900,6754,6401400
2022-03-08,11.7 ( -6.4 %),14321,38531400,2690.55,8585,45575300,5309,-7043900
2022-03-07,12.5 ( 5.04 %),14564,41489000,2848.74,11366,43582500,3834,-2093500
2022-03-04,11.9 ( 6.25 %),15594,70093000,4494.87,11531,51002300,4423,19090700
2022-03-03,11.15 ( -1.33 %),10703,32660700,3051.55,8580,35426800,4129,-2766100
2022-03-02,11.25 ( 2.27 %),12728,52239800,4104.32,13464,54699500,4063,-2459700
2022-03-01,10.95 ( 6.31 %),9337,48627400,5208.03,6439,24185800,3756,24441600
2022-02-28,10.25 ( 0.49 %),8957,49127600,5484.83,6907,33265200,4816,15862400
2022-02-25,10.2 ( -2.86 %),16541,60805200,3676.03,8689,49739600,5724,11065600
2022-02-24,10.5 ( -7.08 %),20472,59778200,2920,10094,75945100,7524,-16166900
2022-02-23,11.25 ( -2.17 %),9571,28228700,2949.4,6983,32341300,4631,-4112600
2022-02-22,11.5 ( 1.77 %),9679,55536900,5737.88,10194,38020300,3730,17516600
2022-02-21,11.3 ( 2.73 %),9939,38889300,3912.8,7531,28793000,3823,10096300
2022-02-18,11 ( -1.79 %),12413,41308000,3327.8,8225,36443300,4431,4864700
2022-02-17,11.15 ( 0.45 %),13700,34030900,2484.01,6213,29591700,4763,4439200
2022-02-16,11.1 ( -5.13 %),12130,28230000,2327.29,7796,34025200,4364,-5795200
2022-02-15,11.65 ( 0.43 %),15148,62749200,4142.41,18021,88614300,4917,-25865100
2022-02-14,11.55 ( -6.85 %),5617,11587100,2062.86,9849,66787400,6781,-55200300
2022-02-11,12.4 ( -2.36 %),8591,26596700,3095.88,7382,34674100,4697,-8077400
2022-02-10,12.65 ( 1.2 %),10063,44348600,4407.1,7021,33368900,4753,10979700
2022-02-09,12.45 ( 2.05 %),7699,33062500,4294.39,5553,24802500,4467,8260000
2022-02-08,12.2 ( 3.39 %),6365,21358000,3355.54,5033,19776900,3929,1581100
2022-02-07,11.8 ( 0 %),7153,28193900,3941.55,4355,23863600,5480,4330300
2022-01-28,11.8 ( -7.09 %),12095,84512000,6987.35,10194,61315900,6015,23196100
2022-01-27,12.65 ( -0.39 %),6104,34690000,5683.16,5393,20298100,3764,14391900
2022-01-26,12.65 ( 6.3 %),15246,73630800,4829.52,10548,50582500,4795,23048300
2022-01-25,11.85 ( -6.69 %),0,0,0,0,0,0,0
2022-01-24,12.7 ( -7.3 %),14817,48350900,3263.2,7786,66952800,8599,-18601900
2022-01-21,13.65 ( 1.87 %),11362,34581100,3043.58,6106,34130400,5590,450700
2022-01-20,13.85 ( -0.36 %),19830,63490600,3201.74,9724,60872900,6260,2617700
2022-01-19,14.3 ( -4.03 %),14234,49881600,3504.4,8710,57589600,6612,-7708000
2022-01-18,14.9 ( -4.79 %),12409,44402500,3578.25,11425,52541400,4599,-8138900
2022-01-17,15.65 ( 4.68 %),17971,75744900,4214.84,17863,69874200,3912,5870700
2022-01-14,14.95 ( 6.79 %),11903,63227000,5311.85,8440,29470300,3492,33756700
2022-01-13,14 ( -6.04 %),20981,88151500,4201.49,15068,87349900,5797,801600
2022-01-12,14.85 ( -2.94 %),23865,94604600,3964.16,17759,85451300,4812,9153300
2022-01-11,15.25 ( -0.33 %),15727,46175400,2936.06,15672,61867400,3948,-15692000
2022-01-10,15.3 ( 6.99 %),24289,95171200,3918.28,15573,76116400,4888,19054800
2022-01-07,14.3 ( 0.7 %),17331,73848700,4261.08,16986,69539700,4094,4309000
2022-01-06,14.2 ( 2.16 %),14679,43519600,2964.75,12621,51109900,4050,-7590300
2022-01-05,13.9 ( 6.92 %),20210,75728900,3747.1,11679,52084100,4460,23644800
2022-01-04,13 ( -2.26 %),27559,63802300,2315.12,11578,64480400,5569,-678100
2021-12-31,13.3 ( -6.99 %),27795,67426600,2425.85,10694,75646400,7074,-8219800
2021-12-30,14.25 ( -1.72 %),9420,29749400,3158.11,10119,43770800,4326,-14021400
2021-12-29,14.45 ( 6.25 %),17590,63469500,3608.27,9821,48842400,4973,14627100
2021-12-28,13.55 ( -6.55 %),27526,79242800,2878.83,11019,90914900,8251,-11672100
2021-12-27,14.5 ( 2.11 %),15773,71364700,4524.48,9752,50919600,5221,20445100
2021-12-24,14.2 ( -4.7 %),20116,73843900,3670.9,10503,58288700,5550,15555200
2021-12-23,14.9 ( 2.76 %),28581,83010100,2904.38,15331,95117200,6204,-12107100
2021-12-22,14.5 ( 6.62 %),18262,53846000,2948.53,9540,47822400,5013,6023600
2021-12-21,13.6 ( 6.67 %),15259,68563000,4493.28,9948,49156100,4941,19406900
2021-12-20,12.75 ( 4.94 %),25037,124609000,4976.99,15543,93120500,5991,31488500
2021-12-17,12.15 ( -6.9 %),19555,68716300,3514,10415,83435500,8011,-14719200
2021-12-16,13.05 ( 6.97 %),16563,73628500,4445.36,9402,48444400,5153,25184100
2021-12-15,12.2 ( 1.67 %),23921,81563500,3409.7,13947,84622300,6067,-3058800
2021-12-14,12 ( 6.67 %),26622,109940300,4129.68,11346,84135800,7415,25804500
2021-12-13,11.25 ( 6.64 %),9136,52395600,5735.07,4374,20666300,4725,31729300
2021-12-10,10.55 ( 3.43 %),17086,71384800,4177.97,11978,61524900,5136,9859900
2021-12-09,10.2 ( 3.34 %),22628,97233700,4297.05,15176,78967000,5203,18266700
2021-12-08,9.87 ( 6.93 %),11298,83190000,7363.25,7894,48105000,6094,35085000
2021-12-07,9.23 ( 6.95 %),9993,85701700,8576.17,8512,46282100,5437,39419600
2021-12-06,8.63 ( -1.93 %),11628,49609600,4266.39,10993,64776400,5893,-15166800
2021-12-03,8.8 ( 0 %),18086,74497400,4119.06,13242,73350100,5539,1147300
2021-12-02,8.8 ( 1.15 %),11824,45800100,3873.49,11414,51118400,4479,-5318300
2021-12-01,8.7 ( 5.71 %),14641,79185400,5408.47,14038,68373300,4871,10812100
2021-11-30,8.23 ( 6.88 %),12878,78277600,6078.4,4942,41136300,8324,37141300
2021-11-29,7.69 ( 6.81 %),10630,51877200,4880.26,5271,26570600,5041,25306600
2021-11-26,7.2 ( -4 %),10991,35167000,3199.62,6495,51934100,7996,-16767100
2021-11-25,7.5 ( 6.23 %),10422,59678700,5726.22,6225,43305800,6957,16372900
2021-11-24,7.06 ( -1.26 %),8994,30453600,3385.99,4270,33471700,7839,-3018100
2021-11-23,7.15 ( -4.03 %),11364,51104000,4497.01,7685,64888900,8444,-13784900
2021-11-22,7.45 ( -6.99 %),11568,53280600,4605.86,10664,107206900,10053,-53926300
2021-11-19,8.01 ( -6.97 %),15349,54186100,3530.27,8365,84409700,10091,-30223600
2021-11-18,8.61 ( 5 %),9908,75008000,7570.45,7090,50273300,7091,24734700
2021-11-17,8.2 ( -0.97 %),11191,77578400,6932.21,9004,56850400,6314,20728000
2021-11-16,8.28 ( 1.6 %),16058,83801800,5218.69,10347,70042900,6769,13758900
2021-11-15,8.15 ( 6.96 %),12771,61992000,4854.12,5390,43666700,8101,18325300
2021-11-12,7.62 ( 6.87 %),14713,73971100,5027.6,6161,54094300,8780,19876800
2021-11-11,7.13 ( 6.42 %),11254,68091900,6050.46,6582,51225000,7783,16866900
2021-11-10,6.7 ( 2.13 %),0,0,0,0,0,0,0
2021-11-09,6.56 ( 6.84 %),13762,89536600,6506.07,9077,64682800,7126,24853800
2021-11-08,6.14 ( 6.97 %),8098,52790100,6518.91,3405,26455200,7770,26334900
2021-11-05,5.74 ( 6.89 %),7409,59911300,8086.29,5240,37714300,7197,22197000
2021-11-04,5.37 ( 0.19 %),4296,23328300,5430.24,2660,20091900,7553,3236400
2021-11-03,5.36 ( -3.6 %),6915,34365300,4969.67,5205,36204100,6956,-1838800
2021-11-02,5.56 ( 0.91 %),9055,41219300,4552.1,5972,44399700,7435,-3180400
2021-11-01,5.51 ( 6.99 %),7281,60130100,8258.49,4787,35328300,7380,24801800
2021-10-29,5.15 ( -0.19 %),3567,15721900,4407.6,3308,22074900,6673,-6353000
2021-10-28,5.16 ( 2.38 %),5680,35979800,6334.47,4700,34258700,7289,1721100
2021-10-27,5.04 ( 0.2 %),4198,15334000,3652.69,1591,16902300,10624,-1568300
2021-10-26,5.03 ( -0.4 %),3565,13191900,3700.39,1513,14590300,9643,-1398400
2021-10-25,5.05 ( 0 %),4251,17681000,4159.26,1549,17120800,11053,560200
2021-10-22,5.05 ( -0.59 %),2748,10102200,3676.2,1548,11000000,7106,-897800
2021-10-21,5.08 ( 0.79 %),2543,11953600,4700.59,1642,13960700,8502,-2007100
2021-10-20,5.04 ( 0 %),2878,10301500,3579.4,1180,10309900,8737,-8400
2021-10-19,5.04 ( -0.59 %),2840,8533700,3004.82,1162,9375000,8068,-841300
2021-10-18,5.07 ( -0.59 %),1792,6889700,3844.7,1586,8610600,5429,-1720900
2021-10-15,5.1 ( -1.92 %),2039,8368200,4104.07,2368,13196500,5573,-4828300
2021-10-14,5.2 ( 3.17 %),3074,36695600,11937.41,3932,25291200,6432,11404400
2021-10-13,5.04 ( 0.4 %),2246,10439800,4648.17,1276,8208200,6433,2231600
2021-10-12,5.02 ( -0.4 %),3127,9419000,3012.15,1209,10591600,8761,-1172600
2021-10-11,5.04 ( -0.98 %),2607,10325400,3960.64,1445,13219000,9148,-2893600
2021-10-08,5.09 ( 0.99 %),1968,8794700,4468.85,1837,11728400,6385,-2933700
2021-10-07,5.04 ( 0.2 %),2219,7792500,3511.72,1131,7988400,7063,-195900
2021-10-06,5.03 ( 0.4 %),2104,9417600,4476.05,1210,12141200,10034,-2723600
2021-10-05,5.01 ( 0.2 %),1772,5808300,3277.82,929,8509100,9159,-2700800
2021-10-04,5 ( 0 %),1932,6081000,3147.52,1161,8249700,7106,-2168700
2021-10-01,5 ( -1.19 %),2079,6491300,3122.32,1027,8560000,8335,-2068700
2021-09-30,5.06 ( -0.2 %),1239,5777900,4663.36,918,7289500,7941,-1511600
2021-09-29,5.07 ( 0.2 %),1554,7956900,5120.27,1085,7661700,7061,295200
2021-09-28,5.06 ( 1 %),2739,10468000,3821.83,1295,6336200,4893,4131800
2021-09-27,5.01 ( -4.39 %),2997,11535500,3849.02,1946,13412900,6893,-1877400
2021-09-24,5.24 ( 0 %),1897,7509100,3958.41,1471,10142800,6895,-2633700
2021-09-23,5.24 ( -4.38 %),4617,14398800,3118.65,3088,22797000,7382,-8398200
2021-09-22,5.48 ( 6.82 %),7363,37268100,5061.54,2820,24041300,8525,13226800
2021-09-21,5.13 ( -1.35 %),1919,7750500,4038.82,1084,8499300,7841,-748800
2021-09-20,5.2 ( 0.97 %),2338,12620700,5398.08,2015,13322600,6612,-701900
2021-09-17,5.15 ( 3 %),1929,13669900,7086.52,2481,17504400,7055,-3834500
2021-09-16,5 ( -0.2 %),1410,5376700,3813.26,880,6972900,7924,-1596200
2021-09-15,5.01 ( 0 %),1397,4745000,3396.56,876,5712800,6521,-967800
2021-09-14,5.01 ( -1.76 %),1164,3744600,3217.01,952,7376400,7748,-3631800
2021-09-13,5.1 ( 2.41 %),1535,8310600,5414.07,1275,8897600,6979,-587000
2021-09-10,4.98 ( -1.78 %),1781,6630200,3722.74,900,6022000,6691,608200
2021-09-09,5.07 ( 0.6 %),1807,6085500,3367.74,847,6605600,7799,-520100
2021-09-08,5.04 ( -1.18 %),1832,4224000,2305.68,736,5734400,7791,-1510400
2021-09-07,5.1 ( -1.54 %),1167,3855500,3303.77,1185,5999700,5063,-2144200
2021-09-06,5.18 ( 0.97 %),1658,6150700,3709.71,1221,7173400,5875,-1022700
2021-09-01,5.13 ( 0.59 %),1186,4795800,4043.68,1390,6318500,4546,-1522700
2021-08-31,5.1 ( 0.99 %),1357,4876200,3593.37,1237,4472200,3615,404000
2021-08-30,5.05 ( 0 %),1210,3974200,3284.46,907,5013900,5528,-1039700
2021-08-27,5.05 ( 0.6 %),1176,3890700,3308.42,670,4178900,6237,-288200
2021-08-26,5.02 ( 0.4 %),1045,3366700,3221.72,775,4162500,5371,-795800
2021-08-25,5 ( 0 %),920,3415600,3712.61,588,3147800,5353,267800
2021-08-24,5 ( 0 %),1031,3539300,3432.88,877,3995300,4556,-456000
2021-08-23,5 ( -2.15 %),1387,4447800,3206.78,817,4800800,5876,-353000
2021-08-20,5.11 ( 0 %),2630,8529800,3243.27,1009,8312100,8238,217700
2021-08-19,5.11 ( -2.67 %),1535,5621700,3662.35,808,6246000,7730,-624300
2021-08-18,5.25 ( -0.38 %),830,4786500,5766.87,880,9694100,11016,-4907600
2021-08-17,5.27 ( 2.13 %),1417,9942200,7016.37,1156,20753500,17953,-10811300
2021-08-16,5.16 ( -0.77 %),1694,6676700,3941.38,917,6685500,7291,-8800
2021-08-13,5.2 ( -0.95 %),1266,4679000,3695.89,1023,5438200,5316,-759200
2021-08-12,5.25 ( -2.05 %),1209,4361700,3607.69,1119,6612600,5909,-2250900
2021-08-11,5.36 ( -0.56 %),1040,5308300,5104.13,1307,7317400,5599,-2009100
2021-08-10,5.39 ( -0.19 %),1135,6483300,5712.16,1202,7269200,6048,-785900
2021-08-09,5.4 ( -0.92 %),1245,7130200,5727.07,1065,5821900,5467,1308300
2021-08-06,5.45 ( -0.18 %),1781,6896500,3872.26,1679,8842800,5267,-1946300
2021-08-05,5.46 ( 6.02 %),2462,8837900,3589.72,1824,8330400,4567,507500
2021-08-04,5.2 ( 2.16 %),1297,7653000,5900.54,1393,6912600,4962,740400
2021-08-03,5.09 ( 0.99 %),1110,6137900,5529.64,1146,4655700,4063,1482200
2021-08-02,5.04 ( 0.6 %),1247,5140700,4122.45,1256,5688000,4529,-547300
2021-07-30,5.01 ( -0.6 %),980,3428000,3497.96,865,3633400,4200,-205400
2021-07-29,5.04 ( 0.8 %),1070,5319300,4971.31,1031,4454000,4320,865300
2021-07-28,5 ( 0 %),1201,3915300,3260.03,976,5287400,5417,-1372100
2021-07-27,5 ( 4.6 %),1505,5920900,3934.15,1135,5865000,5167,55900
2021-07-26,4.78 ( -2.45 %),2233,12705800,5690.01,1158,12808000,11060,-102200
2021-07-23,4.9 ( -2.97 %),841,2233300,2655.53,523,2832000,5415,-598700
2021-07-22,5.05 ( 2.02 %),876,3945500,4504,608,3382300,5563,563200
2021-07-21,4.95 ( -0.2 %),797,2262400,2838.64,472,2284500,4840,-22100
2021-07-20,4.96 ( 1.02 %),808,2338700,2894.43,478,2334800,4885,3900
2021-07-19,4.91 ( -3.54 %),1069,3970300,3714.03,619,4170800,6738,-200500
2021-07-16,5.09 ( -0.39 %),828,3341700,4035.87,550,4670300,8491,-1328600
2021-07-15,5.11 ( 0.2 %),682,2686500,3939.15,561,4760000,8485,-2073500
2021-07-14,5.1 ( 0 %),803,3782600,4710.59,600,4062200,6770,-279600
2021-07-13,5.1 ( 4.94 %),1085,3823100,3523.59,614,3565800,5807,257300
2021-07-12,4.86 ( -6.9 %),1418,7535000,5313.82,745,8386600,11257,-851600
2021-07-09,5.22 ( -2.25 %),911,3148700,3456.31,656,3895600,5938,-746900
2021-07-08,5.34 ( 2.69 %),0,0,0,0,0,0,0
2021-07-07,5.2 ( -2.44 %),1426,7045400,4940.67,634,6114600,9644,930800
2021-07-06,5.33 ( -3.96 %),0,0,0,0,0,0,0
2021-07-02,5.75 ( -0.86 %),0,0,0,0,0,0,0
2021-07-01,5.8 ( -1.69 %),1452,7533400,5188.29,1086,9961900,9173,-2428500
2021-06-30,5.9 ( -2.32 %),1042,4862600,4666.6,991,6949900,7013,-2087300
2021-06-29,6.04 ( 0.5 %),1119,6827800,6101.7,1279,9347200,7308,-2519400
2021-06-28,6.01 ( 0.17 %),0,0,0,0,0,0,0
2021-06-25,6 ( -0.17 %),1229,7128600,5800.33,1441,8494400,5895,-1365800
2021-06-24,6.01 ( -1.64 %),1254,10252000,8175.44,1735,12643100,7287,-2391100
2021-06-23,6.11 ( -0.81 %),1181,14715800,12460.46,1975,14792900,7490,-77100
2021-06-22,0 ( 0 %),1459,12363800,8474.16,2614,20219400,7735,-7855600
2021-06-21,6.2 ( 2.48 %),2509,21538600,8584.54,2787,21997700,7893,-459100
2021-06-18,6.05 ( 0.83 %),1629,12722200,7809.82,2922,16354400,5597,-3632200
2021-06-17,6 ( -0.33 %),1504,9926100,6599.8,2135,11362900,5322,-1436800
2021-06-16,6.02 ( 0.17 %),1677,16238200,9682.89,2523,15250100,6044,988100
2021-06-15,6.01 ( 5.07 %),2556,20914100,8182.36,3361,18728300,5572,2185800
2021-06-14,5.72 ( 4.19 %),2715,14055500,5176.98,2530,15219600,6016,-1164100
2021-06-11,5.49 ( -0.18 %),976,5012500,5135.76,1428,8432700,5905,-3420200
2021-06-10,5.5 ( 0.18 %),1311,9197500,7015.64,2339,12960800,5541,-3763300
2021-06-09,5.49 ( 0.55 %),699,7286300,10423.89,1360,8192900,6024,-906600
2021-06-08,5.46 ( 1.49 %),1489,14633200,9827.54,2726,14966100,5490,-332900
2021-06-07,5.38 ( 1.89 %),1242,6558400,5280.52,906,6226000,6872,332400
2021-06-04,5.28 ( 0.38 %),1586,8895500,5608.76,1829,11515500,6296,-2620000
2021-06-03,5.26 ( 0.96 %),0,0,0,0,0,0,0
2021-06-02,5.21 ( 1.96 %),1550,6649000,4289.68,1153,5512800,4781,1136200
2021-06-01,5.11 ( -0.39 %),1090,4572500,4194.95,803,4924200,6132,-351700
2021-05-31,5.13 ( -1.72 %),1187,5635300,4747.51,973,6138800,6309,-503500
2021-05-28,5.22 ( 0.38 %),1516,8360600,5514.91,911,6184300,6788,2176300
2021-05-27,5.2 ( -2.8 %),999,4906200,4911.11,1063,7188000,6762,-2281800
2021-05-26,5.35 ( 1.9 %),1691,9539300,5641.22,1847,10042100,5437,-502800
2021-05-25,5.25 ( 0.57 %),1083,6424700,5932.32,1061,6918900,6521,-494200
2021-05-24,5.22 ( -0.38 %),1013,4972900,4909.08,930,4752400,5110,220500
2021-05-21,5.24 ( 1.16 %),1145,5550200,4847.34,1010,5400700,5347,149500
2021-05-20,5.18 ( -1.33 %),1217,6372500,5236.24,959,6017600,6275,354900
2021-05-19,5.25 ( -0.76 %),1010,5913200,5854.65,928,6024100,6491,-110900
2021-05-18,5.29 ( -2.22 %),1432,6900700,4818.92,977,5032100,5151,1868600
2021-05-17,5.41 ( -2.87 %),1401,7629600,5445.82,1388,9608100,6922,-1978500
2021-05-14,5.57 ( -0.18 %),1122,7312700,6517.56,1595,8723400,5469,-1410700
2021-05-13,5.58 ( -0.36 %),2157,11071100,5132.64,1883,15573700,8271,-4502600
2021-05-12,5.6 ( 6.87 %),1965,15760200,8020.46,1665,10679000,6414,5081200
2021-05-11,5.24 ( -0.19 %),1094,8264000,7553.93,1219,7843000,6434,421000
2021-05-10,5.25 ( -0.94 %),919,11761200,12797.82,1337,12881500,9635,-1120300
2021-05-07,5.3 ( -1.12 %),847,12847300,15168,1501,13652300,9095,-805000
2021-05-06,5.36 ( 0 %),1164,11605400,9970.27,1400,9777400,6984,1828000
2021-05-05,5.36 ( 1.52 %),1600,13136900,8210.56,1480,11189700,7561,1947200
2021-05-04,5.28 ( -2.94 %),1813,12887600,7108.44,1677,14739500,8789,-1851900
2021-04-29,5.44 ( 0.74 %),1281,11473000,8956.28,1719,16970700,9872,-5497700
2021-04-28,5.4 ( 1.89 %),674,10172400,15092.58,1239,7356600,5938,2815800
2021-04-27,5.3 ( -0.56 %),1270,12135500,9555.51,1871,11812700,6314,322800
2021-04-23,5.04 ( -6.84 %),1611,12462200,7735.69,4173,50518100,12106,-38055900
2021-04-22,0 ( 0 %),1898,19219200,10126.03,5115,77079200,15069,-57860000
2021-04-20,5.81 ( -1.86 %),2126,16094500,7570.32,2367,19078600,8060,-2984100
2021-04-19,5.92 ( -1.17 %),2727,21236000,7787.31,2624,23769100,9058,-2533100
2021-04-16,5.99 ( -1.64 %),3558,23838900,6700.08,3455,32115200,9295,-8276300
2021-04-15,6.09 ( 0.66 %),5130,29058100,5664.35,3523,32377100,9190,-3319000
2021-04-14,6.05 ( -0.66 %),4531,31414000,6933.13,4401,36414100,8274,-5000100
2021-04-13,6.09 ( -2.25 %),4652,27583500,5929.39,5764,42372800,7351,-14789300
2021-04-12,6.23 ( 6.86 %),6619,49098300,7417.78,4460,32576000,7304,16522300
2021-04-09,5.83 ( 1.57 %),2109,17881300,8478.57,3304,22452200,6795,-4570900
2021-04-08,5.74 ( 0.35 %),1929,11980600,6210.78,2226,16728300,7515,-4747700
2021-04-07,5.72 ( 1.06 %),2407,20768800,8628.5,3316,21091500,6361,-322700
2021-04-06,5.66 ( 0 %),1589,13438300,8457.08,2330,17545300,7530,-4107000
2021-04-05,5.66 ( 0 %),1806,15388300,8520.65,2579,19331800,7496,-3943500
2021-04-02,5.66 ( 1.43 %),2099,17860100,8508.86,3224,19091700,5922,-1231600
2021-04-01,5.58 ( 0.54 %),2003,15543700,7760.21,2806,16941400,6038,-1397700
2021-03-31,5.55 ( -0.72 %),2108,13038000,6185.01,2807,19331300,6887,-6293300
2021-03-30,5.59 ( 2.01 %),3515,16577000,4716.07,4531,23953400,5287,-7376400
2021-03-29,5.48 ( 6.82 %),3203,32721100,10215.77,2897,19138900,6606,13582200
2021-03-26,5.13 ( -0.39 %),1816,13342700,7347.3,1691,14702800,8695,-1360100
2021-03-25,5.15 ( -0.77 %),1178,8889000,7545.84,1659,12507800,7539,-3618800
2021-03-24,5.19 ( -0.76 %),1521,11966300,7867.39,1578,12111900,7675,-145600
2021-03-23,5.23 ( -0.57 %),1357,11259100,8297.05,1658,11813800,7125,-554700
2021-03-22,5.26 ( 1.35 %),1870,16564000,8857.75,2535,15441300,6091,1122700
2021-03-19,5.19 ( -0.57 %),1611,11652000,7232.77,1832,13957700,7619,-2305700
2021-03-18,5.22 ( 0 %),1342,9302800,6932.04,2117,14922500,7049,-5619700
2021-03-17,5.22 ( -0.19 %),1843,14049700,7623.28,2707,16927000,6253,-2877300
2021-03-16,5.23 ( -0.19 %),1814,14150400,7800.66,2383,18278200,7670,-4127800
2021-03-15,5.24 ( 3.56 %),3248,2164580,666.43,3553,2025910,570,138670
2021-03-12,5.06 ( -0.98 %),2170,15629200,7202.4,2307,19510700,8457,-3881500
2021-03-11,5.11 ( -0.58 %),1625,11075800,6815.88,2521,16971500,6732,-5895700
2021-03-10,5.14 ( 2.8 %),2995,19671600,6568.15,3356,19484700,5806,186900
2021-03-09,5 ( 3.09 %),0,0,0,0,0,0,0
2021-03-08,4.85 ( 0.21 %),1939,1138780,587.3,2085,1448390,695,-309610
2021-03-05,4.84 ( 0.83 %),1782,8400700,4714.2,1581,10201800,6453,-1801100
2021-03-04,4.8 ( -0.62 %),2690,16991600,6316.58,3371,20633700,6121,-3642100
2021-03-03,4.83 ( 2.55 %),2315,11386200,4918.44,1821,8674200,4763,2712000
2021-03-02,4.71 ( 0.21 %),1614,855900,530.3,1958,1103480,564,-247580
2021-03-01,4.7 ( 0 %),1950,7374300,3781.69,1864,10415800,5588,-3041500
2021-02-26,4.7 ( 2.17 %),2324,11967800,5149.66,2194,10523700,4797,1444100
2021-02-25,4.6 ( -0.43 %),2915,12583800,4316.91,1472,10484600,7123,2099200
2021-02-24,4.62 ( -1.28 %),2677,12650600,4725.66,1897,12251400,6458,399200
2021-02-23,4.68 ( -2.3 %),3924,16671900,4248.7,2123,16312700,7684,359200
2021-02-22,4.79 ( -0.42 %),2304,9923600,4307.12,2122,12658700,5965,-2735100
2021-02-19,4.81 ( -0.82 %),2220,11094900,4997.7,2054,12229800,5954,-1134900
2021-02-18,4.85 ( 0.41 %),2632,14687200,5580.24,2578,14131900,5482,555300
2021-02-17,4.83 ( 5.92 %),2454,12745900,5193.93,2053,10844600,5282,1901300
2021-02-09,4.56 ( 5.31 %),2512,1672780,665.92,1941,1132250,583,540530
2021-02-08,4.33 ( -5.04 %),3180,1176740,370.04,1478,1915300,1296,-738560
2021-02-05,4.56 ( 2.24 %),1840,11859200,6445.22,1707,9191000,5384,2668200
2021-02-04,4.46 ( 0.22 %),2440,11321300,4639.88,1721,13773000,8003,-2451700
2021-02-03,4.45 ( 4.46 %),3068,16665100,5431.91,2070,13409100,6478,3256000
2021-02-02,4.26 ( -5.33 %),3218,15560000,4835.3,2263,16601000,7336,-1041000
2021-02-01,4.5 ( -6.83 %),3596,18134500,5042.96,2444,30587200,12515,-12452700
2021-01-29,4.83 ( 0.84 %),4139,26667900,6443.08,2637,23694700,8985,2973200
2021-01-28,4.79 ( -6.99 %),3083,16043600,5203.89,3253,32004300,9838,-15960700
2021-01-27,5.15 ( -6.87 %),4076,21911200,5375.66,2680,29396000,10969,-7484800
2021-01-26,5.53 ( -5.15 %),4637,2255290,486.37,2652,3675620,1386,-1420330
2021-01-25,5.83 ( 0.52 %),3378,1605260,475.21,3616,2118750,586,-513490
2021-01-22,5.8 ( -3.33 %),5001,2030470,406.01,3507,3168830,904,-1138360
2021-01-21,6 ( 5.26 %),4424,22213700,5021.18,2754,19929200,7236,2284500
2021-01-20,5.7 ( -2.73 %),5494,43689200,7952.17,4186,49343900,11788,-5654700
2021-01-19,5.86 ( -6.98 %),4639,21800400,4699.37,4338,46526600,10725,-24726200
2021-01-18,6.3 ( -1.41 %),4940,29070200,5884.66,4171,31738000,7609,-2667800
2021-01-15,6.39 ( 5.27 %),4700,41389000,8806.17,5542,37017500,6679,4371500
2021-01-14,6.07 ( 1.17 %),6311,36318100,5754.73,3947,41239400,10448,-4921300
2021-01-13,6 ( -4.31 %),9554,41503400,4344.09,5152,54352700,10550,-12849300
2021-01-12,6.27 ( -1.42 %),6269,27233300,4344.12,3721,28750500,7727,-1517200
2021-01-11,6.36 ( 5.47 %),7174,53244600,7421.88,6355,53134500,8361,110100
2021-01-08,6.03 ( 6.91 %),8422,60696900,7206.95,4269,47770800,11190,12926100
2021-01-07,5.64 ( 6.82 %),5458,44779600,8204.4,2952,18724200,6343,26055400
2021-01-06,5.28 ( -1.49 %),3684,17716800,4809.12,2705,26405200,9762,-8688400
2021-01-05,5.36 ( 1.32 %),2951,17061900,5781.74,2710,21751700,8026,-4689800
2021-01-04,5.29 ( 0.76 %),0,0,0,0,0,0,0
2020-12-31,5.25 ( -0.57 %),0,0,0,0,0,0,0
2020-12-30,5.28 ( -3.3 %),3787,16496930,4356.2,3168,23632990,7460,-7136060
2020-12-29,5.46 ( 0.92 %),3856,23625630,6126.98,4616,31490160,6822,-7864530
2020-12-28,5.41 ( 4.04 %),5157,45056860,8737.03,5130,45903180,8948,-846320
2020-12-25,5.2 ( 1.36 %),3917,18478590,4717.54,2370,19223990,8111,-745400
2020-12-24,5.13 ( -1.35 %),5789,28812610,4977.13,3057,34867190,11406,-6054580
2020-12-23,5.2 ( -3.17 %),3901,19958980,5116.38,3120,31759460,10179,-11800480
2020-12-22,5.37 ( 0.75 %),0,0,0,0,0,0,0
2020-12-21,5.33 ( 2.7 %),5590,36728390,6570.37,3686,33238600,9018,3489790
2020-12-18,5.19 ( 0.78 %),4016,24621140,6130.76,2880,22548660,7829,2072480
2020-12-17,5.15 ( -0.96 %),4985,30656320,6149.71,4169,33369790,8004,-2713470
2020-12-16,5.2 ( 5.05 %),4086,36570620,8950.23,4186,33658450,8041,2912170
2020-12-15,4.95 ( 2.91 %),5522,51839430,9387.8,6349,53828190,8478,-1988760
2020-12-14,4.81 ( 1.69 %),2336,23740840,10163.03,2268,17660640,7787,6080200
2020-12-11,4.73 ( -0.21 %),1705,8971250,5261.73,1668,12034290,7215,-3063040
2020-12-10,4.74 ( 1.28 %),3322,34754250,10461.85,4506,35479230,7874,-724980
2020-12-09,4.68 ( -0.21 %),2921,15469950,5296.11,1826,15654910,8573,-184960
2020-12-08,4.69 ( -1.47 %),0,0,0,0,0,0,0
2020-12-07,4.76 ( 1.49 %),2968,29938470,10087.09,3505,24301230,6933,5637240
2020-12-04,4.69 ( 3.3 %),3606,33361670,9251.71,4637,30959120,6677,2402550
2020-12-03,4.54 ( 0.22 %),2455,14719840,5995.86,1493,13586160,9100,1133680
2020-12-02,4.53 ( -1.31 %),1764,10859010,6155.9,1551,14603580,9416,-3744570
2020-12-01,4.59 ( 1.55 %),2782,36862440,13250.34,2123,25254600,11896,11607840
2020-11-30,4.52 ( -2.8 %),2656,15001100,5648,1579,17523140,11098,-2522040
2020-11-27,4.65 ( -2.52 %),1884,10941330,5807.5,2686,17919670,6672,-6978340
2020-11-26,4.77 ( 4.15 %),2852,28306720,9925.22,4397,32371290,7362,-4064570
2020-11-25,4.58 ( 2.92 %),2854,19998770,7007.28,2998,23716870,7911,-3718100
2020-11-23,0 ( 0 %),2759,14661720,5314.14,1908,19211950,10069,-4550230
2020-11-20,4.55 ( 2.94 %),2123,13338550,6282.88,1262,14905950,11811,-1567400
2020-11-19,4.42 ( -1.34 %),2151,8033880,3734.95,1093,10141050,9278,-2107170
2020-11-18,4.48 ( -1.32 %),1454,7057070,4853.56,1141,9432420,8267,-2375350
2020-11-17,4.54 ( 0.22 %),1009,5556520,5506.96,1434,7386840,5151,-1830320
2020-11-16,4.53 ( 0 %),1266,6246810,4934.29,1380,9179020,6651,-2932210
2020-11-13,4.53 ( 1.57 %),1533,6235210,4067.33,1390,6807370,4897,-572160
2020-11-12,4.46 ( -0.22 %),3301,14484870,4388.02,1845,14404320,7807,80550
2020-11-11,4.47 ( -1.11 %),2204,10043990,4557.16,1326,9981060,7527,62930
2020-11-10,4.52 ( -0.88 %),2113,7766280,3675.48,1050,8754820,8338,-988540
2020-11-09,4.56 ( -0.22 %),1870,8964880,4794.05,989,10526740,10644,-1561860
2020-11-06,4.57 ( -0.65 %),1221,3772930,3090.03,773,5440850,7039,-1667920
2020-11-05,4.6 ( -0.43 %),1341,4904970,3657.7,976,6707160,6872,-1802190
2020-11-04,4.62 ( 0.43 %),1442,5436540,3770.14,1173,7664780,6534,-2228240
2020-11-03,4.6 ( -1.08 %),1278,5232660,4094.41,1153,8290160,7190,-3057500
2020-11-02,4.65 ( 2.42 %),1522,8121570,5336.12,1233,10024550,8130,-1902980
2020-10-30,4.54 ( 2.02 %),2107,10678720,5068.21,1446,13201990,9130,-2523270
2020-10-29,4.45 ( -1.11 %),2073,9080070,4380.16,1168,10816730,9261,-1736660
2020-10-28,4.5 ( -3.23 %),0,0,0,0,0,0,0
2020-10-27,4.65 ( -2.72 %),0,0,0,0,0,0,0
2020-10-26,4.78 ( -1.85 %),1868,11054090,5917.61,2075,14111280,6801,-3057190
2020-10-23,4.87 ( 3.18 %),1951,14524680,7444.74,2465,14869530,6032,-344850
2020-10-22,4.72 ( -0.63 %),2339,13700390,5857.37,1354,10475200,7736,3225190
2020-10-21,4.75 ( -2.06 %),1611,9009700,5592.61,1619,12779520,7893,-3769820
2020-10-20,4.85 ( -1.22 %),2846,13915190,4889.39,2021,15846640,7841,-1931450
2020-10-19,4.91 ( 0.2 %),2588,20199770,7805.17,1827,18870220,10329,1329550
2020-10-16,4.9 ( -2.58 %),2802,12467730,4449.58,2867,23031850,8033,-10564120
2020-10-15,5.03 ( 1.41 %),6342,45058500,7104.78,5642,57912810,10265,-12854310
2020-10-14,4.96 ( 6.9 %),4384,52227620,11913.23,1243,5650810,4546,46576810
2020-10-13,4.64 ( 3.11 %),1889,14128360,7479.28,1674,15172470,9064,-1044110
2020-10-12,4.5 ( -3.85 %),2375,12787900,5384.38,1541,17712270,11494,-4924370
2020-10-09,4.68 ( -2.5 %),1999,8918960,4461.71,1546,13944380,9020,-5025420
2020-10-08,4.8 ( -1.03 %),1900,14878300,7830.68,2879,23741300,8246,-8863000
2020-10-07,4.85 ( 3.41 %),2900,22367670,7712.99,3442,23434360,6808,-1066690
2020-10-06,4.69 ( -0.42 %),1712,8835200,5160.75,1830,14217760,7769,-5382560
2020-10-05,4.71 ( 3.74 %),2062,16074730,7795.7,2827,16475820,5828,-401090
2020-10-02,4.54 ( -0.22 %),1733,8221900,4744.32,1334,10393170,7791,-2171270
2020-10-01,4.55 ( -0.22 %),1288,5969520,4634.72,1048,6768160,6458,-798640
2020-09-30,4.56 ( 0 %),1296,6738220,5199.24,1133,6221840,5491,516380
2020-09-29,4.56 ( -0.22 %),2511,16246920,6470.3,2703,14701840,5439,1545080
2020-09-28,4.57 ( 0 %),1723,6777420,3933.5,1157,7606260,6574,-828840
2020-09-25,4.57 ( -0.65 %),1395,6155640,4412.65,1105,7959480,7203,-1803840
2020-09-24,4.6 ( 0 %),1645,7150630,4346.89,1223,8344660,6823,-1194030
2020-09-23,4.6 ( 1.1 %),1388,7090150,5108.18,1199,7160310,5972,-70160
2020-09-22,4.55 ( -0.87 %),0,0,0,0,0,0,0
2020-09-21,4.59 ( -1.08 %),2507,9747160,3887.98,1260,10352330,8216,-605170
2020-09-18,4.64 ( -1.69 %),2142,10622900,4959.34,1289,11392090,8838,-769190
2020-09-17,4.72 ( 1.94 %),2005,15431250,7696.38,1477,12386190,8386,3045060
2020-09-16,4.63 ( -0.86 %),2214,11211630,5063.97,1265,10565140,8352,646490
2020-09-15,4.67 ( -4.11 %),2850,13385240,4696.58,2379,17792520,7479,-4407280
2020-09-14,4.87 ( -0.61 %),1262,9072790,7189.22,2095,13047590,6228,-3974800
2020-09-11,4.9 ( 2.3 %),2012,17970710,8931.76,2733,18081840,6616,-111130
2020-09-10,4.79 ( -0.83 %),2211,16244350,7347.06,2579,20156680,7816,-3912330
2020-09-09,4.83 ( 4.77 %),3052,22219020,7280.15,2987,19067490,6383,3151530
2020-09-08,4.61 ( 0.22 %),2311,13562770,5868.79,2066,18180500,8800,-4617730
2020-09-07,4.6 ( 5.75 %),4475,38151170,8525.4,3180,29736520,9351,8414650
2020-09-04,4.35 ( 0.93 %),1721,16772050,9745.53,2288,15443660,6750,1328390
2020-09-03,4.31 ( -0.46 %),1251,7099150,5674.78,1510,9451750,6259,-2352600
2020-09-01,4.33 ( 1.64 %),1767,17082080,9667.28,1752,15313440,8741,1768640
2020-08-31,4.26 ( 0.24 %),1780,9934770,5581.33,2060,13233710,6424,-3298940
2020-08-28,4.25 ( -2.07 %),1335,7171740,5372.09,1695,9753480,5754,-2581740
2020-08-27,4.34 ( 3.33 %),1854,13662460,7369.18,1899,14418350,7593,-755890
2020-08-26,4.2 ( -0.24 %),2160,9650470,4467.81,1184,9899340,8361,-248870
2020-08-25,4.21 ( -1.64 %),2188,11000280,5027.55,1225,10935360,8927,64920
2020-08-24,4.28 ( 0 %),2421,12481430,5155.49,1397,11099960,7946,1381470
2020-08-21,4.28 ( 0.47 %),887,4665180,5259.5,1181,5628940,4766,-963760
2020-08-20,4.26 ( -0.7 %),2116,11849020,5599.73,2199,15018080,6830,-3169060
2020-08-19,4.29 ( 6.98 %),2811,19282380,6859.62,2366,13475980,5696,5806400
2020-08-18,4.01 ( 0 %),1106,5276360,4770.67,712,4896040,6876,380320
2020-08-17,4.01 ( -0.99 %),1232,5213030,4231.36,771,5744090,7450,-531060
2020-08-14,4.05 ( -1.7 %),1373,5226710,3806.78,984,8006970,8137,-2780260
2020-08-13,4.12 ( 2.49 %),1401,8249750,5888.47,1594,8500510,5333,-250760
2020-08-12,4.02 ( -0.74 %),1134,5550790,4894.88,842,6100900,7246,-550110
2020-08-11,4.05 ( 0 %),1470,8810590,5993.6,1103,9577120,8683,-766530
2020-08-10,4.05 ( -0.25 %),1983,10038500,5062.28,1306,11993740,9184,-1955240
2020-08-07,4.06 ( -1.22 %),1804,8051430,4463.1,1347,10386730,7711,-2335300
2020-08-06,4.11 ( 4.58 %),1910,13851140,7251.91,1685,11989820,7116,1861320
2020-08-05,3.93 ( 1.55 %),1292,7361640,5697.86,909,7159320,7876,202320
2020-08-04,3.87 ( 0 %),1752,11772120,6719.25,1054,9775990,9275,1996130
2020-08-03,3.87 ( 1.84 %),1595,10072540,6315.07,1223,11002230,8996,-929690
2020-07-31,3.8 ( 1.88 %),1527,10164150,6656.29,1300,8270360,6362,1893790
2020-07-30,3.73 ( -0.27 %),979,4911060,5016.4,672,4743450,7059,167610
2020-07-29,3.74 ( -3.11 %),1531,11431250,7466.53,827,11143220,13474,288030
2020-07-28,3.86 ( 2.93 %),2227,18567930,8337.64,1518,14858060,9788,3709870
2020-07-27,3.75 ( -6.95 %),1421,10547290,7422.44,1513,20869220,13793,-10321930
2020-07-24,4.03 ( -6.93 %),1990,10127800,5089.35,1458,16462360,11291,-6334560
2020-07-23,4.33 ( 0.7 %),1789,9290320,5193.02,1271,8376640,6591,913680
2020-07-22,4.3 ( -3.8 %),2386,10339740,4333.5,1168,11528360,9870,-1188620
2020-07-21,4.47 ( 2.29 %),1496,7191800,4807.35,1161,6817130,5872,374670
2020-07-20,4.37 ( -4.59 %),0,0,0,0,0,0,0
2020-07-17,4.58 ( -2.14 %),4276,18433560,4310.94,1808,17865890,9882,567670
2020-07-16,4.68 ( 0.65 %),1526,5488570,3596.7,977,4708330,4819,780240
2020-07-15,4.65 ( -4.91 %),4962,19043120,3837.79,1906,21360580,11207,-2317460
2020-07-14,4.89 ( -3.74 %),3784,14062480,3716.3,1127,17886870,15871,-3824390
2020-07-13,5.08 ( 0.59 %),911,3365280,3694.05,985,5604980,5690,-2239700
2020-07-10,5.05 ( 1 %),1703,9356440,5494.09,1491,14740140,9886,-5383700
2020-07-09,5 ( 0 %),0,0,0,0,0,0,0
2020-07-08,5 ( -0.4 %),1467,6278740,4279.99,722,6581910,9116,-303170
2020-07-07,5.02 ( -2.52 %),3108,10506060,3380.33,1435,13147910,9162,-2641850
2020-07-06,5.15 ( -0.96 %),1464,5629170,3845.06,893,8853760,9915,-3224590
2020-07-03,5.2 ( -0.57 %),768,4382480,5706.35,990,7085270,7157,-2702790
2020-07-02,5.23 ( 0 %),1340,4903750,3659.51,983,7212790,7338,-2309040
2020-07-01,5.23 ( 0.58 %),960,4835290,5036.76,1321,8495190,6431,-3659900
2020-06-30,5.2 ( 0 %),1063,8011230,7536.43,1397,10718270,7672,-2707040
2020-06-29,5.2 ( 1.76 %),2137,11826420,5534.12,2414,15763280,6530,-3936860
2020-06-26,5.11 ( -1.73 %),1103,6388270,5791.72,1525,10635340,6974,-4247070
2020-06-25,5.2 ( -0.38 %),1350,8254970,6114.79,1003,6142900,6125,2112070
2020-06-24,5.22 ( -1.51 %),1129,8718460,7722.29,1386,12586620,9081,-3868160
2020-06-23,5.3 ( 2.12 %),1503,10040910,6680.58,1484,12058020,8125,-2017110
2020-06-22,5.19 ( -0.76 %),1622,6368770,3926.49,1294,8549850,6607,-2181080
2020-06-19,5.23 ( 5.23 %),2314,14195450,6134.59,1565,13179180,8421,1016270
2020-06-18,4.97 ( -2.36 %),1332,7355570,5522.2,843,8387850,9950,-1032280
2020-06-17,5.09 ( -1.93 %),1230,7000920,5691.8,1097,9532580,8690,-2531660
2020-06-16,5.19 ( 5.92 %),1470,15364060,10451.74,1406,8746570,6221,6617490
2020-06-15,4.9 ( -5.77 %),2467,18491260,7495.44,2035,16611060,8163,1880200
2020-06-12,5.2 ( -3.7 %),2641,24581980,9307.83,2117,24778840,11705,-196860
2020-06-11,5.4 ( -6.9 %),2308,16612180,7197.65,2341,25252990,10787,-8640810
2020-06-10,5.8 ( 2.65 %),3496,27042230,7735.19,2378,23372800,9829,3669430
2020-06-09,5.65 ( -1.74 %),3754,26085140,6948.63,2660,26577290,9991,-492150
2020-06-08,5.75 ( 6.09 %),0,0,0,0,0,0,0
2020-06-05,5.42 ( 6.69 %),4982,34166630,6858.01,3908,32809410,8395,1357220
2020-06-04,5.08 ( 6.95 %),2037,22082660,10840.78,1441,16799090,11658,5283570
2020-06-03,4.75 ( -1.04 %),1810,14325770,7914.79,1525,21269350,13947,-6943580
2020-06-02,4.8 ( -1.44 %),3175,27745960,8738.89,2861,37470700,13097,-9724740
2020-06-01,4.87 ( 6.8 %),1454,16156640,11111.86,627,3697460,5897,12459180
2020-05-29,4.56 ( 6.79 %),1420,18220090,12831.05,1626,10776030,6627,7444060
2020-05-28,4.27 ( 2.4 %),782,9723530,12434.18,1045,7671360,7341,2052170
2020-05-27,4.17 ( -1.42 %),1068,9376440,8779.44,946,9948340,10516,-571900
2020-05-26,4.23 ( 1.68 %),1183,8044470,6800.06,1180,8178940,6931,-134470
2020-05-25,4.16 ( 0.24 %),807,6295430,7801.03,767,4728370,6165,1567060
2020-05-22,4.15 ( 0.24 %),910,8639110,9493.53,1027,7940470,7732,698640
2020-05-21,4.14 ( -0.48 %),1125,5769670,5128.6,1210,9078730,7503,-3309060
2020-05-20,4.16 ( 6.94 %),1326,13028250,9825.23,1253,7977360,6367,5050890
2020-05-19,3.89 ( 0.78 %),695,8242580,11859.83,935,6923780,7405,1318800
2020-05-18,3.86 ( -0.52 %),589,3617710,6142.12,707,3948930,5585,-331220
2020-05-15,3.88 ( 2.11 %),1002,7064430,7050.33,1278,7998780,6259,-934350
2020-05-14,3.8 ( -1.55 %),948,7133730,7525.03,768,6781450,8830,352280
2020-05-13,3.86 ( 0.26 %),911,7970650,8749.34,927,6701310,7229,1269340
2020-05-12,3.85 ( 2.39 %),1889,8943530,4734.53,1367,11575730,8468,-2632200
2020-05-11,3.76 ( 6.82 %),0,0,0,0,0,0,0
2020-05-08,3.52 ( -0.85 %),741,7199010,9715.26,840,9420780,11215,-2221770
2020-05-07,3.55 ( 0.28 %),612,3575590,5842.47,802,6833150,8520,-3257560
2020-05-06,3.54 ( 2.31 %),656,3708340,5652.96,617,3929360,6368,-221020
2020-05-05,3.46 ( 1.76 %),630,4415810,7009.22,494,3333930,6749,1081880
2020-05-04,3.4 ( -5.56 %),749,6974700,9312.02,790,9544350,12081,-2569650
2020-04-29,3.6 ( -1.1 %),847,10385600,12261.63,1045,7959750,7617,2425850
2020-04-28,3.64 ( 4 %),965,7141400,7400.41,1027,6519910,6349,621490
2020-04-27,3.5 ( 3.55 %),1047,8774800,8380.9,1196,10116590,8459,-1341790
2020-04-24,3.38 ( 6.96 %),1227,17012150,13864.83,875,12377940,14146,4634210
2020-04-23,3.16 ( 1.28 %),410,4541860,11077.71,482,4802350,9963,-260490
2020-04-22,3.12 ( 0 %),476,3848810,8085.74,490,3339070,6814,509740
2020-04-21,3.12 ( -1.58 %),653,11406220,17467.41,702,6823590,9720,4582630
2020-04-20,3.17 ( 0 %),818,8868940,10842.22,886,7604590,8583,1264350
2020-04-17,3.17 ( 0 %),534,7086230,13270.09,609,4612510,7574,2473720
2020-04-16,3.17 ( 1.93 %),620,4747140,7656.68,623,4219320,6773,527820
2020-04-15,3.11 ( 1.3 %),619,7476500,12078.35,652,6297910,9659,1178590
2020-04-14,3.07 ( -1.92 %),502,5021650,10003.29,497,4684360,9425,337290
2020-04-13,3.13 ( -0.32 %),650,6804820,10468.95,689,6941900,10075,-137080
2020-04-10,3.14 ( -1.88 %),571,10618930,18597.08,855,8721070,10200,1897860
2020-04-09,3.2 ( 0 %),754,6030120,7997.51,859,6500840,7568,-470720
2020-04-08,3.2 ( 3.23 %),698,8599410,12320.07,946,6583540,6959,2015870
2020-04-07,3.1 ( 3.33 %),789,10791110,13676.95,994,7975080,8023,2816030
2020-04-06,3 ( 6.76 %),996,9987360,10027.47,634,5724880,9030,4262480
2020-04-03,2.81 ( 4.46 %),731,4608480,6304.35,608,4629920,7615,-21440
2020-04-01,2.69 ( 5.49 %),485,6596590,13601.22,532,3329270,6258,3267320
2020-03-31,2.55 ( 0 %),533,7345200,13780.86,634,4460670,7036,2884530
2020-03-30,2.55 ( -4.14 %),547,5807520,10617.04,543,5671230,10444,136290
2020-03-27,2.66 ( -0.75 %),596,5995610,10059.75,387,5552960,14349,442650
2020-03-26,2.68 ( -1.11 %),657,4027560,6130.23,479,4496220,9387,-468660
2020-03-25,2.71 ( -0.37 %),796,3559000,4471.11,369,3887240,10535,-328240
2020-03-24,2.72 ( -0.73 %),764,4692650,6142.21,371,4470550,12050,222100
2020-03-23,2.74 ( -6.8 %),807,5437400,6737.79,526,7125660,13547,-1688260
2020-03-20,2.94 ( -1.34 %),607,2078450,3424.14,285,1657130,5814,421320
2020-03-19,2.98 ( -1.65 %),1168,4812080,4119.93,426,4429750,10398,382330
2020-03-18,3.03 ( 0.33 %),920,4649790,5054.12,522,5050860,9676,-401070
2020-03-17,3.02 ( -0.33 %),840,4339920,5166.57,287,3646560,12706,693360
2020-03-16,3.03 ( -1.94 %),658,2704140,4109.64,363,3036990,8366,-332850
2020-03-13,3.09 ( -0.32 %),819,8694740,10616.29,577,7913960,13716,780780
2020-03-12,3.1 ( -2.52 %),996,8608470,8643.04,645,8873670,13758,-265200
2020-03-11,3.18 ( -2.45 %),761,5963580,7836.5,564,5924400,10504,39180
2020-03-10,3.26 ( 0.31 %),947,7234450,7639.33,547,3910300,7149,3324150
2020-03-09,3.25 ( -6.88 %),849,3875560,4564.85,611,7242780,11854,-3367220
2020-03-06,3.49 ( 0.29 %),450,2850800,6335.11,368,2023580,5499,827220
2020-03-05,3.48 ( -1.14 %),604,2952430,4888.13,792,5197840,6563,-2245410
2020-03-04,3.52 ( 6.34 %),1123,9790610,8718.26,1109,10914140,9841,-1123530
2020-03-03,3.31 ( 1.22 %),483,3256900,6743.06,466,3399900,7296,-143000
2020-03-02,3.27 ( 0 %),0,0,0,0,0,0,0
2020-02-28,3.27 ( -1.8 %),546,3131300,5734.98,329,3051810,9276,79490
2020-02-27,3.33 ( 2.15 %),473,3684070,7788.73,601,3015290,5017,668780
2020-02-26,3.26 ( -2.69 %),516,2336980,4529.03,333,2187010,6568,149970
2020-02-25,3.35 ( 4.69 %),760,5737160,7548.89,467,3547030,7595,2190130
2020-02-24,3.2 ( -6.98 %),0,0,0,0,0,0,0
2020-02-21,3.44 ( -1.43 %),0,0,0,0,0,0,0
2020-02-20,3.49 ( -0.57 %),566,1691180,2987.95,399,2809530,7041,-1118350
2020-02-19,3.51 ( 0.29 %),424,1919190,4526.39,394,2499130,6343,-579940
2020-02-18,3.5 ( 0.57 %),440,1807630,4108.25,289,1761570,6095,46060
2020-02-17,3.48 ( -0.29 %),464,1809540,3899.87,327,1723170,5270,86370
2020-02-14,3.49 ( -0.29 %),530,1886020,3558.53,269,1501130,5580,384890
2020-02-13,3.5 ( -2.23 %),538,2601980,4836.39,317,2539720,8012,62260
2020-02-12,3.58 ( 3.77 %),579,3799750,6562.61,481,2962590,6159,837160
2020-02-11,3.45 ( 0.29 %),505,2259000,4473.27,218,1286170,5900,972830
2020-02-10,3.44 ( -3.1 %),543,1814990,3342.52,325,1872680,5762,-57690
2020-02-07,3.55 ( 0.57 %),571,2548430,4463.1,489,2950550,6034,-402120
2020-02-06,3.53 ( 6.97 %),833,6966350,8362.97,627,4385580,6995,2580770
2020-02-05,3.3 ( 0.92 %),713,3350090,4698.58,363,2296720,6327,1053370
2020-02-04,3.27 ( -3.54 %),1031,4000030,3879.76,396,4616600,11658,-616570
2020-02-03,3.39 ( -6.87 %),865,4743340,5483.63,503,6235230,12396,-1491890
2020-01-31,3.64 ( -6.67 %),1016,4105250,4040.6,457,6053420,13246,-1948170
2020-01-30,3.9 ( -2.01 %),424,2845040,6710,435,4445950,10221,-1600910
2020-01-22,3.98 ( 1.53 %),338,1868550,5528.25,416,2324920,5589,-456370
2020-01-21,3.92 ( 1.55 %),361,2823430,7821.14,409,1996240,4881,827190
2020-01-20,3.86 ( -0.52 %),410,1329740,3243.27,240,1117390,4656,212350
2020-01-17,3.88 ( 1.04 %),353,1841760,5217.45,424,2245710,5296,-403950
2020-01-16,3.84 ( -1.54 %),808,3626970,4488.82,454,3578480,7882,48490
2020-01-15,3.9 ( -1.02 %),502,1812680,3610.92,307,2756740,8980,-944060
2020-01-14,3.94 ( -1.5 %),624,2567320,4114.29,396,3668220,9263,-1100900
2020-01-13,4 ( -1.96 %),462,1860010,4026,471,3748020,7958,-1888010
2020-01-10,4.08 ( -0.49 %),365,1890510,5179.48,511,3083690,6035,-1193180
2020-01-09,4.1 ( 4.86 %),410,2736180,6673.61,401,2175550,5425,560630
2020-01-08,3.91 ( -4.87 %),796,3667950,4607.98,556,5064040,9108,-1396090
2020-01-07,4.11 ( 0.49 %),484,2783820,5751.69,381,3084700,8096,-300880
2020-01-06,4.09 ( -1.45 %),550,2354120,4280.22,601,3847790,6402,-1493670
2020-01-03,4.15 ( 2.47 %),688,6586520,9573.43,1155,7571750,6556,-985230
2020-01-02,4.05 ( 1.76 %),428,2081440,4863.18,484,2544490,5257,-463050
2019-12-31,3.98 ( -1 %),681,3165550,4648.38,469,2942600,6274,222950
2019-12-30,4.02 ( -0.74 %),504,1855820,3682.18,416,3192570,7674,-1336750
2019-12-27,4.05 ( -0.74 %),465,2035910,4378.3,751,3930050,5233,-1894140
2019-12-26,4.08 ( 3.03 %),916,6303550,6881.6,1324,7463650,5637,-1160100
2019-12-25,3.96 ( -1.25 %),414,1653170,3993.16,433,2309780,5334,-656610
2019-12-24,4.01 ( 0.25 %),324,1809330,5584.35,455,2495740,5485,-686410
2019-12-23,4 ( 1.01 %),0,0,0,0,0,0,0
2019-12-20,3.96 ( 0.25 %),612,2396230,3915.41,360,2424670,6735,-28440
2019-12-19,3.95 ( -2.23 %),513,1324800,2582.46,481,3151580,6552,-1826780
2019-12-18,4.04 ( 0.25 %),496,2304540,4646.25,784,3766110,4804,-1461570
2019-12-17,4.03 ( 1.77 %),798,4271380,5352.61,1039,6004480,5779,-1733100
2019-12-16,3.96 ( 0.25 %),863,3557480,4122.22,593,3840150,6476,-282670
2019-12-13,3.95 ( -0.5 %),632,2677370,4236.34,679,3925790,5782,-1248420
2019-12-12,3.97 ( -1.73 %),465,1797830,3866.3,726,4485770,6179,-2687940
2019-12-11,4.04 ( 3.59 %),716,4835820,6753.94,1027,5008030,4876,-172210
2019-12-10,3.9 ( 1.04 %),597,2790920,4674.91,744,3665420,4927,-874500
2019-12-09,3.86 ( 3.76 %),797,2858480,3586.55,844,3742960,4435,-884480
2019-12-06,3.72 ( 0.54 %),447,1776600,3974.5,450,1440460,3201,336140
2019-12-05,3.7 ( 1.93 %),388,1412170,3639.61,446,1039120,2330,373050
2019-12-04,3.63 ( 0.55 %),0,0,0,0,0,0,0
2019-12-03,3.61 ( -0.55 %),629,2571670,4088.51,340,2217070,6521,354600
2019-12-02,3.63 ( -5.71 %),1440,5475180,3802.21,626,6451620,10306,-976440
2019-11-29,3.85 ( -2.28 %),710,2984970,4204.18,383,2951050,7705,33920
2019-11-28,3.94 ( -0.51 %),337,2052800,6091.39,423,1821910,4307,230890
2019-11-27,3.96 ( 1.28 %),393,1721590,4380.64,358,1045980,2922,675610
2019-11-26,3.91 ( 0.26 %),462,3020320,6537.49,383,2022630,5281,997690
2019-11-25,3.9 ( -2.5 %),600,3104460,5174.1,430,3283540,7636,-179080
2019-11-22,4 ( -1.23 %),587,3346790,5701.52,346,3404740,9840,-57950
2019-11-21,4.05 ( 0 %),389,1106640,2844.83,286,1315630,4600,-208990
2019-11-20,4.05 ( -1.22 %),414,1452530,3508.53,359,1995360,5558,-542830
2019-11-19,4.1 ( 3.02 %),706,3794470,5374.6,559,2986830,5343,807640
2019-11-18,3.98 ( -0.75 %),604,3508520,5808.81,381,2601690,6829,906830
2019-11-15,4.01 ( -1.72 %),578,2249830,3892.44,416,3407300,8191,-1157470
2019-11-14,4.08 ( 0.25 %),681,4711040,6917.83,357,2574790,7212,2136250
2019-11-13,4.07 ( -1.69 %),742,2476000,3336.93,440,4348760,9884,-1872760
2019-11-12,4.14 ( -0.72 %),506,1880190,3715.79,409,2673050,6536,-792860
2019-11-11,4.17 ( -0.24 %),399,1352530,3389.8,391,1994510,5101,-641980
2019-11-08,4.18 ( 0.72 %),489,2086380,4266.63,388,1900630,4899,185750
2019-11-07,4.15 ( 0 %),571,1860010,3257.46,491,2442520,4975,-582510
2019-11-06,4.15 ( -2.12 %),1717,7136870,4156.59,653,5344430,8184,1792440
2019-11-05,4.24 ( -1.17 %),561,1479440,2637.15,509,2250580,4422,-771140
2019-11-04,4.29 ( 1.42 %),644,2836380,4404.32,533,2668760,5007,167620
2019-11-01,4.23 ( 0.24 %),555,2458580,4429.87,454,2602210,5732,-143630
2019-10-31,4.22 ( -1.63 %),708,1813530,2561.48,340,1923850,5658,-110320
2019-10-30,4.29 ( -0.23 %),853,2884330,3381.4,337,1862610,5527,1021720
2019-10-29,4.3 ( -1.38 %),868,2858650,3293.38,474,3265240,6889,-406590
2019-10-28,4.36 ( 0 %),621,2805280,4517.36,492,2786850,5664,18430
2019-10-25,4.36 ( -1.58 %),453,2291320,5058.1,465,3105640,6679,-814320
2019-10-24,4.43 ( 1.37 %),497,2759210,5551.73,560,2224690,3973,534520
2019-10-23,4.37 ( -2.02 %),557,1780920,3197.34,674,3157310,4684,-1376390
2019-10-22,4.46 ( 4.21 %),804,4587700,5706.09,948,4693710,4951,-106010
2019-10-21,4.28 ( -1.38 %),522,1732360,3318.7,428,2310490,5398,-578130
2019-10-18,4.34 ( 1.17 %),690,3790250,5493.12,615,3657860,5948,132390
2019-10-17,4.29 ( 3.12 %),932,5330880,5719.83,658,3679630,5592,1651250
2019-10-16,4.16 ( -3.26 %),1542,6253890,4055.7,584,6183080,10587,70810
2019-10-15,4.3 ( -2.05 %),951,5300190,5573.28,471,4828100,10251,472090
2019-10-14,4.39 ( -1.57 %),985,4111640,4174.25,426,6171590,14487,-2059950
2019-10-11,4.46 ( 0 %),359,1235700,3442.06,316,2812760,8901,-1577060
2019-10-10,4.46 ( -0.45 %),434,1554110,3580.9,384,3653900,9515,-2099790
2019-10-09,4.48 ( 0 %),457,1952260,4271.9,358,3442250,9615,-1489990
2019-10-08,4.48 ( -0.44 %),491,1782840,3631.04,325,2786720,8575,-1003880
2019-10-07,4.5 ( -1.53 %),649,4187380,6452.05,419,3018000,7203,1169380
2019-10-04,4.57 ( -1.51 %),513,1587590,3094.72,395,3139060,7947,-1551470
2019-10-03,4.64 ( 0.43 %),584,2901370,4968.1,574,3139520,5470,-238150
2019-10-02,4.62 ( 1.54 %),1093,5996170,5485.97,1187,7738870,6520,-1742700
2019-10-01,4.55 ( 1.34 %),447,3190340,7137.23,346,2251500,6507,938840
2019-09-30,4.49 ( -0.22 %),484,2163780,4470.62,431,3272190,7592,-1108410
2019-09-27,4.5 ( -0.66 %),516,1642980,3184.07,374,2818760,7537,-1175780
2019-09-26,4.53 ( 0.67 %),465,2453590,5276.54,375,2734770,7293,-281180
2019-09-25,4.5 ( -1.32 %),482,1502330,3116.87,396,2972150,7505,-1469820
2019-09-24,4.56 ( 2.01 %),738,4442090,6019.09,877,4411520,5030,30570
2019-09-23,4.47 ( 0.22 %),535,2221180,4151.74,457,2150160,4705,71020
2019-09-20,4.46 ( -1.33 %),762,3059440,4015.01,439,4131860,9412,-1072420
2019-09-19,4.52 ( -0.44 %),575,2239690,3895.11,377,1945220,5160,294470
2019-09-18,4.54 ( 1.11 %),624,2710390,4343.57,444,2612820,5885,97570
2019-09-17,4.49 ( -2.39 %),1145,5215920,4555.39,554,4832750,8723,383170
2019-09-16,4.6 ( -2.13 %),1163,4207240,3617.58,565,4832860,8554,-625620
2019-09-13,4.7 ( -1.88 %),617,2029050,3288.57,398,2660960,6686,-631910
2019-09-12,4.79 ( 0.63 %),602,2857580,4746.81,441,2768450,6278,89130
2019-09-11,4.76 ( -0.21 %),356,1391740,3909.38,460,1969720,4282,-577980
2019-09-10,4.77 ( -0.42 %),570,2446570,4292.23,573,3617950,6314,-1171380
2019-09-09,4.79 ( 0.42 %),332,1758390,5296.36,403,2229520,5532,-471130
2019-09-06,4.77 ( -0.83 %),447,2480740,5549.75,379,3075040,8114,-594300
2019-09-05,4.81 ( -0.41 %),298,2833620,9508.79,420,2088740,4973,744880
2019-09-04,4.83 ( 0.42 %),522,3219180,6167.01,352,2120760,6025,1098420
2019-09-03,4.81 ( -1.03 %),492,2818540,5728.74,395,2667120,6752,151420
2019-08-30,4.86 ( 0.83 %),605,4278220,7071.44,679,2900080,4271,1378140
2019-08-29,4.82 ( 0.42 %),486,3229820,6645.72,461,1970570,4275,1259250
2019-08-28,4.8 ( -0.21 %),474,2272830,4795,384,1895140,4935,377690
2019-08-27,4.81 ( 0 %),626,3315090,5295.67,379,2517550,6643,797540
2019-08-26,4.81 ( -1.84 %),740,3203890,4329.58,432,5263210,12183,-2059320
2019-08-23,4.9 ( 0.41 %),960,3568040,3716.71,411,3393030,8256,175010
2019-08-22,4.88 ( 0 %),458,2308790,5041.03,447,2323840,5199,-15050
2019-08-21,4.88 ( 0 %),527,1722640,3268.77,443,2319790,5237,-597150
2019-08-20,4.88 ( 1.88 %),735,3828940,5209.44,446,3008470,6745,820470
2019-08-19,4.79 ( -2.24 %),1366,5703330,4175.2,1249,5498010,4402,205320
2019-08-16,4.9 ( -0.41 %),651,2986440,4587.47,412,2690570,6531,295870
2019-08-15,4.92 ( -1.6 %),822,4453340,5417.69,530,4149230,7829,304110
2019-08-14,5 ( 0.4 %),452,3319280,7343.54,676,3832690,5670,-513410
2019-08-13,4.98 ( -1.39 %),655,3525370,5382.24,535,4639800,8673,-1114430
2019-08-12,5.05 ( 0 %),474,2647390,5585.21,748,4229150,5654,-1581760
2019-08-09,5.05 ( 0.8 %),500,3003470,6006.94,701,4544240,6483,-1540770
2019-08-08,5.01 ( 0.2 %),666,2984960,4481.92,670,3947860,5892,-962900
2019-08-07,5 ( -0.4 %),549,2599430,4734.85,742,4028660,5429,-1429230
2019-08-06,5.02 ( -0.59 %),980,5074890,5178.46,1215,6278950,5168,-1204060
2019-08-05,5.05 ( 4.77 %),1763,8986250,5097.14,966,7564330,7831,1421920
2019-08-02,4.82 ( -2.63 %),1777,6831260,3844.27,673,7344070,10912,-512810
2019-08-01,4.95 ( -2.56 %),1628,6056370,3720.13,684,8230010,12032,-2173640
2019-07-31,5.08 ( -2.87 %),1252,7184640,5738.53,838,6753900,8060,430740
2019-07-30,5.23 ( 2.95 %),1438,9913420,6893.89,946,8617200,9109,1296220
2019-07-29,5.08 ( -1.17 %),894,3207230,3587.51,478,3319620,6945,-112390
2019-07-26,5.14 ( -1.34 %),928,4219270,4546.63,550,3758390,6833,460880
2019-07-25,5.21 ( -0.57 %),884,7172920,8114.16,598,4594650,7683,2578270
2019-07-24,5.24 ( -0.38 %),876,4128240,4712.6,559,3940460,7049,187780
2019-07-23,5.26 ( -0.75 %),736,2428230,3299.23,563,3927670,6976,-1499440
2019-07-22,5.3 ( 0.38 %),1045,5376450,5144.93,686,4593170,6696,783280
2019-07-19,5.28 ( -1.86 %),1028,5264680,5121.28,714,5917160,8287,-652480
2019-07-18,5.38 ( 0.56 %),657,3933890,5987.66,548,4578790,8355,-644900
2019-07-17,5.35 ( 0.75 %),731,5708790,7809.56,563,3340240,5933,2368550
2019-07-16,5.31 ( -1.67 %),1653,7900900,4779.73,879,9814390,11165,-1913490
2019-07-15,5.4 ( -3.57 %),1403,7824950,5577.3,1012,10405240,10282,-2580290
2019-07-12,5.6 ( -1.75 %),945,4474020,4734.41,1175,8686570,7393,-4212550
2019-07-11,5.7 ( 1.42 %),1061,8992520,8475.51,1623,13625530,8395,-4633010
2019-07-10,5.62 ( 0.18 %),1044,7485660,7170.17,1046,6139100,5869,1346560
2019-07-09,5.61 ( 2.19 %),1569,12074540,7695.69,2034,14425030,7092,-2350490
2019-07-08,5.49 ( 1.1 %),1115,9255780,8301.15,1226,11318540,9232,-2062760
2019-07-05,5.43 ( -0.73 %),725,3512880,4845.35,865,5660670,6544,-2147790
2019-07-04,5.47 ( 0.92 %),0,0,0,0,0,0,0
2019-07-03,5.42 ( 1.69 %),658,4250810,6460.2,818,5398770,6600,-1147960
2019-07-02,5.33 ( 0.19 %),658,4250810,6460.2,818,5398770,6600,-1147960
2019-07-01,5.32 ( -0.56 %),800,6218990,7773.74,1135,8123110,7157,-1904120
2019-06-28,5.35 ( 2.1 %),0,0,0,0,0,0,0
2019-06-27,5.24 ( -1.13 %),773,6718910,8691.99,920,7145890,7767,-426980
2019-06-26,5.3 ( 0.19 %),763,7720610,10118.75,1183,9955090,8415,-2234480
2019-06-25,5.29 ( 3.52 %),1175,10199410,8680.35,2123,11763430,5541,-1564020
2019-06-24,5.11 ( 0.39 %),889,6368260,7163.4,900,6837510,7597,-469250
2019-06-21,5.09 ( -0.78 %),588,4330060,7364.05,472,3047940,6458,1282120
2019-06-20,5.13 ( -0.39 %),658,4250810,6460.2,818,5398770,6600,-1147960
2019-06-19,5.15 ( 3.62 %),1177,9952120,8455.5,1355,9907670,7312,44450
2019-06-18,4.97 ( -0.6 %),278,2157560,7761.01,385,1835460,4767,322100
2019-06-17,5 ( 0.6 %),520,3500510,6731.75,369,2703540,7327,796970
2019-06-14,4.97 ( 0 %),410,1543610,3764.9,382,1941820,5083,-398210
2019-06-13,4.97 ( 0.4 %),517,3468370,6708.65,526,2901210,5516,567160
2019-06-12,4.95 ( -0.8 %),440,2032550,4619.43,369,2714290,7356,-681740
2019-06-11,4.99 ( -0.4 %),399,1603210,4018.07,521,3273450,6283,-1670240
2019-06-10,5.01 ( 0.6 %),360,1389120,3858.67,507,2090200,4123,-701080
2019-06-07,4.98 ( 1.43 %),457,2042230,4468.77,401,1914950,4775,127280
2019-06-06,4.91 ( -0.61 %),443,1889220,4264.6,309,1970550,6377,-81330
2019-06-05,4.94 ( 0.82 %),580,2262520,3900.9,397,2341940,5899,-79420
2019-06-04,4.9 ( -2.39 %),766,2645130,3453.17,425,3663570,8620,-1018440
2019-06-03,5.02 ( -0.99 %),0,0,0,0,0,0,0
2019-05-31,5.07 ( -0.59 %),798,3718680,4660,401,2936310,7322,782370
2019-05-30,5.1 ( -0.39 %),552,2757600,4995.65,397,2734970,6889,22630
2019-05-29,5.12 ( -0.78 %),589,2419380,4107.61,485,3043210,6275,-623830
2019-05-28,5.16 ( 0 %),404,2472750,6120.67,597,3506920,5874,-1034170
2019-05-27,5.16 ( 0 %),364,2367020,6502.8,473,3309260,6996,-942240
2019-05-24,5.16 ( 0 %),386,3596370,9317.02,570,4547790,7979,-951420
2019-05-23,5.16 ( 0 %),408,2813700,6896.32,715,3506150,4904,-692450
2019-05-22,5.16 ( 0.19 %),622,5733370,9217.64,677,5507180,8135,226190
2019-05-21,5.15 ( -0.19 %),610,4971270,8149.62,584,3888880,6659,1082390
2019-05-20,5.16 ( -0.77 %),994,5810770,5845.85,532,4962500,9328,848270
2019-05-17,5.2 ( -1.89 %),541,3123670,5773.88,878,5976750,6807,-2853080
2019-05-16,5.3 ( 3.11 %),790,7226270,9147.18,1066,5938390,5571,1287880
2019-05-15,5.14 ( 0.98 %),711,3232510,4546.43,504,2807970,5571,424540
2019-05-14,5.09 ( -0.2 %),572,2569620,4492.34,470,2655580,5650,-85960
2019-05-13,5.1 ( 0.2 %),671,3187330,4750.12,423,2814950,6655,372380
2019-05-10,5.09 ( 0.59 %),753,3180290,4223.49,479,2646910,5526,533380
2019-05-09,5.06 ( -0.98 %),741,2597860,3505.88,368,2604960,7079,-7100
2019-05-08,5.11 ( -1.35 %),638,2406530,3771.99,389,2572290,6613,-165760
2019-05-07,5.18 ( 0.19 %),697,2893470,4151.32,448,2846330,6353,47140
2019-05-06,5.17 ( -2.08 %),1224,5480950,4477.9,636,6190920,9734,-709970
2019-05-03,5.28 ( -1.68 %),913,4348030,4762.35,577,4848090,8402,-500060
2019-05-02,5.37 ( -1.83 %),811,3265590,4026.62,638,4825070,7563,-1559480
2019-04-26,5.47 ( -1.44 %),837,5890600,7037.75,1050,8426990,8026,-2536390
2019-04-25,5.55 ( 2.97 %),1182,17020730,14399.94,2270,17300890,7622,-280160
2019-04-24,5.39 ( 1.7 %),768,7041520,9168.65,1065,7308590,6863,-267070
2019-04-23,5.3 ( -0.19 %),501,3586570,7158.82,648,4356750,6723,-770180
2019-04-22,5.31 ( 0.19 %),644,5071780,7875.43,830,5341720,6436,-269940
2019-04-19,5.3 ( 0 %),652,3650720,5599.26,500,3257720,6515,393000
2019-04-18,5.3 ( -1.49 %),918,4033360,4393.64,572,5184220,9063,-1150860
2019-04-17,5.38 ( 1.7 %),1294,7565230,5846.39,1350,9489460,7029,-1924230
2019-04-16,5.29 ( 0.38 %),0,0,0,0,0,0,0
2019-04-12,5.27 ( 0.96 %),844,3828720,4536.4,497,3349550,6740,479170
2019-04-11,5.22 ( -0.38 %),1114,4029620,3617.25,452,3521080,7790,508540
2019-04-10,5.24 ( -3.14 %),1649,6734910,4084.24,707,7390370,10453,-655460
2019-04-09,5.41 ( -1.99 %),934,3668170,3927.38,664,5341840,8045,-1673670
2019-04-08,5.52 ( 1.85 %),1036,8132380,7849.79,1098,7667500,6983,464880
2019-04-05,5.42 ( 0 %),647,2928750,4526.66,561,3437920,6128,-509170
2019-04-04,5.42 ( 0.56 %),835,3556530,4259.32,698,4029520,5773,-472990
2019-04-03,5.39 ( -0.92 %),1293,5051180,3906.56,680,3447290,5070,1603890
2019-04-02,5.44 ( -0.37 %),991,4546300,4587.59,758,5423330,7155,-877030
2019-04-01,5.46 ( -1.8 %),1532,6413810,4186.56,903,6459750,7154,-45940
2019-03-29,5.56 ( 0 %),1544,8033580,5203.1,927,6558850,7075,1474730
2019-03-28,5.56 ( -0.89 %),1954,8777240,4491.93,1269,10852550,8552,-2075310
2019-03-27,5.61 ( -4.43 %),1743,6951090,3988,1525,15258820,10006,-8307730
2019-03-26,5.87 ( 4.63 %),3301,20357600,6167.1,2362,22829730,9665,-2472130
2019-03-25,5.61 ( 6.86 %),1719,12330750,7173.21,788,4847720,6152,7483030
2019-03-22,5.25 ( 0.96 %),1398,7072350,5058.91,769,4793320,6233,2279030
2019-03-21,5.2 ( -5.8 %),1829,7038200,3848.11,976,9693560,9932,-2655360
2019-03-20,5.52 ( -0.54 %),1152,4279250,3714.63,646,4958930,7676,-679680
2019-03-19,5.55 ( 0.18 %),1350,8934070,6617.83,948,8633790,9107,300280
2019-03-18,5.54 ( -3.99 %),2303,10790990,4685.62,1343,12664740,9430,-1873750
2019-03-15,5.77 ( -1.2 %),930,4793700,5154.52,889,8405500,9455,-3611800
2019-03-14,5.84 ( 0.69 %),1155,7514030,6505.65,1132,9048520,7993,-1534490
2019-03-13,5.8 ( 0 %),1070,6790890,6346.63,1074,9074940,8450,-2284050
2019-03-12,5.8 ( 0.69 %),1366,7880190,5768.81,904,8969840,9922,-1089650
2019-03-11,5.76 ( -1.87 %),1406,7039380,5006.67,915,7651750,8363,-612370
2019-03-08,5.87 ( -3.29 %),1808,10639520,5884.69,1336,11202760,8385,-563240
2019-03-07,6.07 ( -1.3 %),1449,8530180,5886.94,1419,9163380,6458,-633200
2019-03-06,6.15 ( 1.15 %),1599,13745480,8596.3,1690,12368550,7319,1376930
2019-03-05,6.08 ( 0.66 %),3139,19063230,6073.03,2583,22207550,8598,-3144320
2019-03-04,6.04 ( 6.9 %),2462,25724470,10448.61,2063,16293150,7898,9431320
2019-03-01,5.65 ( 2.36 %),980,9664580,9861.82,976,8946520,9167,718060
2019-02-28,5.52 ( -2.99 %),1261,10537780,8356.69,1557,12776170,8206,-2238390
2019-02-27,5.69 ( 0.53 %),1091,7705430,7062.72,1305,9274760,7107,-1569330
2019-02-26,5.66 ( 2.91 %),2135,19475600,9122.06,2893,20399490,7051,-923890
2019-02-25,5.5 ( 0.18 %),1037,6550180,6316.47,1359,9402830,6919,-2852650
2019-02-22,5.49 ( 1.48 %),1132,8594280,7592.12,1719,10766580,6263,-2172300
2019-02-21,5.41 ( 1.5 %),1070,7986200,7463.74,1554,10551900,6790,-2565700
2019-02-20,5.33 ( -2.02 %),1247,8450230,6776.45,1121,8802740,7853,-352510
2019-02-19,5.44 ( 0 %),1912,15344800,8025.52,2331,18014490,7728,-2669690
2019-02-18,5.44 ( 5.22 %),1511,15560370,10298.06,2105,15973490,7588,-413120
2019-02-15,5.17 ( -0.58 %),1450,7264190,5009.79,1026,7968960,7767,-704770
2019-02-14,5.2 ( -2.26 %),1080,6330760,5861.81,859,7270460,8464,-939700
2019-02-13,5.32 ( 0.38 %),1069,7988000,7472.4,1662,10299320,6197,-2311320
2019-02-12,5.3 ( 6.85 %),1927,17625010,9146.35,1923,12778940,6645,4846070
2019-02-11,4.96 ( -0.8 %),525,2366640,4507.89,419,2353690,5617,12950
2019-02-01,5 ( 0 %),596,2839800,4764.77,392,2691240,6865,148560
2019-01-31,5 ( 0 %),800,3766910,4708.64,859,4580790,5333,-813880
2019-01-30,5 ( 1.42 %),363,2617190,7209.89,469,2670830,5695,-53640
2019-01-29,4.93 ( -1.4 %),513,2490360,4854.5,444,3243240,7305,-752880
2019-01-28,5 ( 0 %),341,1757900,5155.13,473,2203090,4658,-445190
2019-01-25,5 ( 0.2 %),383,2987320,7799.79,713,3606710,5058,-619390
2019-01-24,4.99 ( -0.2 %),424,2784900,6568.16,528,4045830,7663,-1260930
2019-01-23,5 ( 0.4 %),508,3129290,6160.02,729,4107200,5634,-977910
2019-01-22,4.98 ( 0.61 %),635,3339720,5259.4,677,4404680,6506,-1064960
2019-01-21,4.95 ( -0.8 %),785,2768580,3526.85,510,3174270,6224,-405690
2019-01-18,4.99 ( -0.8 %),689,2108140,3059.71,585,2877740,4919,-769600
2019-01-17,5.03 ( -1.57 %),582,2412080,4144.47,668,3972780,5947,-1560700
2019-01-16,5.11 ( 0.79 %),816,4175790,5117.39,1014,6144650,6060,-1968860
2019-01-15,5.07 ( 0 %),749,3862900,5157.41,820,4957710,6046,-1094810
2019-01-14,5.07 ( -0.2 %),894,4020510,4497.21,1242,6938560,5587,-2918050
2019-01-11,5.08 ( 4.53 %),1498,8733900,5830.37,1476,9927540,6726,-1193640
2019-01-10,4.86 ( 3.18 %),1024,5240910,5118.08,692,4023750,5815,1217160
2019-01-09,4.71 ( -0.84 %),496,2732610,5509.29,467,2733870,5854,-1260
2019-01-08,4.75 ( 1.93 %),517,2989390,5782.19,400,2368560,5921,620830
2019-01-07,4.66 ( 0 %),520,2064280,3969.77,343,1879820,5481,184460
2019-01-04,4.66 ( -0.43 %),698,3514270,5034.77,401,2885290,7195,628980
2019-01-03,4.68 ( -2.09 %),974,3971640,4077.66,573,3948310,6891,23330
2019-01-02,4.78 ( -2.05 %),712,2333590,3277.51,357,2911040,8154,-577450
2018-12-28,4.88 ( -1.21 %),555,1927630,3473.21,458,3034850,6626,-1107220
2018-12-27,4.94 ( 1.23 %),475,2498870,5260.78,524,2831150,5403,-332280
2018-12-26,4.88 ( 0 %),685,3005110,4387.02,466,3475820,7459,-470710
2018-12-25,4.88 ( -3.37 %),1233,5046210,4092.63,658,6219720,9452,-1173510
2018-12-24,5.05 ( 0 %),1024,4188070,4089.91,505,5346960,10588,-1158890
2018-12-21,5.05 ( -0.79 %),699,3866520,5531.5,497,4137000,8324,-270480
2018-12-20,5.09 ( -1.93 %),555,2102420,3788.14,492,3081660,6264,-979240
2018-12-19,5.19 ( -0.19 %),589,2184940,3709.58,692,3564100,5150,-1379160
2018-12-18,5.2 ( 1.96 %),1043,4981130,4775.77,538,4605760,8561,375370
2018-12-17,5.1 ( -1.54 %),796,2973050,3734.99,560,4275910,7636,-1302860
2018-12-14,5.18 ( -0.38 %),642,3847170,5992.48,492,4512320,9171,-665150
2018-12-13,5.2 ( 0.19 %),619,3932250,6352.58,705,5370060,7617,-1437810
2018-12-12,5.19 ( 0.39 %),734,3730470,5082.38,525,5663880,10788,-1933410
2018-12-11,5.17 ( -0.19 %),622,2790310,4486.03,463,3938210,8506,-1147900
2018-12-10,5.18 ( -0.38 %),628,2851990,4541.39,678,5045790,7442,-2193800
2018-12-07,5.2 ( 0.58 %),663,5182190,7816.27,710,4966190,6995,216000
2018-12-06,5.17 ( -0.19 %),626,2283450,3647.68,462,2713390,5873,-429940
2018-12-05,5.18 ( -1.33 %),574,3098700,5398.43,665,3305150,4970,-206450
2018-12-04,5.25 ( 1.94 %),731,7695890,10527.89,742,6704580,9036,991310
2018-12-03,5.15 ( 0 %),932,4604340,4940.28,568,4685580,8249,-81240
2018-11-30,5.15 ( 1.98 %),1259,5706650,4532.68,514,4685310,9115,1021340
2018-11-29,5.05 ( -2.32 %),1047,4581190,4375.54,516,5178620,10036,-597430
2018-11-28,5.17 ( -0.77 %),617,1876500,3041.33,414,2322380,5610,-445880
2018-11-27,5.21 ( -0.76 %),664,2237830,3370.23,440,3042190,6914,-804360
2018-11-26,5.25 ( 0 %),649,2341450,3607.78,455,2613070,5743,-271620
2018-11-23,5.25 ( -4.37 %),825,2712510,3287.89,626,4611060,7366,-1898550
2018-11-22,5.49 ( -1.08 %),662,2858630,4318.17,652,4300990,6597,-1442360
2018-11-21,5.55 ( 0 %),517,3102930,6001.8,688,4746040,6898,-1643110
2018-11-20,5.55 ( -0.89 %),506,5185440,10247.91,892,6662640,7469,-1477200
2018-11-19,5.6 ( 0.18 %),615,3244380,5275.41,841,5083960,6045,-1839580
2018-11-16,5.59 ( 1.82 %),751,7257620,9663.94,1259,9216820,7321,-1959200
2018-11-15,5.49 ( 1.67 %),618,6419150,10386.97,1052,6208040,5901,211110
2018-11-14,5.4 ( 0 %),558,5309370,9515,900,5940380,6600,-631010
2018-11-13,5.4 ( -1.64 %),756,4329890,5727.37,821,5372080,6543,-1042190
2018-11-12,5.49 ( 0.92 %),727,5042140,6935.54,900,6039880,6711,-997740
2018-11-09,5.44 ( -0.37 %),1082,7502170,6933.61,1541,8897540,5774,-1395370
2018-11-08,5.46 ( 4 %),1014,7994130,7883.76,1465,8872710,6056,-878580
2018-11-07,5.25 ( 0.57 %),501,3875860,7736.25,799,4918430,6156,-1042570
2018-11-06,5.22 ( 0.38 %),669,3658000,5467.86,944,4831200,5118,-1173200
2018-11-05,5.2 ( 0.19 %),777,4366740,5620,980,5861840,5981,-1495100
2018-11-02,5.19 ( 2.17 %),984,6447000,6551.83,1210,6209660,5132,237340
2018-11-01,5.08 ( 0 %),879,4152880,4724.55,934,5959620,6381,-1806740
2018-10-31,5.08 ( 2.63 %),1068,5841580,5469.64,1107,6072180,5485,-230600
2018-10-30,4.95 ( 3.99 %),550,3341690,6075.8,607,3245780,5347,95910
2018-10-29,4.76 ( 0.21 %),997,5467440,5483.89,506,4656000,9202,811440
2018-10-26,4.75 ( -3.06 %),1214,4231500,3485.58,650,5393910,8298,-1162410
2018-10-25,4.9 ( -2 %),1866,8614010,4616.3,827,7515220,9087,1098790
2018-10-24,5 ( -0.99 %),1079,4671740,4329.69,577,5610430,9723,-938690
2018-10-23,5.05 ( -3.26 %),1189,4628900,3893.1,607,4900400,8073,-271500
2018-10-22,5.22 ( -1.14 %),858,2790350,3252.16,567,4010190,7073,-1219840
2018-10-19,5.28 ( 3.53 %),1634,9838640,6021.2,1324,8953040,6762,885600
2018-10-18,5.1 ( -1.35 %),1109,3171000,2859.33,462,3624170,7845,-453170
2018-10-17,5.17 ( -1.52 %),2193,8899600,4058.19,979,11821730,12075,-2922130
2018-10-16,5.25 ( 0.77 %),987,3965950,4018.19,520,3670480,7059,295470
2018-10-15,5.21 ( -2.25 %),959,3225250,3363.14,537,4691300,8736,-1466050
2018-10-12,5.33 ( 2.3 %),2019,11846680,5867.6,967,7948280,8220,3898400
2018-10-11,5.21 ( -6.96 %),2442,11313040,4632.69,1335,15285620,11450,-3972580
2018-10-10,5.6 ( -0.88 %),1438,7307720,5081.86,722,7808310,10815,-500590
2018-10-09,5.65 ( -2.92 %),1255,5614140,4473.42,722,7197800,9969,-1583660
2018-10-08,5.82 ( -1.36 %),1641,7055160,4299.31,826,7300190,8838,-245030
2018-10-05,5.9 ( -1.5 %),1162,5333040,4589.54,755,5843910,7740,-510870
2018-10-04,5.99 ( 0.34 %),1393,6214590,4461.3,775,5306320,6847,908270
2018-10-03,5.97 ( -0.33 %),1348,6378980,4732.18,821,5954280,7252,424700
2018-10-02,5.99 ( -1.16 %),1996,9314910,4666.79,899,8235800,9161,1079110
2018-10-01,6.06 ( -1.14 %),1615,7355110,4554.25,1075,7927900,7375,-572790
2018-09-28,6.13 ( -0.49 %),1467,6399230,4362.12,1260,8999940,7143,-2600710
2018-09-27,6.16 ( 0.16 %),994,4838410,4867.62,1411,7733690,5481,-2895280
2018-09-26,6.15 ( 1.49 %),2210,13888430,6284.36,2416,13013320,5386,875110
2018-09-25,6.06 ( -0.66 %),1490,7785740,5225.33,1005,8455060,8413,-669320
2018-09-24,6.1 ( 0 %),871,6109040,7013.82,1189,6263010,5267,-153970
2018-09-20,6 ( 0.33 %),1649,7316530,4436.95,876,4846540,5533,2469990
2018-09-19,5.98 ( 0.17 %),1748,6751020,3862.14,1017,6610640,6500,140380
2018-09-18,5.97 ( 0.17 %),2245,8421100,3751.05,1070,6757840,6316,1663260
2018-09-17,5.96 ( -2.45 %),1956,7496970,3832.81,918,7631420,8313,-134450
2018-09-14,6.11 ( -0.65 %),1782,8477090,4757.07,823,4999630,6075,3477460
2018-09-13,6.15 ( -0.49 %),2063,7829120,3795.02,887,8235890,9285,-406770
2018-09-12,6.18 ( -2.06 %),2228,10865480,4876.79,1770,14381320,8125,-3515840
2018-09-11,6.31 ( 6.95 %),2325,17973670,7730.61,1582,9406560,5946,8567110
2018-09-10,5.9 ( 0.17 %),1632,7048620,4319.01,868,7744820,8923,-696200
2018-09-07,5.89 ( -3.28 %),3468,17814620,5136.86,1675,16739440,9994,1075180
2018-09-06,6.09 ( -6.31 %),2902,14712030,5069.62,1602,18939180,11822,-4227150
2018-09-05,6.5 ( -1.52 %),2100,11033350,5253.98,1368,16093350,11764,-5060000
2018-09-04,6.6 ( -2.8 %),1988,10861650,5463.61,1320,15719690,11909,-4858040
2018-08-31,6.79 ( -1.45 %),2783,14633770,5258.27,1667,19007480,11402,-4373710
2018-08-30,6.89 ( -1.43 %),1373,10227400,7448.94,1351,16862520,12482,-6635120
2018-08-29,6.99 ( 1.3 %),1650,12105590,7336.72,1874,19460580,10385,-7354990
2018-08-28,0 ( 0 %),1366,8914900,6526.28,1404,13488770,9607,-4573870
2018-08-27,6.8 ( -1.45 %),1987,12722070,6402.65,1481,16542900,11170,-3820830
2018-08-24,6.9 ( -1.43 %),1373,6280170,4574.05,1252,9790470,7820,-3510300
2018-08-23,7 ( -0.14 %),2049,10149520,4953.4,1509,11798720,7819,-1649200
2018-08-22,7.01 ( -1.68 %),1825,10264520,5624.39,1999,14779340,7393,-4514820
2018-08-21,7.13 ( 0.14 %),1489,9961360,6689.97,2125,15353040,7225,-5391680
2018-08-20,7.12 ( 6.75 %),2567,16245330,6328.53,2084,15226780,7307,1018550
2018-08-17,6.67 ( -0.45 %),2256,8563330,3795.8,1235,10393950,8416,-1830620
2018-08-16,6.7 ( -4.29 %),3063,12855450,4197.01,1464,14363870,9811,-1508420
2018-08-15,7 ( -3.98 %),3933,19757070,5023.41,1901,18141520,9543,1615550
2018-08-14,7.29 ( -1.49 %),1710,9237460,5402.02,1816,14727760,8110,-5490300
2018-08-13,7.4 ( -1.73 %),2009,9892880,4924.28,2060,14572110,7074,-4679230
2018-08-10,7.53 ( 1.35 %),8089,65967070,8155.16,5524,73539710,13313,-7572640
2018-08-09,7.43 ( 6.91 %),2615,35921180,13736.59,622,2866530,4609,33054650
2018-08-08,6.95 ( 1.91 %),1897,11787010,6213.5,1700,12239400,7200,-452390
2018-08-07,6.82 ( -5.67 %),2550,13481280,5286.78,2063,16804250,8146,-3322970
2018-08-06,7.23 ( 1.12 %),2284,14149800,6195.18,2840,20899950,7359,-6750150
2018-08-03,7.15 ( 3.62 %),2048,18741390,9151.07,2425,20415220,8419,-1673830
2018-08-02,6.9 ( -2.82 %),3646,28615320,7848.41,2943,31239780,10615,-2624460
2018-08-01,7.1 ( -6.82 %),3701,19935840,5386.61,3107,25288510,8139,-5352670
2018-07-31,7.62 ( 0.53 %),5246,43613990,8313.76,6002,48854170,8140,-5240180
2018-07-30,7.58 ( 6.91 %),1817,21717740,11952.53,1310,7982560,6094,13735180
2018-07-27,7.09 ( 6.94 %),3316,35023180,10561.88,2889,19105160,6613,15918020
2018-07-26,6.63 ( -6.88 %),3854,26840860,6964.42,4395,40592610,9236,-13751750
2018-07-25,7.12 ( 0.56 %),5496,35959980,6542.94,4103,35992300,8772,-32320
2018-07-24,7.08 ( 6.95 %),4705,38223810,8124.08,3496,25535750,7304,12688060
2018-07-23,6.62 ( 6.95 %),3689,47717430,12935.06,3994,34924600,8744,12792830
2018-07-20,6.19 ( -1.12 %),3079,25740330,8359.96,2346,30464020,12986,-4723690
2018-07-19,6.26 ( -1.11 %),4799,32316560,6734.02,2581,40001520,15498,-7684960
2018-07-18,6.33 ( 6.75 %),3729,31910130,8557.29,3075,29608980,9629,2301150
2018-07-17,5.93 ( 3.67 %),3708,26203750,7066.81,2892,30635790,10593,-4432040
2018-07-16,5.72 ( 6.92 %),1581,29337190,18556.1,896,9569160,10680,19768030
2018-07-13,5.35 ( 7 %),2175,27739400,12753.75,2554,21742370,8513,5997030
2018-07-12,5 ( 2.46 %),732,7566360,10336.56,685,8382470,12237,-816110
2018-07-11,4.88 ( -1.81 %),1019,10124230,9935.46,739,10954080,14823,-829850
2018-07-10,4.97 ( -0.6 %),1086,5891610,5425.06,715,7561160,10575,-1669550
2018-07-09,5 ( -3.66 %),1189,8645750,7271.45,1120,10795220,9639,-2149470
2018-07-06,5.19 ( 4.01 %),1128,11384020,10092.22,1416,12679130,8954,-1295110
2018-07-05,4.99 ( 2.25 %),1058,9271440,8763.18,892,9209030,10324,62410
2018-07-04,4.88 ( -3.37 %),1118,6379000,5705.72,876,7735970,8831,-1356970
2018-07-03,5.05 ( -2.88 %),906,7120660,7859.45,1227,9494600,7738,-2373940
2018-07-02,5.2 ( -0.19 %),1417,9595390,6771.62,1400,12630590,9022,-3035200
2018-06-29,5.21 ( 4.2 %),1324,13277390,10028.24,1782,14114220,7920,-836830
2018-06-28,5 ( -2.53 %),1203,8208470,6823.33,1126,8773240,7792,-564770
2018-06-27,5.13 ( 1.18 %),1661,13235130,7968.17,2233,14643520,6558,-1408390
2018-06-26,5.07 ( 4.75 %),1895,17053580,8999.25,2453,18770140,7652,-1716560
2018-06-25,4.84 ( 2.98 %),1174,9062140,7719.03,1367,10573630,7735,-1511490
2018-06-22,4.7 ( -1.47 %),707,4091470,5787.09,581,6114450,10524,-2022980
2018-06-21,4.77 ( 0 %),1041,6433590,6180.2,559,6020320,10770,413270
2018-06-20,4.77 ( 0.21 %),1088,5326520,4895.7,824,6367580,7728,-1041060
2018-06-19,4.76 ( -4.99 %),1554,9947290,6401.09,1304,13788120,10574,-3840830
2018-06-18,5.01 ( 6.82 %),1750,20618340,11781.91,2182,13788230,6319,6830110
2018-06-15,4.69 ( 0.86 %),1516,32021740,21122.52,1460,21221180,14535,10800560
2018-06-14,4.65 ( 3.56 %),1960,22703220,11583.28,1603,19968560,12457,2734660
2018-06-13,4.49 ( 0.9 %),752,2690830,3578.23,600,3113120,5189,-422290
2018-06-12,4.45 ( -3.47 %),1573,6728850,4277.72,710,6756530,9516,-27680
2018-06-11,4.61 ( -3.76 %),1295,5235090,4042.54,770,7877760,10231,-2642670
2018-06-08,4.79 ( 0.21 %),717,2812300,3922.32,635,2819880,4441,-7580
2018-06-07,4.78 ( 2.58 %),1326,6015650,4536.69,1092,6386240,5848,-370590
2018-06-06,4.66 ( -1.48 %),793,3285900,4143.63,611,4626980,7573,-1341080
2018-06-05,4.73 ( 2.38 %),906,5052460,5576.67,769,4817620,6265,234840
2018-06-04,4.62 ( 2.67 %),1243,5334310,4291.48,685,4623630,6750,710680
2018-06-01,4.5 ( 0.9 %),779,5065280,6502.28,616,3429710,5568,1635570
2018-05-31,4.46 ( 0.68 %),846,4300420,5083.24,469,3334860,7111,965560
2018-05-30,4.43 ( -1.34 %),697,2388710,3427.13,390,2616400,6709,-227690
2018-05-29,4.49 ( 1.58 %),1317,6119880,4646.83,696,4694020,6744,1425860
2018-05-28,4.42 ( -6.95 %),1205,5666170,4702.22,651,8154660,12526,-2488490
2018-05-25,4.75 ( -3.06 %),852,2848660,3343.5,376,3025670,8047,-177010
2018-05-24,4.9 ( -2 %),1002,3089130,3082.96,450,3229170,7176,-140040
2018-05-23,5 ( -0.99 %),1011,3517240,3478.97,470,2981060,6343,536180
2018-05-22,5.05 ( -3.81 %),965,5005490,5187.04,679,5965820,8786,-960330
2018-05-21,5.25 ( -0.19 %),425,2212540,5205.98,708,3631410,5129,-1418870
2018-05-18,5.26 ( 0.19 %),615,5297880,8614.44,1250,6435260,5148,-1137380
2018-05-17,5.25 ( 0.96 %),592,4161240,7029.12,1112,4426080,3980,-264840
2018-05-16,5.2 ( 0.78 %),570,3867220,6784.6,900,3486370,3874,380850
2018-05-15,5.16 ( 0.39 %),713,3490330,4895.27,699,3294020,4712,196310
2018-05-11,5.2 ( 1.96 %),944,4100980,4344.26,652,4113960,6310,-12980
2018-05-10,5.1 ( -2.86 %),953,3555680,3731.04,832,4431450,5326,-875770
2018-05-09,5.25 ( -0.57 %),1001,4357140,4352.79,906,4816900,5317,-459760
2018-05-08,5.28 ( 1.54 %),986,4849780,4918.64,1179,5396810,4577,-547030
2018-05-07,0 ( 0 %),1224,5491530,4486.54,1035,6490610,6271,-999080
2018-05-04,5.15 ( 6.85 %),1991,13835530,6949.04,770,11388840,14791,2446690
2018-05-03,4.82 ( -2.23 %),1512,7044960,4659.37,798,5871680,7358,1173280
2018-05-02,4.93 ( -6.98 %),2019,8055060,3989.63,940,10351060,11012,-2296000
2018-04-27,5.3 ( -1.85 %),2183,6942440,3180.23,1183,7792030,6587,-849590
2018-04-26,5.4 ( 0 %),1089,6141950,5639.99,1363,6470750,4747,-328800
2018-04-24,5.4 ( 1.31 %),895,4972790,5556.19,834,5071060,6080,-98270
2018-04-23,5.33 ( -3.27 %),761,4990780,6558.19,1044,5850850,5604,-860070
2018-04-20,5.51 ( 0.36 %),954,4535380,4754.07,792,3991850,5040,543530
2018-04-19,5.49 ( -3.17 %),1506,8408220,5583.15,1019,8804090,8640,-395870
2018-04-18,5.67 ( -2.24 %),1112,8787150,7902.11,1251,8690910,6947,96240
2018-04-17,5.8 ( 1.75 %),1295,8051940,6217.71,1402,8775200,6259,-723260
2018-04-16,5.7 ( 4.01 %),1659,10507890,6333.87,1771,9037030,5103,1470860
2018-04-13,5.48 ( 3.79 %),2109,14272360,6767.36,1352,8701190,6436,5571170
2018-04-12,5.28 ( -2.76 %),2957,14492400,4901.05,1381,11780170,8530,2712230
2018-04-11,5.43 ( -5.57 %),3116,11674490,3746.63,1459,11872900,8138,-198410
2018-04-10,5.75 ( -4.96 %),3593,13626300,3792.46,1579,16500840,10450,-2874540
2018-04-09,6.05 ( -2.26 %),2777,11603080,4178.28,1408,13069970,9283,-1466890
2018-04-06,6.19 ( -0.96 %),1661,12827230,7722.59,1580,12852260,8134,-25030
2018-04-05,6.25 ( -0.79 %),2056,10095960,4910.49,1293,8654000,6693,1441960
2018-04-04,6.3 ( -2.02 %),1729,10043650,5808.94,1306,8574390,6565,1469260
2018-04-03,6.43 ( 4.55 %),3324,20036050,6027.69,2146,12808990,5969,7227060
2018-04-02,6.15 ( -6.96 %),5226,26603090,5090.53,2560,33038600,12906,-6435510
2018-03-30,6.61 ( -1.34 %),1404,4972250,3541.49,739,5129450,6941,-157200
2018-03-29,6.7 ( 0 %),1145,4088520,3570.76,776,3567560,4597,520960
2018-03-28,6.7 ( -1.76 %),1864,7443330,3993.2,997,7045350,7067,397980
2018-03-27,6.82 ( -2.01 %),2131,7774430,3648.25,1109,8554500,7714,-780070
2018-03-26,6.96 ( -0.57 %),1331,6569910,4936.07,940,6555090,6974,14820
2018-03-23,7 ( -2.64 %),2390,11807200,4940.25,1502,10608070,7063,1199130
2018-03-22,7.19 ( 2.71 %),1589,9137500,5750.47,1769,10554180,5966,-1416680
2018-03-21,7 ( 0.86 %),1484,7105650,4788.17,1229,6495480,5285,610170
2018-03-20,6.94 ( 0.58 %),2190,8852210,4042.11,1148,6563480,5717,2288730
2018-03-19,6.9 ( -5.22 %),4634,22184450,4787.32,2217,24282980,10953,-2098530
2018-03-16,7.28 ( -1.75 %),2813,11801180,4195.23,1995,13212340,6623,-1411160
2018-03-15,7.41 ( 0 %),2568,12485370,4861.9,2347,15379450,6553,-2894080
2018-03-14,7.41 ( 3.64 %),2665,18649600,6997.97,2812,17568010,6248,1081590
2018-03-13,7.15 ( 0.85 %),1922,10544450,5486.19,1900,11177230,5883,-632780
2018-03-12,7.09 ( 0.14 %),1557,6737930,4327.51,1783,10128680,5681,-3390750
2018-03-09,7.08 ( 2.46 %),3087,16606290,5379.43,2834,18710910,6602,-2104620
2018-03-08,6.91 ( -1.14 %),2545,13414870,5271.07,2331,18053160,7745,-4638290
2018-03-07,6.99 ( 3.4 %),3499,16341810,4670.42,2782,20600960,7405,-4259150
2018-03-06,6.76 ( 6.96 %),2425,19731100,8136.54,1899,12040370,6340,7690730
2018-03-05,6.32 ( 0.48 %),2126,13444270,6323.74,1801,13144840,7299,299430
2018-03-02,6.29 ( 0.64 %),1528,5325110,3485.02,826,5200750,6296,124360
2018-03-01,6.25 ( 0.48 %),1754,6442180,3672.85,1366,7580940,5550,-1138760
2018-02-28,6.22 ( -2.81 %),1680,7651530,4554.48,1161,8414330,7247,-762800
2018-02-27,6.4 ( 3.23 %),1394,7831190,5617.78,1305,7306240,5599,524950
2018-02-26,6.2 ( -2.36 %),2183,10909810,4997.62,1515,12108400,7992,-1198590
2018-02-23,6.35 ( 0.79 %),1677,10896880,6497.84,1197,7516820,6280,3380060
2018-02-22,6.3 ( -3.37 %),2206,8526490,3865.14,1333,9338310,7005,-811820
2018-02-21,6.52 ( 0.31 %),2135,9014350,4222.18,1222,9443330,7728,-428980
2018-02-13,6.5 ( 5.69 %),2972,17965930,6045.06,1542,13352600,8659,4613330
2018-02-12,6.15 ( -5.38 %),3906,22327050,5716.09,1431,23715710,16573,-1388660
2018-02-09,6.5 ( -1.81 %),2800,17889870,6389.24,1528,16390630,10727,1499240
2018-02-08,6.62 ( -6.89 %),4194,23352590,5568.09,1636,30957990,18923,-7605400
2018-02-07,7.11 ( 2.01 %),2167,8036760,3708.7,1075,8890980,8271,-854220
2018-02-06,6.97 ( -6.94 %),2310,16745760,7249.25,1621,28008070,17278,-11262310
2018-02-05,7.49 ( -6.96 %),3498,17968210,5136.71,1705,24837580,14567,-6869370
2018-02-02,8.05 ( 0 %),1477,7685470,5203.43,1135,8226610,7248,-541140
2018-02-01,8.05 ( -1.83 %),2303,11545810,5013.38,1264,13045160,10321,-1499350
2018-01-31,8.2 ( 1.36 %),3758,23659600,6295.8,3107,24408040,7856,-748440
2018-01-30,8.09 ( -2.53 %),3384,20902980,6177,1580,18611890,11780,2291090
2018-01-29,8.3 ( -1.19 %),2163,16916700,7820.94,2096,17528730,8363,-612030
2018-01-26,8.4 ( -1.06 %),2936,18614060,6339.94,3116,25439830,8164,-6825770
2018-01-25,8.49 ( 6.93 %),3355,32147160,9581.87,2560,24702720,9650,7444440
2018-01-22,7.94 ( -2.58 %),2597,16346400,6294.34,1805,16961960,9397,-615560
2018-01-19,8.15 ( -1.81 %),2116,14398400,6804.54,2039,18077150,8866,-3678750
2018-01-18,8.3 ( 1.72 %),2177,16782500,7709,2183,14891770,6822,1890730
2018-01-17,8.16 ( 0 %),3909,23338020,5970.33,3262,26035350,7981,-2697330
2018-01-16,8.16 ( 6.95 %),3646,35036310,9609.52,3900,27868890,7146,7167420
2018-01-15,7.63 ( 1.73 %),1380,8678760,6288.96,1656,9735360,5879,-1056600
2018-01-12,7.5 ( 0 %),1085,6999660,6451.3,1123,7318240,6517,-318580
2018-01-11,7.5 ( -1.7 %),1503,7539690,5016.43,1277,8094770,6339,-555080
2018-01-10,7.63 ( 1.06 %),1842,10631280,5771.6,1229,8334360,6781,2296920
2018-01-09,7.55 ( -1.56 %),1329,6144570,4623.45,1068,6662660,6238,-518090
2018-01-08,7.67 ( -0.39 %),1380,8480180,6145.06,1615,10638700,6587,-2158520
2018-01-05,7.7 ( 3.22 %),1774,15242130,8591.96,2876,15858370,5514,-616240
2018-01-04,7.46 ( 2.05 %),969,6061220,6255.13,1420,7296030,5138,-1234810
2018-01-03,7.31 ( 0.83 %),972,4477880,4606.87,791,3986580,5040,491300
2018-01-02,7.25 ( -1.36 %),1500,5139160,3426.11,686,5561890,8108,-422730
2017-12-29,7.35 ( -1.34 %),1006,3668150,3646.27,595,4349420,7310,-681270
2017-12-28,7.45 ( 0.68 %),851,5990310,7039.14,706,5896700,8352,93610
2017-12-27,7.4 ( 0 %),1013,7411830,7316.71,833,9141790,10975,-1729960
2017-12-26,7.4 ( 1.37 %),1053,7427600,7053.75,773,6843050,8853,584550
2017-12-25,7.3 ( -1.48 %),887,3260690,3676.09,531,3229870,6083,30820
2017-12-22,7.41 ( 0.82 %),969,5465020,5639.86,581,3555420,6119,1909600
2017-12-21,7.35 ( -2.13 %),1830,8986140,4910.46,596,6704530,11249,2281610
2017-12-20,7.51 ( 0.13 %),734,3964790,5401.62,662,3821190,5772,143600
2017-12-19,7.5 ( -2.85 %),1062,4933060,4645.07,939,6892050,7340,-1958990
2017-12-18,7.72 ( 4.89 %),1297,8352880,6440.15,1692,9724540,5747,-1371660
2017-12-15,7.36 ( -0.27 %),668,3601210,5391.03,585,3221370,5507,379840
2017-12-14,7.38 ( 0.82 %),656,2445290,3727.58,523,2072680,3963,372610
2017-12-13,7.32 ( 0.14 %),888,4815200,5422.52,557,3924290,7045,890910
2017-12-12,7.31 ( -2.79 %),1503,5202890,3461.67,687,5661700,8241,-458810
2017-12-11,7.52 ( -2.72 %),818,2569330,3140.99,491,3032270,6176,-462940
2017-12-08,7.73 ( -1.28 %),872,2941830,3373.66,719,3679220,5117,-737390
2017-12-07,7.83 ( 1.69 %),894,5726350,6405.31,1654,7812510,4723,-2086160
2017-12-06,7.7 ( 2.12 %),771,4831310,6266.29,848,4651830,5486,179480
2017-12-05,7.54 ( 0.4 %),1116,6430180,5761.81,1008,6401260,6350,28920
2017-12-04,7.51 ( -1.44 %),1574,5102840,3241.96,728,5781870,7942,-679030
2017-12-01,7.62 ( -1.42 %),1075,4191440,3899.01,626,4498290,7186,-306850
2017-11-30,7.73 ( 0.39 %),998,4774190,4783.76,770,4709650,6116,64540
2017-11-29,7.7 ( -1.53 %),946,6438090,6805.59,1029,8352190,8117,-1914100
2017-11-28,7.82 ( 0.9 %),1193,8821890,7394.71,1335,9584480,7179,-762590
2017-11-27,7.75 ( 0.78 %),1163,6054530,5205.96,1119,6159800,5505,-105270
2017-11-24,7.69 ( 2.4 %),840,6047090,7198.92,951,5946270,6253,100820
2017-11-23,7.51 ( -0.13 %),894,4359700,4876.62,559,4490140,8032,-130440
2017-11-22,7.52 ( 0.13 %),1122,5748680,5123.6,772,5231980,6777,516700
2017-11-21,7.51 ( -2.09 %),1146,4092740,3571.33,657,4169550,6346,-76810
2017-11-20,7.67 ( -1.79 %),803,2605220,3244.36,818,4187040,5119,-1581820
2017-11-17,7.81 ( 1.17 %),1082,5739140,5304.2,1775,8931240,5032,-3192100
2017-11-16,7.72 ( 6.93 %),928,6433350,6932.49,1044,4216250,4039,2217100
2017-11-15,7.22 ( 0 %),748,3800390,5080.74,478,3762430,7871,37960
2017-11-14,7.22 ( -2.17 %),774,2953920,3816.43,523,3552820,6793,-598900
2017-11-13,7.38 ( -0.81 %),516,5712290,11070.33,855,6212620,7266,-500330
2017-11-10,7.44 ( 1.92 %),717,5840900,8146.3,1117,5319020,4762,521880
2017-11-09,7.3 ( -0.27 %),649,5096930,7853.51,706,4251690,6022,845240
2017-11-08,7.32 ( 0.27 %),1074,6184990,5758.84,893,4822890,5401,1362100
2017-11-07,7.3 ( 0.14 %),916,3694090,4032.85,837,4198160,5016,-504070
2017-11-06,7.29 ( 3.55 %),1578,8694740,5509.97,943,6232890,6610,2461850
2017-11-03,7.04 ( -6.38 %),2650,10825890,4085.24,1031,14353790,13922,-3527900
2017-11-02,7.52 ( -6.93 %),1146,6797330,5931.35,928,5674780,6115,1122550
2017-11-01,8.08 ( 0.75 %),1255,12566560,10013.2,1755,14137380,8055,-1570820
2017-10-31,8.02 ( 3.48 %),1338,17860030,13348.3,1591,11397280,7164,6462750
2017-10-30,7.75 ( 2.65 %),1147,9230290,8047.33,826,6631840,8029,2598450
2017-10-27,7.55 ( -1.95 %),1232,5547870,4503.14,718,5769540,8036,-221670
2017-10-26,7.7 ( -2.65 %),1017,3363860,3307.63,665,4149620,6240,-785760
2017-10-25,7.91 ( 1.8 %),1076,3935100,3657.16,850,4088670,4810,-153570
2017-10-24,7.77 ( 0.39 %),1075,3754070,3492.16,542,2895100,5342,858970
2017-10-23,7.74 ( -4.44 %),1473,4736930,3215.84,656,6026460,9187,-1289530
2017-10-20,8.1 ( -0.98 %),1028,2462290,2395.22,461,3170670,6878,-708380
2017-10-19,8.18 ( 0 %),1026,2995820,2919.9,483,3222530,6672,-226710
2017-10-18,8.18 ( -1.33 %),1196,2705970,2262.52,515,3425600,6652,-719630
2017-10-17,8.29 ( -0.48 %),803,2368810,2949.95,517,3016680,5835,-647870
2017-10-16,8.33 ( 0.6 %),648,7228780,11155.52,648,3676270,5673,3552510
2017-10-13,8.28 ( 0.12 %),640,1937910,3027.98,455,2235280,4913,-297370
2017-10-12,8.27 ( -0.6 %),788,2045880,2596.29,389,2337600,6009,-291720
2017-10-11,8.32 ( 0.12 %),510,2067080,4053.1,497,2682550,5397,-615470
2017-10-10,8.31 ( -0.36 %),693,1937790,2796.23,429,2442060,5692,-504270
2017-10-09,8.34 ( 0.6 %),491,2666770,5431.3,576,2707990,4701,-41220
2017-10-06,8.29 ( -0.12 %),676,2024480,2994.79,364,2361830,6489,-337350
2017-10-05,8.3 ( -0.95 %),585,1981630,3387.4,507,3297150,6503,-1315520
2017-10-04,8.38 ( 1.58 %),589,2296340,3898.71,365,2092610,5733,203730
2017-10-03,8.25 ( -1.2 %),993,2968180,2989.1,550,3307250,6013,-339070
2017-10-02,8.35 ( -0.6 %),851,3307040,3886.06,555,3088390,5565,218650
2017-09-29,8.4 ( -1.52 %),976,4199460,4302.73,601,4354060,7245,-154600
2017-09-28,8.53 ( -1.84 %),777,4196750,5401.22,1036,6022960,5814,-1826210
2017-09-27,8.69 ( -1.25 %),1050,4726430,4501.36,1981,9988210,5042,-5261780
2017-09-26,8.8 ( 5.26 %),1507,9036630,5996.44,2425,10011540,4128,-974910
2017-09-25,8.36 ( -0.48 %),630,1823320,2894.16,597,2406900,4032,-583580
2017-09-22,8.4 ( 0 %),717,4761430,6640.77,890,5212270,5856,-450840
2017-09-21,8.4 ( 0.6 %),687,2335780,3399.97,782,3008640,3847,-672860
2017-09-20,8.35 ( 0.85 %),1053,5344630,5075.62,1482,5747910,3878,-403280
2017-09-19,8.28 ( -0.6 %),1117,2304440,2063.06,586,2941940,5020,-637500
2017-09-18,8.33 ( -0.48 %),827,2350050,2841.66,692,3532450,5105,-1182400
2017-09-15,8.37 ( 0.24 %),724,2887860,3988.76,674,3068020,4552,-180160
2017-09-14,8.35 ( 0.48 %),846,3611270,4268.64,958,4684420,4890,-1073150
2017-09-13,8.31 ( 0.61 %),1474,5698540,3866.04,882,5359880,6077,338660
2017-09-12,8.26 ( -0.72 %),1455,3581130,2461.26,658,3414390,5189,166740
2017-09-11,8.32 ( -1.07 %),790,1889340,2391.57,540,2485840,4603,-596500
2017-09-08,8.41 ( -0.12 %),836,3852830,4608.65,670,3914910,5843,-62080
2017-09-07,8.42 ( 1.32 %),795,4647620,5846.06,586,2421100,4132,2226520
2017-09-06,8.31 ( -0.95 %),994,3169030,3188.16,564,4223900,7489,-1054870
2017-09-05,8.39 ( -0.36 %),719,1918330,2668.05,501,2404260,4799,-485930
2017-09-01,8.42 ( -0.82 %),1004,2296310,2287.16,474,2325950,4907,-29640
2017-08-31,8.49 ( -1.16 %),681,1922250,2822.69,566,2647550,4678,-725300
2017-08-30,8.59 ( 0 %),864,3355170,3883.3,617,4050810,6565,-695640
2017-08-29,8.59 ( 2.26 %),1131,6428790,5684.16,1121,4940540,4407,1488250
2017-08-28,8.4 ( -0.94 %),1139,3956890,3474,608,3774440,6208,182450
2017-08-25,8.48 ( 0.36 %),837,2785520,3327.98,631,2916150,4621,-130630
2017-08-24,8.45 ( 1.2 %),1216,4618460,3798.08,674,3759830,5578,858630
2017-08-23,8.35 ( -2 %),1014,1982830,1955.45,522,3196960,6124,-1214130
2017-08-22,8.52 ( -0.93 %),644,2819650,4378.34,538,2729030,5073,90620
2017-08-21,8.6 ( 2.38 %),1148,4001550,3485.67,775,4058070,5236,-56520
2017-08-18,8.4 ( 0 %),1603,6203690,3870.05,736,4355710,5918,1847980
2017-08-17,8.4 ( -5.51 %),2209,7476060,3384.36,1019,8785600,8622,-1309540
2017-08-16,8.89 ( -0.11 %),773,3330550,4308.6,648,4347620,6709,-1017070
2017-08-15,8.9 ( 0 %),660,3275110,4962.29,521,3030470,5817,244640
2017-08-14,8.9 ( 1.14 %),1502,4574280,3045.46,636,3932620,6183,641660
2017-08-11,8.8 ( -1.68 %),1957,5298050,2707.23,742,6057990,8164,-759940
2017-08-10,8.95 ( -0.44 %),1306,5149600,3943.03,700,5695360,8136,-545760
2017-08-09,8.99 ( -0.99 %),2310,8485020,3673.17,949,8247940,8691,237080
2017-08-08,9.08 ( -0.77 %),1313,4577970,3486.65,767,6286110,8196,-1708140
2017-08-07,9.15 ( 0.22 %),1169,4233870,3621.79,779,5124030,6578,-890160
2017-08-04,9.13 ( -0.98 %),1257,4982950,3964.16,793,5807370,7323,-824420
2017-08-03,9.22 ( -0.32 %),1448,7206470,4976.84,807,7424520,9200,-218050
2017-08-02,9.25 ( -2.12 %),1341,6032240,4498.31,1244,9192240,7389,-3160000
2017-08-01,9.45 ( 0.43 %),1774,10812780,6095.14,2701,19156900,7093,-8344120
2017-07-31,9.41 ( 2.28 %),1133,10434380,9209.51,2606,14044620,5389,-3610240
2017-07-28,9.2 ( 1.43 %),841,4470720,5315.96,1278,5831580,4563,-1360860
2017-07-27,9.07 ( -0.33 %),686,3714470,5414.68,740,4990900,6744,-1276430
2017-07-26,9.1 ( 1.34 %),0,0,0,0,0,0,0
2017-07-25,8.98 ( -0.11 %),1110,3313240,2984.9,511,3600780,7047,-287540
2017-07-24,8.99 ( -0.22 %),1007,4457800,4426.81,656,4081240,6221,376560
2017-07-21,9.01 ( -0.99 %),809,3939430,4869.51,549,4695520,8553,-756090
2017-07-20,9.1 ( 0.22 %),986,4822550,4891.02,711,4857820,6832,-35270
2017-07-19,9.08 ( 0.11 %),923,4803210,5203.91,609,4049780,6650,753430
2017-07-18,9.07 ( -1.63 %),1470,7194490,4894.21,822,5903840,7182,1290650
2017-07-17,9.22 ( -1.91 %),1315,5608630,4265.12,847,5873400,6934,-264770
2017-07-14,9.4 ( -1.67 %),1561,7352240,4709.96,1870,13213850,7066,-5861610
2017-07-13,9.56 ( 3.35 %),2148,15533410,7231.57,3170,18311610,5777,-2778200
2017-07-12,9.25 ( 0.54 %),1541,9398440,6098.92,2145,12618480,5883,-3220040
2017-07-11,9.2 ( 4.55 %),1054,8919890,8462.89,961,9063740,9432,-143850
2017-07-10,8.8 ( -2.22 %),2013,6193790,3076.9,954,6233510,6534,-39720
2017-07-07,9 ( -1.1 %),1244,4872910,3917.13,696,5119900,7356,-246990
2017-07-06,9.1 ( -0.87 %),1037,4946110,4769.63,759,4536410,5977,409700
2017-07-05,9.18 ( -0.43 %),1134,4865590,4290.64,617,4812260,7799,53330
2017-07-04,9.22 ( 1.32 %),1752,6358350,3629.2,778,5757600,7401,600750
2017-07-03,9.1 ( -4.01 %),3079,10296830,3344.21,1219,11327850,9293,-1031020
2017-06-30,9.48 ( -1.25 %),1046,8041590,7687.94,1679,11682010,6958,-3640420
2017-06-29,9.6 ( 1.16 %),796,5142150,6459.99,1280,6637840,5186,-1495690
2017-06-28,9.49 ( 1.5 %),1130,5069170,4485.99,823,4372990,5313,696180
2017-06-27,9.35 ( -3.61 %),1684,8976540,5330.49,1489,11244350,7552,-2267810
2017-06-26,9.7 ( -0.82 %),1397,8307510,5946.68,1616,9722080,6016,-1414570
2017-06-23,9.78 ( 2.3 %),1625,11113470,6839.06,2365,12668040,5356,-1554570
2017-06-22,9.56 ( 4.48 %),1615,11269280,6977.88,2465,12868680,5221,-1599400
2017-06-21,9.15 ( 0.99 %),1495,10846640,7255.28,1375,11039270,8029,-192630
2017-06-20,9.06 ( 0.11 %),1058,6585550,6224.53,1005,5735230,5707,850320
2017-06-19,9.05 ( -1.31 %),1363,8084370,5931.31,1514,10054060,6641,-1969690
2017-06-16,9.17 ( 1.33 %),1945,31988030,16446.29,1616,18379950,11374,13608080
2017-06-15,9.05 ( -0.98 %),2153,17448390,8104.22,2409,18058780,7496,-610390
2017-06-14,9.14 ( 6.9 %),2512,21346240,8497.71,2657,14548910,5476,6797330
2017-06-13,8.55 ( 2.27 %),942,5664760,6013.55,1407,5610610,3988,54150
2017-06-12,8.36 ( 1.7 %),687,2653170,3861.97,592,2366680,3998,286490
2017-06-09,8.22 ( 0 %),1557,7021870,4509.87,889,6074560,6833,947310
2017-06-08,8.22 ( -4.08 %),1584,6116110,3861.18,909,6126870,6740,-10760
2017-06-07,8.57 ( -0.12 %),671,3952980,5891.18,822,4807240,5848,-854260
2017-06-06,8.58 ( 3.37 %),1601,8717080,5444.77,967,4505990,4660,4211090
2017-06-05,8.3 ( -6.95 %),2854,16651460,5834.43,1741,17157310,9855,-505850
2017-06-02,8.92 ( 1.36 %),570,3334330,5849.7,719,3482630,4844,-148300
2017-06-01,8.8 ( 1.15 %),804,5024690,6249.61,521,4252680,8163,772010
2017-05-31,8.7 ( -1.36 %),826,5250330,6356.33,597,4908520,8222,341810
2017-05-30,8.82 ( -2.86 %),979,6800910,6946.79,1050,7864980,7490,-1064070
2017-05-29,9.08 ( 0.89 %),854,8617690,10090.97,1639,10416410,6355,-1798720
2017-05-26,9 ( 2.27 %),921,8088570,8782.38,875,5864420,6702,2224150
2017-05-25,8.8 ( -0.34 %),1153,6200220,5377.47,828,7043290,8506,-843070
2017-05-24,8.83 ( -0.79 %),917,4704470,5130.28,1051,7782940,7405,-3078470
2017-05-23,8.9 ( -1.66 %),1045,6753650,6462.82,1101,8180990,7431,-1427340
2017-05-22,9.05 ( 0.56 %),1192,8318390,6978.52,2156,15416760,7151,-7098370
2017-05-19,9 ( 2.27 %),798,5446310,6824.95,957,5975790,6244,-529480
2017-05-18,8.8 ( -1.79 %),969,5708460,5891.08,963,7178640,7454,-1470180
2017-05-17,8.96 ( 0.22 %),772,5142930,6661.83,1145,7132830,6230,-1989900
2017-05-16,8.94 ( 1.48 %),1056,10415460,9863.12,2196,13385170,6095,-2969710
2017-05-15,8.81 ( 1.73 %),992,7127550,7185.03,1218,8107070,6656,-979520
2017-05-12,8.66 ( 1.64 %),1030,7258720,7047.3,1158,5769550,4982,1489170
2017-05-11,8.52 ( -1.96 %),1406,6213120,4419,997,5925330,5943,287790
2017-05-10,8.69 ( -2.36 %),1317,8743880,6639.24,1204,9849930,8181,-1106050
2017-05-09,8.9 ( 4.71 %),2086,15581390,7469.51,1637,10864930,6637,4716460
2017-05-08,8.5 ( -6.59 %),3328,22638500,6802.43,2219,23621690,10645,-983190
2017-05-05,9.1 ( -3.4 %),1909,13628740,7139.2,2285,17966180,7863,-4337440
2017-05-04,9.42 ( 4.67 %),2018,17288050,8566.92,2952,20278100,6869,-2990050
2017-05-03,9 ( 4.05 %),1088,7671140,7050.68,1053,5702030,5415,1969110
2017-04-28,8.65 ( -0.69 %),1038,6744750,6497.83,880,6434650,7312,310100
2017-04-27,8.71 ( -0.91 %),885,4321810,4883.4,1193,6155120,5159,-1833310
2017-04-26,8.79 ( 3.05 %),827,6250250,7557.74,1164,6606220,5675,-355970
2017-04-25,8.53 ( -1.73 %),1149,5044250,4390.12,1218,6589290,5410,-1545040
2017-04-24,8.68 ( 4.7 %),1704,11650840,6837.35,1992,10838980,5441,811860
2017-04-21,8.29 ( 1.59 %),1065,7117870,6683.45,1115,6923710,6210,194160
2017-04-20,8.16 ( 1.12 %),972,5210380,5360.47,820,4715930,5751,494450
2017-04-19,8.07 ( 0.25 %),1441,8110600,5628.45,911,7767370,8526,343230
2017-04-18,8.05 ( -0.86 %),1941,9981470,5142.44,1238,8459350,6833,1522120
2017-04-17,8.12 ( -0.98 %),1449,8372700,5778.26,970,8381830,8641,-9130
2017-04-14,8.2 ( -4.65 %),2112,11617750,5500.83,1173,12604070,10745,-986320
2017-04-13,8.6 ( 0 %),1492,11019760,7385.9,1143,8699700,7611,2320060
2017-04-12,8.6 ( -5.91 %),3179,17972420,5653.48,1796,19209970,10696,-1237550
2017-04-11,9.14 ( -0.54 %),1323,8654740,6541.75,1243,11236310,9040,-2581570
2017-04-10,9.19 ( -0.65 %),1011,5612950,5551.88,986,6407270,6498,-794320
2017-04-07,9.25 ( -1.07 %),1150,5080960,4418.23,815,5089270,6245,-8310
2017-04-05,9.35 ( -2.6 %),1343,7579030,5643.36,1888,12211760,6468,-4632730
2017-04-04,9.6 ( 6.08 %),1722,11816910,6862.32,1753,9240350,5271,2576560
2017-04-03,9.05 ( -1.09 %),1343,6730150,5011.28,878,6355450,7239,374700
2017-03-31,9.15 ( 0.99 %),1860,9727040,5229.59,1060,7939910,7490,1787130
2017-03-30,9.06 ( -1.52 %),3114,16662370,5350.79,1807,12621080,6985,4041290
2017-03-29,9.2 ( -4.66 %),4325,23732940,5487.38,2333,22632770,9701,1100170
2017-03-28,9.65 ( -2.53 %),3250,21598650,6645.74,1784,21970400,12315,-371750
2017-03-27,9.9 ( 0 %),3360,20762750,6179.39,2218,20668710,9319,94040
2017-03-24,9.9 ( -1.98 %),3206,18957030,5912.99,2652,22682530,8553,-3725500
2017-03-23,10.1 ( 4.34 %),3384,18142760,5361.34,2184,18548810,8493,-406050
2017-03-22,9.68 ( 3.86 %),3199,22446860,7016.84,2726,19258400,7065,3188460
2017-03-21,9.32 ( 2.31 %),1969,14600680,7415.28,2041,12972660,6356,1628020
2017-03-20,9.11 ( 0.11 %),1529,7879360,5153.28,1384,10285180,7431,-2405820
2017-03-17,9.1 ( 2.59 %),2427,22267470,9174.89,1979,19168250,9686,3099220
2017-03-16,8.87 ( 7 %),2991,32868800,10989.23,3436,28294300,8235,4574500
2017-03-15,8.29 ( 0.73 %),1113,9081710,8159.67,1398,11605880,8302,-2524170
2017-03-14,8.23 ( 0.24 %),1058,5839270,5519.16,1096,6806220,6210,-966950
2017-03-13,8.21 ( -1.56 %),1249,6742160,5398.05,1014,8052710,7942,-1310550
2017-03-10,8.34 ( 0.48 %),1450,9601000,6621.38,2111,13553910,6421,-3952910
2017-03-09,8.3 ( 3.23 %),2107,16585090,7871.42,3094,21628300,6990,-5043210
2017-03-08,8.04 ( 0.37 %),1498,9604310,6411.42,1678,11535050,6874,-1930740
2017-03-07,8.01 ( -0.74 %),1289,5944310,4611.57,1165,8864020,7609,-2919710
2017-03-06,8.07 ( 0.25 %),1187,7934510,6684.51,1655,12410130,7499,-4475620
2017-03-03,8.05 ( 1.77 %),1474,10680600,7246,1448,8913470,6156,1767130
2017-03-02,7.91 ( -2.94 %),1322,8648610,6542.07,1767,12005240,6794,-3356630
2017-03-01,8.15 ( -0.37 %),1728,12971780,7506.82,2382,17323040,7272,-4351260
2017-02-28,8.18 ( 0.86 %),1757,10822450,6159.62,2618,15363570,5868,-4541120
2017-02-27,8.11 ( 6.99 %),2519,24634810,9779.6,2678,18336020,6847,6298790
2017-02-24,7.58 ( -6.88 %),3450,19017860,5512.42,2853,24399320,8552,-5381460
2017-02-23,8.14 ( 0.25 %),2562,15738140,6142.91,2409,17606940,7309,-1868800
2017-02-22,8.12 ( -0.98 %),3225,19858150,6157.57,2932,20153700,6874,-295550
2017-02-21,8.2 ( 5.94 %),3575,19313680,5402.43,2293,15833900,6905,3479780
2017-02-20,7.74 ( 6.91 %),2791,23134990,8289.14,2507,19437220,7753,3697770
2017-02-17,7.24 ( 2.7 %),2559,18995700,7423.09,2161,15620260,7228,3375440
2017-02-16,7.05 ( 3.68 %),3649,33813060,9266.39,2965,27351280,9225,6461780
2017-02-15,6.8 ( 4.29 %),2263,18753520,8287.02,2448,16839430,6879,1914090
2017-02-14,6.52 ( 4.49 %),2623,16779720,6397.15,2463,17059480,6926,-279760
2017-02-13,6.24 ( 2.97 %),1752,15625890,8918.89,2053,14954640,7284,671250
2017-02-10,6.06 ( 1.85 %),1822,12612190,6922.17,1640,12930850,7885,-318660
2017-02-09,5.95 ( -3.41 %),1501,11940790,7955.22,1646,14988710,9106,-3047920
2017-02-08,6.16 ( 1.15 %),1365,9734950,7131.83,1954,14399530,7369,-4664580
2017-02-07,6.09 ( 2.87 %),1356,9259750,6828.72,2079,13840560,6657,-4580810
2017-02-06,5.92 ( 1.37 %),1064,6738860,6333.52,1162,6745540,5805,-6680
2017-02-03,5.84 ( -2.5 %),1208,6755640,5592.42,1452,10011950,6895,-3256310
2017-02-02,5.99 ( 6.96 %),1241,14765000,11897.66,2054,13230520,6441,1534480
2017-01-25,5.6 ( -3.28 %),1117,8227460,7365.68,1602,11724520,7319,-3497060
2017-01-24,5.79 ( 6.83 %),859,15072390,17546.44,2059,11641290,5654,3431100
2017-01-23,5.42 ( 6.48 %),698,7334150,10507.38,1483,7328260,4942,5890
2017-01-20,5.09 ( 2.41 %),757,5287480,6984.78,603,3544150,5878,1743330
2017-01-19,4.97 ( 0.2 %),669,4037800,6035.58,520,3497230,6725,540570
2017-01-18,4.96 ( -1.98 %),1116,5276610,4728.15,521,4253800,8165,1022810
2017-01-17,5.06 ( -0.39 %),751,3926360,5228.18,528,3256480,6168,669880
2017-01-16,5.08 ( 0 %),803,3634510,4526.16,667,3065920,4597,568590
2017-01-13,5.08 ( -2.5 %),1084,5898940,5441.83,1281,4695080,3665,1203860
2017-01-12,5.21 ( 0.58 %),3305,19871570,6012.58,906,17511960,19329,2359610
2017-01-11,5.18 ( -0.77 %),1161,7314690,6300.34,700,7868620,11241,-553930
2017-01-10,5.22 ( -0.19 %),1426,9909210,6948.96,627,5483360,8745,4425850
2017-01-09,5.23 ( -2.43 %),1735,7470770,4305.92,605,7824230,12933,-353460
2017-01-06,5.36 ( -0.74 %),1132,5012870,4428.33,527,5405250,10257,-392380
2017-01-05,5.4 ( -1.82 %),1207,5608870,4646.95,585,5894630,10076,-285760
2017-01-04,5.5 ( 2.8 %),1385,11512150,8312.02,1154,8098380,7018,3413770
2017-01-03,5.35 ( 0 %),689,2888160,4191.81,402,3981770,9905,-1093610
2016-12-30,5.35 ( -0.19 %),965,5226470,5416.03,612,5863300,9581,-636830
2016-12-29,5.36 ( 0 %),734,2820790,3843.04,331,3628320,10962,-807530
2016-12-28,5.36 ( 0.19 %),911,4872080,5348.06,612,4728260,7726,143820
2016-12-27,5.35 ( -2.01 %),840,2784450,3314.82,335,3088930,9221,-304480
2016-12-26,5.46 ( -0.91 %),580,2116290,3648.78,330,2467860,7478,-351570
2016-12-23,5.51 ( -0.36 %),707,3852430,5448.98,315,2460370,7811,1392060
2016-12-22,5.53 ( -1.43 %),814,4220250,5184.58,478,5252980,10989,-1032730
2016-12-21,5.61 ( -0.53 %),716,3200320,4469.72,426,3858780,9058,-658460
2016-12-20,5.64 ( -4.41 %),823,3188350,3874.06,604,3927110,6502,-738760
2016-12-19,5.9 ( 2.08 %),713,6273210,8798.33,924,7026330,7604,-753120
2016-12-16,5.78 ( 0.87 %),830,8440320,10169.06,728,6432690,8836,2007630
2016-12-15,5.73 ( -0.35 %),740,5090800,6879.46,898,7561890,8421,-2471090
2016-12-14,5.75 ( 6.48 %),1199,8784090,7326.18,968,8785620,9076,-1530
2016-12-13,5.4 ( -3.23 %),759,3924920,5171.17,556,4685730,8428,-760810
2016-12-12,5.58 ( 0.9 %),736,4795810,6516.05,880,5510200,6262,-714390
2016-12-09,5.53 ( -0.54 %),599,2005960,3348.85,402,2420240,6020,-414280
2016-12-08,5.56 ( 0.72 %),687,3221970,4689.91,558,2674270,4793,547700
2016-12-07,5.52 ( 0 %),847,3658050,4318.83,421,3217850,7643,440200
2016-12-06,5.52 ( -2.3 %),778,3024250,3887.21,511,4728040,9253,-1703790
2016-12-05,5.65 ( 0 %),687,3225740,4695.4,605,3509460,5801,-283720
2016-12-02,5.65 ( -4.24 %),1362,6766480,4968.05,737,6036530,8191,729950
2016-12-01,5.9 ( -0.17 %),844,3016950,3574.59,594,3944700,6641,-927750
2016-11-30,5.91 ( -4.83 %),1393,8096170,5812.04,1019,7653000,7510,443170
2016-11-29,6.21 ( -0.16 %),851,5936170,6975.52,895,5727840,6400,208330
2016-11-28,6.22 ( -1.74 %),1036,7528660,7267.05,967,6587080,6812,941580
2016-11-25,6.33 ( -1.86 %),1364,8221200,6027.27,1352,8903250,6585,-682050
2016-11-24,6.45 ( 4.03 %),1698,15916610,9373.74,2149,16232630,7554,-316020
2016-11-23,6.2 ( -0.48 %),1151,8712680,7569.66,1657,13688230,8261,-4975550
2016-11-22,6.23 ( 3.15 %),1518,10463780,6893.14,2003,11659900,5821,-1196120
2016-11-21,6.04 ( 5.96 %),1245,11541370,9270.18,1751,9598760,5482,1942610
2016-11-18,5.7 ( -1.72 %),982,7630110,7769.97,1306,8946530,6850,-1316420
2016-11-17,5.8 ( 1.22 %),2170,13015650,5998,2613,21021260,8045,-8005610
2016-11-16,5.73 ( 6.9 %),1099,12439120,11318.58,971,3901870,4018,8537250
2016-11-15,5.36 ( 0 %),747,6112990,8183.39,718,4773320,6648,1339670
2016-11-14,5.36 ( -2.55 %),829,4410330,5320.06,1087,6504830,5984,-2094500
2016-11-11,5.5 ( 3 %),1351,15358120,11367.96,2226,9806540,4405,5551580
2016-11-10,5.34 ( 4.09 %),837,11879510,14192.96,1288,6039950,4689,5839560
2016-11-09,5.13 ( -0.58 %),1030,4854430,4713.04,624,4937540,7913,-83110
2016-11-08,5.16 ( 0.58 %),363,1622190,4468.84,533,2628760,4932,-1006570
2016-11-07,5.13 ( 0.2 %),482,2636440,5469.79,498,2652980,5327,-16540
2016-11-04,5.12 ( 0 %),491,2550630,5194.77,368,2606140,7082,-55510
2016-11-03,5.12 ( -0.97 %),625,2775580,4440.93,421,2453080,5827,322500
2016-11-02,5.17 ( 1.37 %),1049,4883990,4655.85,752,5159150,6861,-275160
2016-11-01,5.1 ( -1.92 %),1021,3822990,3744.36,412,2928380,7108,894610
2016-10-31,5.2 ( -3.17 %),763,2763740,3622.2,521,3591780,6894,-828040
2016-10-28,5.37 ( 2.48 %),738,4314280,5845.91,1192,6040410,5067,-1726130
2016-10-27,5.24 ( -0.19 %),464,2520050,5431.14,376,2132390,5671,387660
2016-10-26,5.25 ( -0.94 %),621,2784630,4484.11,408,2582250,6329,202380
2016-10-25,5.3 ( 0.57 %),726,3901120,5373.44,451,2997400,6646,903720
2016-10-24,5.27 ( -0.57 %),841,5237420,6227.61,672,4387020,6528,850400
2016-10-21,5.3 ( -0.93 %),651,3731500,5731.95,496,2913390,5874,818110
2016-10-20,5.35 ( 0 %),820,5465200,6664.88,596,4549090,7633,916110
2016-10-19,5.35 ( -0.74 %),1133,8077860,7129.62,744,5916650,7952,2161210
2016-10-18,5.39 ( -4.26 %),1215,5693420,4685.94,960,7162430,7461,-1469010
2016-10-17,5.63 ( 0 %),1708,10275270,6015.97,1825,11955530,6551,-1680260
2016-10-14,5.63 ( 6.83 %),1357,16085240,11853.53,1574,6951280,4416,9133960
2016-10-13,5.27 ( 2.13 %),896,4269420,4764.98,1148,4753260,4140,-483840
2016-10-12,5.16 ( 1.18 %),997,5156170,5171.69,1186,5421760,4571,-265590
2016-10-11,5.1 ( -0.58 %),983,4836540,4920.18,521,3616910,6942,1219630
2016-10-10,5.13 ( 0 %),636,2862090,4500.14,439,2757010,6280,105080
2016-10-07,5.13 ( -0.19 %),554,3292200,5942.6,460,2189550,4760,1102650
2016-10-06,5.14 ( 0.59 %),738,4958460,6718.78,662,3544530,5354,1413930
2016-10-05,5.11 ( -0.78 %),682,2534450,3716.2,551,3007210,5458,-472760
2016-10-04,5.15 ( -1.15 %),563,2309290,4101.76,541,2287970,4229,21320
2016-10-03,5.21 ( -0.76 %),667,4279840,6416.55,607,3230580,5322,1049260
2016-09-30,5.25 ( 0 %),818,4975110,6082.04,562,3711430,6604,1263680
2016-09-29,5.25 ( -1.13 %),675,3512490,5203.69,854,4924590,5766,-1412100
2016-09-28,5.31 ( 0.57 %),974,6782070,6963.11,982,6909900,7037,-127830
2016-09-27,5.28 ( 2.52 %),1435,8015560,5585.76,1106,9315520,8423,-1299960
2016-09-26,5.15 ( 0.39 %),631,3134440,4967.42,546,2683980,4916,450460
2016-09-23,5.13 ( -0.19 %),741,3692390,4982.98,541,2972540,5495,719850
2016-09-22,5.14 ( 0.19 %),616,2633440,4275.06,651,3392320,5211,-758880
2016-09-21,5.13 ( 1.18 %),796,3599030,4521.39,772,3500800,4535,98230
2016-09-20,5.07 ( 1.2 %),778,4059430,5217.78,651,4142510,6363,-83080
2016-09-19,5.01 ( 1.62 %),1174,5499240,4684.19,822,5153520,6269,345720
2016-09-16,4.93 ( -6.98 %),1442,10056130,6973.74,932,14302600,15346,-4246470
2016-09-15,5.3 ( 1.92 %),1068,5502390,5152.05,1127,5751430,5103,-249040
2016-09-14,5.2 ( 0 %),1324,5641620,4261.04,643,5084220,7907,557400
2016-09-13,5.2 ( -3.7 %),812,3103740,3822.34,518,4078080,7873,-974340
2016-09-12,5.4 ( -3.57 %),814,3496420,4295.36,541,4216620,7794,-720200
2016-09-09,5.6 ( -1.75 %),1120,6054360,5405.68,905,6634620,7331,-580260
2016-09-08,5.7 ( 0 %),1582,6225430,3935.16,887,6018620,6785,206810
2016-09-07,5.7 ( -1.72 %),1252,5046290,4030.58,750,4494060,5992,552230
2016-09-06,5.8 ( 3.57 %),1476,5553870,3762.78,671,3754900,5596,1798970
2016-09-05,5.6 ( -6.67 %),2073,7345910,3543.61,1342,10814140,8058,-3468230
2016-09-01,6 ( -4.76 %),1668,7214060,4324.98,1197,8319980,6951,-1105920
2016-08-31,6.3 ( 0 %),1132,5563860,4915.07,997,5797560,5815,-233700
2016-08-30,6.3 ( 0 %),1042,5659050,5430.95,1072,5744910,5359,-85860
2016-08-29,6.3 ( -1.56 %),1554,12480670,8031.32,2184,14752660,6755,-2271990
2016-08-26,6.4 ( 6.67 %),1434,12694390,8852.43,1178,6780040,5756,5914350
2016-08-25,6 ( -3.23 %),1624,8468060,5214.32,1419,9984240,7036,-1516180
2016-08-24,6.2 ( -1.59 %),1214,10369050,8541.23,1256,7491940,5965,2877110
2016-08-23,6.3 ( 0 %),1106,5725620,5176.87,1303,6904090,5299,-1178470
2016-08-22,6.3 ( -1.56 %),2843,20842750,7331.25,3893,26770980,6877,-5928230
2016-08-19,6.4 ( 6.67 %),1444,10417560,7214.38,666,2814510,4226,7603050
2016-08-18,6 ( -6.25 %),1708,7668810,4489.94,1994,13010000,6525,-5341190
2016-08-17,6.4 ( -5.88 %),987,4508270,4567.65,2344,16262160,6938,-11753890
2016-08-16,6.8 ( -1.45 %),1607,8767880,5456.05,2909,15818190,5438,-7050310
2016-08-15,6.9 ( 6.15 %),2432,18126680,7453.4,2232,13042080,5843,5084600
2016-08-12,6.5 ( 3.17 %),1762,10824170,6143.12,2376,13653190,5746,-2829020
2016-08-11,6.3 ( 6.78 %),2408,13651990,5669.43,1493,8418550,5639,5233440
2016-08-10,5.9 ( 5.36 %),1793,10476110,5842.78,979,5292060,5406,5184050
2016-08-09,5.6 ( 5.66 %),1425,9800800,6877.75,752,3404530,4527,6396270
2016-08-08,5.3 ( 3.92 %),1503,8769790,5834.86,1213,5937940,4895,2831850
2016-08-05,5.1 ( -5.56 %),2048,8359140,4081.61,1508,11617040,7704,-3257900
2016-08-04,5.4 ( -6.9 %),1783,7129580,3998.64,1492,12165270,8154,-5035690
2016-08-03,5.8 ( -4.92 %),1123,4584740,4082.58,773,5972450,7726,-1387710
2016-08-02,6.1 ( -3.17 %),1544,6404370,4147.91,951,7984800,8396,-1580430
2016-08-01,6.3 ( -1.56 %),830,2766620,3333.28,657,3924860,5974,-1158240
2016-07-29,6.4 ( 0 %),1107,3749240,3386.85,683,4597790,6732,-848550
2016-07-28,6.4 ( -3.03 %),1262,4509410,3573.23,766,5424590,7082,-915180
2016-07-27,6.6 ( -1.49 %),694,2518290,3628.66,710,4521410,6368,-2003120
2016-07-26,6.7 ( -1.47 %),771,2835010,3677.06,1267,7107290,5610,-4272280
2016-07-25,6.8 ( 6.25 %),1584,8147200,5143.43,918,4303070,4687,3844130
2016-07-22,6.4 ( -3.03 %),1651,5750780,3483.21,1012,7471770,7383,-1720990
2016-07-21,6.6 ( -1.49 %),868,2589630,2983.44,663,3807580,5743,-1217950
2016-07-20,6.7 ( -1.47 %),1061,4299080,4051.91,790,5319520,6734,-1020440
2016-07-19,6.8 ( -1.45 %),810,3905360,4821.43,1047,5507560,5260,-1602200
2016-07-18,6.9 ( 2.99 %),1127,6177170,5481.07,792,4099620,5176,2077550
2016-07-15,6.7 ( 0 %),1236,4567820,3695.65,712,5287070,7426,-719250
2016-07-14,6.7 ( -2.9 %),1096,4254970,3882.27,899,6913050,7690,-2658080
2016-07-13,6.9 ( 1.47 %),1200,5473030,4560.86,819,5234730,6392,238300
2016-07-12,6.8 ( 0 %),1411,5474870,3880.13,633,4063340,6419,1411530
2016-07-11,6.8 ( -4.23 %),2094,8284470,3956.29,1059,8372170,7906,-87700
2016-07-08,7.1 ( -1.39 %),1194,4399450,3684.63,811,4672210,5761,-272760
2016-07-07,7.2 ( -1.37 %),1099,4274610,3889.55,977,6695550,6853,-2420940
2016-07-06,7.3 ( 0 %),905,3677140,4063.14,731,4460670,6102,-783530
2016-07-05,7.3 ( -2.67 %),768,3462140,4507.99,944,5448280,5771,-1986140
2016-07-04,7.5 ( 1.35 %),794,4445490,5598.85,916,5434320,5933,-988830
2016-07-01,7.4 ( 1.37 %),673,4133300,6141.6,882,4616920,5235,-483620
2016-06-30,7.3 ( 0 %),782,4368470,5586.28,1074,5374690,5004,-1006220
2016-06-29,7.3 ( 2.82 %),1107,5697810,5147.07,807,4280900,5305,1416910
2016-06-28,7.1 ( 0 %),1125,4525400,4022.58,552,3705730,6713,819670
2016-06-27,7.1 ( -4.05 %),1406,5852160,4162.28,1014,6556590,6466,-704430
2016-06-24,7.4 ( -3.9 %),2027,8364610,4126.6,1505,10616780,7054,-2252170
2016-06-23,7.7 ( 1.32 %),1063,5398950,5078.97,920,5105610,5550,293340
2016-06-22,7.6 ( 0 %),1138,4054900,3563.18,838,5369190,6407,-1314290
2016-06-21,7.6 ( 0 %),910,3699300,4065.16,887,5605250,6319,-1905950
2016-06-20,7.6 ( 0 %),931,4152820,4460.6,775,4296310,5544,-143490
2016-06-17,7.6 ( -2.56 %),1420,7480360,5267.86,1020,8214560,8053,-734200
2016-06-16,7.8 ( -1.27 %),958,3994970,4170.11,1244,6537050,5255,-2542080
2016-06-15,7.9 ( 1.28 %),1284,5600140,4361.48,933,6766850,7253,-1166710
2016-06-14,7.8 ( 1.3 %),1348,7892200,5854.75,839,5545930,6610,2346270
2016-06-13,7.7 ( -2.53 %),1513,6318530,4176.16,966,7547170,7813,-1228640
2016-06-10,7.9 ( -2.47 %),1156,6084230,5263.17,1260,8175500,6488,-2091270
2016-06-09,8.1 ( 0 %),920,5524320,6004.7,1511,7907460,5233,-2383140
2016-06-08,8.1 ( 1.25 %),1186,7610250,6416.74,1944,9377910,4824,-1767660
2016-06-07,8 ( 0 %),797,4545500,5703.26,1225,6381960,5210,-1836460
2016-06-06,8 ( -1.23 %),904,5906880,6534.16,1683,9243270,5492,-3336390
2016-06-03,8.1 ( 0 %),1036,6667530,6435.84,1894,10214430,5393,-3546900
2016-06-02,8.1 ( 2.53 %),1797,11228140,6248.27,2220,11611530,5230,-383390
2016-06-01,7.9 ( 1.28 %),1540,7315030,4750.02,1188,6816770,5738,498260
2016-05-31,7.8 ( -2.5 %),1027,3672960,3576.4,1276,6605600,5177,-2932640
2016-05-30,8 ( 1.27 %),586,2426230,4140.32,1098,4136560,3767,-1710330
2016-05-27,7.9 ( 2.6 %),1527,7488570,4904.11,1316,5624420,4274,1864150
2016-05-26,7.7 ( -3.75 %),1701,6225500,3659.91,1289,8409170,6524,-2183670
2016-05-25,8 ( 0 %),732,3067630,4190.75,1145,4848140,4234,-1780510
2016-05-24,8 ( -1.23 %),920,3521260,3827.46,1267,6046130,4772,-2524870
2016-05-23,8.1 ( 1.25 %),1097,5622790,5125.61,1272,5452400,4286,170390
2016-05-20,8 ( -3.61 %),1748,7364880,4213.32,2148,11886600,5534,-4521720
2016-05-19,8.3 ( -1.19 %),3138,15931310,5076.9,5308,28547060,5378,-12615750
2016-05-18,8.4 ( 6.33 %),2204,13120500,5953.04,556,1737480,3125,11383020
2016-05-17,7.9 ( 6.76 %),2284,18277950,8002.61,473,1119020,2366,17158930
2016-05-16,7.4 ( 0 %),798,2976270,3729.66,720,3458720,4804,-482450
2016-05-13,7.4 ( -1.33 %),897,3432020,3826.11,811,4491760,5539,-1059740
2016-05-12,7.5 ( 0 %),587,2334330,3976.71,811,3488040,4301,-1153710
2016-05-11,7.5 ( 1.35 %),755,2960550,3921.26,784,2879530,3673,81020
2016-05-10,7.4 ( 0 %),937,3394920,3623.18,750,3232240,4310,162680
2016-05-09,7.4 ( -1.33 %),815,2981200,3657.91,876,4111670,4694,-1130470
2016-05-06,7.5 ( 1.35 %),1186,5188720,4374.97,847,4329050,5111,859670
2016-05-05,7.4 ( -1.33 %),1639,7414480,4523.78,974,5247210,5387,2167270
2016-05-04,7.5 ( -6.25 %),1737,8284090,4769.19,2394,14938930,6240,-6654840
2016-04-29,8 ( 1.27 %),1315,8526670,6484.16,2295,11489740,5006,-2963070
2016-04-28,7.9 ( -1.25 %),1277,8609890,6742.28,2467,14362610,5822,-5752720
2016-04-27,8 ( 1.27 %),2215,14896420,6725.25,3573,19602480,5486,-4706060
2016-04-26,7.9 ( 6.76 %),3916,16401860,4188.42,2763,14472180,5238,1929680
2016-04-25,7.4 ( 5.71 %),2726,19181020,7036.32,1850,10509220,5681,8671800
2016-04-22,7 ( 2.94 %),1317,5812200,4413.21,1256,6376210,5077,-564010
2016-04-21,6.8 ( 1.49 %),1153,4910890,4259.23,1033,5331260,5161,-420370
2016-04-20,6.7 ( 0 %),1653,6306520,3815.2,1160,7067700,6093,-761180
2016-04-19,6.7 ( -2.9 %),1861,7928420,4260.3,1365,8085930,5924,-157510
2016-04-15,6.9 ( -2.82 %),1536,5500850,3581.28,1896,11236340,5926,-5735490
2016-04-14,7.1 ( 5.97 %),2963,13663090,4611.24,1240,6804620,5488,6858470
2016-04-13,6.7 ( -2.9 %),3720,18027300,4846.05,2551,14853260,5823,3174040
2016-04-12,6.9 ( -6.76 %),2780,9767990,3513.67,3148,24964340,7930,-15196350
2016-04-11,7.4 ( -2.63 %),1717,6189960,3605.1,1271,8696320,6842,-2506360
2016-04-08,7.6 ( -1.3 %),1139,3652620,3206.87,846,5120960,6053,-1468340
2016-04-07,7.7 ( -1.28 %),1084,3714260,3426.44,1084,6366950,5874,-2652690
2016-04-06,7.8 ( 0 %),1058,4206240,3975.65,999,5444580,5450,-1238340
2016-04-05,7.8 ( 1.3 %),1213,4365300,3598.76,889,5326930,5992,-961630
2016-04-04,7.7 ( 0 %),1425,5264140,3694.13,1046,6133760,5864,-869620
2016-04-01,7.7 ( -1.28 %),1935,8143710,4208.64,1268,8702600,6863,-558890
2016-03-31,7.8 ( -3.7 %),2543,9592360,3772.06,1763,13097980,7429,-3505620
2016-03-30,8.1 ( 1.25 %),1548,6248150,4036.27,1151,7378750,6411,-1130600
2016-03-29,8 ( -2.44 %),1512,6526920,4316.75,1393,8970470,6440,-2443550
2016-03-28,8.2 ( 0 %),1603,6443890,4019.89,1194,7823140,6552,-1379250
2016-03-25,8.2 ( -1.2 %),2314,9077190,3922.73,1433,10464160,7302,-1386970
2016-03-24,8.3 ( -2.35 %),1579,6576780,4165.16,1642,10326450,6289,-3749670
2016-03-23,8.5 ( 0 %),1873,12992880,6936.94,1975,10901520,5520,2091360
2016-03-22,8.5 ( 0 %),1522,9590160,6301.02,2120,11147020,5258,-1556860
2016-03-21,8.5 ( 1.19 %),3479,24206850,6957.99,4690,26343850,5617,-2137000
2016-03-18,8.4 ( 0 %),1907,11050430,5794.67,1911,12184430,6376,-1134000
2016-03-17,8.4 ( -1.18 %),1871,8725910,4663.77,2530,15702630,6207,-6976720
2016-03-16,8.5 ( 2.41 %),2726,14909400,5469.33,2990,17135470,5731,-2226070
2016-03-15,8.3 ( -1.19 %),3772,19736480,5232.36,2867,19041760,6642,694720
2016-03-14,8.4 ( 0 %),1831,9602580,5244.45,2072,10662390,5146,-1059810
2016-03-11,8.4 ( -1.18 %),2174,11859740,5455.26,3854,18682900,4848,-6823160
2016-03-10,8.5 ( 4.94 %),2092,14549410,6954.78,2707,12570610,4644,1978800
2016-03-09,8.1 ( -1.22 %),1512,5569660,3683.64,1225,6958140,5680,-1388480
2016-03-08,8.2 ( -2.38 %),1969,7850730,3987.17,2083,13359620,6414,-5508890
2016-03-07,8.4 ( 2.44 %),1776,9289260,5230.44,2230,9706530,4353,-417270
2016-03-04,8.2 ( 3.8 %),2544,12653900,4974.02,1889,8956380,4741,3697520
2016-03-03,7.9 ( -4.82 %),4894,18678730,3816.66,2361,20265930,8584,-1587200
2016-03-02,8.3 ( 0 %),1371,4754680,3468.04,1237,5960460,4818,-1205780
2016-03-01,8.3 ( 2.47 %),2802,13036490,4652.57,1623,9032610,5565,4003880
2016-02-29,8.1 ( -5.81 %),3763,15483280,4114.61,2130,15888550,7459,-405270
2016-02-26,8.6 ( -1.15 %),1784,7046210,3949.67,1663,8924800,5367,-1878590
2016-02-25,8.7 ( -3.33 %),2060,8955780,4347.47,2794,15007740,5371,-6051960
2016-02-24,9 ( 1.12 %),3606,27426450,7605.78,4682,26005510,5554,1420940
2016-02-23,8.9 ( 1.14 %),3986,21368450,5360.88,6009,33408750,5560,-12040300
2016-02-22,8.8 ( 6.02 %),3005,14404510,4793.51,1520,7291690,4797,7112820
2016-02-19,8.3 ( 6.41 %),3628,27908120,7692.43,2323,17191260,7400,10716860
2016-02-18,7.8 ( 0 %),1979,7230560,3653.64,1457,10279320,7055,-3048760
2016-02-17,7.8 ( 0 %),1754,8627770,4918.91,1587,8339410,5255,288360
2016-02-16,7.8 ( 0 %),1731,5471260,3160.75,1124,6397870,5692,-926610
2016-02-15,7.8 ( 0 %),1429,4818050,3371.62,952,4749670,4989,68380
2016-02-05,7.8 ( 1.3 %),1473,5083520,3451.13,848,4420390,5213,663130
2016-02-04,7.7 ( 1.32 %),2504,9477640,3785,1265,7617310,6022,1860330
2016-02-03,7.6 ( -5 %),3172,11446260,3608.53,1739,13150610,7562,-1704350
2016-02-02,8 ( -2.44 %),2439,9231220,3784.84,1742,11984840,6880,-2753620
2016-02-01,8.2 ( 0 %),2039,9309980,4565.95,1482,9677040,6530,-367060
2016-01-29,8.2 ( -1.2 %),3125,11936180,3819.58,2030,13226930,6516,-1290750
2016-01-28,8.3 ( -5.68 %),3699,13891350,3755.43,2907,18751170,6450,-4859820
2016-01-27,8.8 ( -1.12 %),2956,13258840,4485.4,3353,17322630,5166,-4063790
2016-01-26,8.9 ( 5.95 %),4507,23614440,5239.5,3365,19446010,5779,4168430
2016-01-25,8.4 ( 6.33 %),4888,25353900,5186.97,1590,13216210,8312,12137690
2016-01-22,7.9 ( -5.95 %),5270,21367430,4054.54,3194,31507710,9865,-10140280
2016-01-21,8.4 ( -6.67 %),4321,15326400,3546.96,2717,23726110,8732,-8399710
2016-01-20,9 ( -6.25 %),2862,11247220,3929.85,1796,14959260,8329,-3712040
2016-01-19,9.6 ( 3.23 %),2234,10222290,4575.78,1327,9845890,7420,376400
2016-01-18,9.3 ( -6.06 %),3049,11742620,3851.3,1953,14045260,7192,-2302640
2016-01-15,9.9 ( -3.88 %),2363,7951770,3365.12,1458,9237510,6336,-1285740
2016-01-14,10.3 ( -5.5 %),2708,10539200,3891.88,1872,13858440,7403,-3319240
2016-01-13,10.9 ( -3.54 %),2153,10488840,4871.73,2369,13925690,5878,-3436850
2016-01-12,11.3 ( 3.67 %),3015,14504390,4810.74,2638,15886980,6022,-1382590
2016-01-11,10.9 ( 6.86 %),3413,23427700,6864.25,2982,15851490,5316,7576210
2016-01-08,10.2 ( 0.99 %),2259,16851550,7459.74,1864,13834590,7422,3016960
2016-01-07,10.1 ( 1 %),2879,14746070,5121.94,2508,15844990,6318,-1098920
2016-01-06,10 ( 4.17 %),3581,14405850,4022.86,1809,9422170,5208,4983680
2016-01-05,9.6 ( -4.95 %),2764,10229580,3701.01,1991,16634090,8355,-6404510
2016-01-04,10.1 ( -2.88 %),1772,6669900,3764.05,1149,8365220,7280,-1695320
2015-12-31,10.4 ( -2.8 %),1212,3629500,2994.64,838,5896680,7037,-2267180
2015-12-30,10.7 ( 0 %),1183,4751590,4016.56,1024,5610630,5479,-859040
2015-12-29,10.7 ( 0.94 %),2820,12377840,4389.3,1580,10996350,6960,1381490
2015-12-28,10.6 ( -2.75 %),2821,11256080,3990.1,1769,12077870,6828,-821790
2015-12-25,10.9 ( -1.8 %),2200,7939800,3609,1341,10401050,7756,-2461250
2015-12-24,11.1 ( -1.77 %),1360,4729040,3477.24,888,7718930,8692,-2989890
2015-12-23,11.3 ( 0 %),1188,4920800,4142.09,883,6220570,7045,-1299770
2015-12-22,11.3 ( -0.88 %),1146,4489930,3917.91,856,5837750,6820,-1347820
2015-12-21,11.4 ( 0.88 %),1055,4366430,4138.8,876,5400350,6165,-1033920
2015-12-18,11.3 ( -4.24 %),1644,10876850,6616.09,1544,14190100,9190,-3313250
2015-12-17,11.8 ( 1.72 %),1096,5757250,5252.97,1219,7815430,6411,-2058180
2015-12-16,11.6 ( 0 %),1031,3872680,3756.24,847,6598500,7790,-2725820
2015-12-15,11.6 ( 0 %),1155,6043700,5232.64,900,7082330,7869,-1038630
2015-12-14,11.6 ( 1.75 %),1939,10486360,5408.13,1335,8215430,6154,2270930
2015-12-11,11.4 ( -0.87 %),1460,5453720,3735.42,1006,5322910,5291,130810
2015-12-10,11.5 ( -1.71 %),1227,4021620,3277.6,909,5006450,5508,-984830
2015-12-09,11.7 ( -1.68 %),1231,3793940,3082,965,6390480,6622,-2596540
2015-12-08,11.9 ( 0 %),1791,6083390,3396.64,1203,7248010,6025,-1164620
2015-12-07,11.9 ( -2.46 %),1590,4677210,2941.64,1137,8067730,7096,-3390520
2015-12-04,12.2 ( -0.81 %),1507,4908270,3256.98,765,4337940,5671,570330
2015-12-03,12.3 ( -2.38 %),1328,4476740,3371.04,1231,8111590,6589,-3634850
2015-12-02,12.6 ( 5 %),3875,16148990,4167.48,1968,14309070,7271,1839920
2015-12-01,12 ( -1.64 %),2499,9096020,3639.86,1363,11537310,8465,-2441290
2015-11-30,12.2 ( -3.17 %),1960,6796720,3467.71,1104,8278030,7498,-1481310
2015-11-27,12.6 ( -3.82 %),2453,8103360,3303.45,1294,9531440,7366,-1428080
2015-11-26,13.1 ( -0.76 %),1608,6093660,3789.59,883,5865430,6643,228230
2015-11-25,13.2 ( -1.49 %),2239,8202150,3663.31,1128,9601480,8512,-1399330
2015-11-24,13.4 ( -1.47 %),1572,5220290,3320.8,1001,8157710,8150,-2937420
2015-11-23,13.6 ( 0 %),1280,3843340,3002.61,931,6485660,6966,-2642320
2015-11-20,13.6 ( -0.73 %),1297,4817680,3714.48,748,5488400,7337,-670720
2015-11-19,13.7 ( 0 %),1011,4188890,4143.31,745,4420900,5934,-232010
2015-11-18,13.7 ( -0.72 %),1123,4079220,3632.43,771,6413860,8319,-2334640
2015-11-17,13.8 ( 0 %),1380,6552570,4748.24,899,6694970,7447,-142400
2015-11-16,13.8 ( -0.72 %),1454,4907000,3374.83,929,6971520,7504,-2064520
2015-11-13,13.9 ( -0.71 %),938,2890370,3081.42,685,3397010,4959,-506640
2015-11-12,14 ( 0 %),1130,3706040,3279.68,771,4240900,5501,-534860
2015-11-11,14 ( -0.71 %),971,3072280,3164.04,767,4007450,5225,-935170
2015-11-10,14.1 ( -1.4 %),975,3907880,4008.08,832,4128550,4962,-220670
2015-11-09,14.3 ( -1.38 %),960,2265460,2359.85,949,4834400,5094,-2568940
2015-11-06,14.5 ( -1.36 %),1750,8138410,4650.52,2669,12998780,4870,-4860370
2015-11-05,14.7 ( 6.52 %),2098,11649600,5552.72,1774,8624080,4861,3025520
2015-11-04,13.8 ( -0.72 %),1109,2712930,2446.28,820,3956730,4825,-1243800
2015-11-03,13.9 ( -0.71 %),1676,7027170,4192.82,1125,7852320,6980,-825150
2015-11-02,14 ( -0.71 %),772,2927480,3792.07,762,4228290,5549,-1300810
2015-10-30,14.1 ( 0.71 %),1239,5569980,4495.54,847,5780390,6825,-210410
2015-10-29,14 ( 0 %),1772,7312250,4126.55,966,6374830,6599,937420
2015-10-28,14 ( -2.1 %),2130,7204280,3382.29,1030,7703340,7479,-499060
2015-10-27,14.3 ( -1.38 %),1241,4207550,3390.45,907,5342550,5890,-1135000
2015-10-26,14.5 ( 0 %),1019,4700370,4612.73,1247,6244040,5007,-1543670
2015-10-23,14.5 ( 0.69 %),1059,4202240,3968.12,750,4043780,5392,158460
2015-10-22,14.4 ( -1.37 %),849,3132600,3689.75,623,3207000,5148,-74400
2015-10-21,14.6 ( 1.39 %),1350,4651420,3445.5,673,3202180,4758,1449240
2015-10-20,14.4 ( -2.04 %),1967,6558760,3334.4,980,7492000,7645,-933240
2015-10-19,14.7 ( -0.68 %),1124,5256320,4676.44,787,4692490,5963,563830
2015-10-16,14.8 ( -0.67 %),1572,5687280,3617.86,1147,7838260,6834,-2150980
2015-10-15,14.9 ( -1.32 %),1433,5970190,4166.22,906,6309640,6964,-339450
2015-10-14,15.1 ( -1.31 %),1208,6362110,5266.65,1224,9015590,7366,-2653480
2015-10-13,15.3 ( 0 %),1465,9778700,6674.88,1210,7259810,6000,2518890
2015-10-12,15.3 ( 0 %),1518,7791930,5133.02,1465,8155200,5567,-363270
2015-10-09,15.3 ( 2 %),2693,16663710,6187.79,2110,13169090,6241,3494620
2015-10-08,15 ( 0 %),1238,6647000,5369.14,879,4822210,5486,1824790
2015-10-07,15 ( 0.67 %),1068,5276120,4940.19,929,5099050,5489,177070
2015-10-06,14.9 ( 0 %),1362,5087890,3735.6,1012,5268930,5206,-181040
2015-10-05,14.9 ( 0 %),577,2346930,4067.47,594,2358940,3971,-12010
2015-10-02,14.9 ( 1.36 %),939,4134180,4402.75,975,4519030,4635,-384850
2015-10-01,14.7 ( -0.68 %),538,2044420,3800.04,424,1978080,4665,66340
2015-09-30,14.8 ( 0 %),758,2946080,3886.65,504,2604900,5168,341180
2015-09-29,14.8 ( 0 %),1196,4049200,3385.62,533,2638560,4950,1410640
2015-09-28,14.8 ( -1.99 %),976,2749950,2817.57,626,3573500,5708,-823550
2015-09-25,15.1 ( -1.95 %),731,2728150,3732.08,740,4001650,5408,-1273500
2015-09-24,15.4 ( 0 %),667,3480550,5218.22,655,2981820,4552,498730
2015-09-23,15.4 ( 0 %),781,4092440,5240,1023,3980350,3891,112090
2015-09-22,15.4 ( 1.32 %),1279,7779750,6082.68,1183,5689530,4809,2090220
2015-09-21,15.2 ( -1.94 %),646,2187960,3386.93,682,2637130,3867,-449170
2015-09-18,15.5 ( 1.31 %),1173,9355560,7975.75,1788,13286890,7431,-3931330
2015-09-17,15.3 ( 0 %),766,3360310,4386.83,1074,4045400,3767,-685090
2015-09-16,15.3 ( 4.08 %),1466,5289530,3608.14,1583,5339310,3373,-49780
2015-09-15,14.7 ( 0 %),413,1230500,2979.42,439,1377180,3137,-146680
2015-09-14,14.7 ( -0.68 %),486,1558350,3206.48,644,2144820,3330,-586470
2015-09-11,14.8 ( 0 %),486,1420890,2923.64,566,1703460,3010,-282570
2015-09-10,14.8 ( 0 %),510,1472410,2887.08,457,1468790,3214,3620
2015-09-09,14.8 ( 0 %),519,1657090,3192.85,687,2218270,3229,-561180
2015-09-08,14.8 ( 1.37 %),665,1967130,2958.09,487,1550430,3184,416700
2015-09-07,14.6 ( -0.68 %),516,1170340,2268.1,407,1531280,3762,-360940
2015-09-04,14.7 ( 2.08 %),622,2252310,3621.08,414,1480690,3577,771620
2015-09-03,14.4 ( -2.7 %),927,1997750,2155.07,500,2432530,4865,-434780
2015-09-01,14.8 ( 0 %),671,1792930,2672.03,500,2035690,4071,-242760
2015-08-31,14.8 ( -1.99 %),806,2322080,2880.99,637,3351170,5261,-1029090
2015-08-28,15.1 ( 0 %),1090,3126460,2868.31,878,4325830,4927,-1199370
2015-08-27,15.1 ( 0.67 %),870,2833130,3256.47,920,4450500,4838,-1617370
2015-08-26,15 ( 4.17 %),1233,4712380,3821.88,854,3630510,4251,1081870
2015-08-25,14.4 ( 0 %),2004,8023960,4003.97,1273,7560830,5939,463130
2015-08-24,14.4 ( -6.49 %),1271,3170530,2494.52,1174,7135250,6078,-3964720
2015-08-21,15.4 ( -3.14 %),1798,5876690,3268.46,947,5655140,5972,221550
2015-08-20,15.9 ( -3.05 %),812,2869850,3534.3,685,3275010,4781,-405160
2015-08-19,16.4 ( -0.61 %),591,1811690,3065.47,554,1921210,3468,-109520
2015-08-18,16.5 ( 0 %),560,1512940,2701.68,667,2543870,3814,-1030930
2015-08-17,16.5 ( 1.85 %),1186,4603820,3881.8,1153,4644150,4028,-40330
2015-08-14,16.2 ( -0.61 %),895,3710820,4146.17,620,2652500,4278,1058320
2015-08-13,16.3 ( -1.81 %),1521,4489460,2951.65,970,4716810,4863,-227350
2015-08-12,16.6 ( -1.78 %),983,2304010,2343.86,611,2886950,4725,-582940
2015-08-11,16.9 ( 0.6 %),919,3036150,3303.75,550,2952180,5368,83970
2015-08-10,16.8 ( -1.75 %),769,1920800,2497.79,576,2766580,4803,-845780
2015-08-07,17.1 ( 0.59 %),625,1210950,1937.52,492,1841450,3743,-630500
2015-08-06,17 ( -1.73 %),534,1461910,2737.66,598,2061390,3447,-599480
2015-08-05,17.3 ( 2.98 %),990,3971040,4011.15,607,2461130,4055,1509910
2015-08-04,16.8 ( 0 %),1144,3233510,2826.49,578,3231680,5591,1830
2015-08-03,16.8 ( -2.89 %),1663,3910710,2351.6,811,4105850,5063,-195140
2015-07-31,17.3 ( -1.14 %),1183,2710760,2291.43,565,2751210,4869,-40450
2015-07-30,17.5 ( -0.57 %),2315,6611570,2855.97,962,5776030,6004,835540
2015-07-29,17.6 ( -2.22 %),1163,3040040,2613.96,737,3822990,5187,-782950
2015-07-28,18 ( -0.55 %),1018,3271640,3213.79,773,4079950,5278,-808310
2015-07-27,18.1 ( 0 %),1257,4234290,3368.57,834,4255590,5103,-21300
2015-07-24,18.1 ( -1.09 %),954,3216680,3371.78,694,3810740,5491,-594060
2015-07-23,18.3 ( -0.54 %),849,2166010,2551.25,771,3543830,4596,-1377820
2015-07-22,18.4 ( 0.55 %),831,3325050,4001.26,637,3479710,5463,-154660
2015-07-21,18.3 ( -1.61 %),705,1974650,2800.92,734,3476230,4736,-1501580
2015-07-20,18.6 ( -0.53 %),809,3088600,3817.8,974,5223180,5363,-2134580
2015-07-17,18.7 ( 1.08 %),873,4371410,5007.34,856,3734400,4363,637010
2015-07-16,18.5 ( 0 %),804,3378520,4202.14,699,2601130,3721,777390
2015-07-15,18.5 ( -1.07 %),699,2416530,3457.12,978,3918710,4007,-1502180
2015-07-14,18.7 ( 0.54 %),861,3011820,3498.05,1073,4341740,4046,-1329920
2015-07-13,18.6 ( 1.64 %),1124,4641800,4129.72,1328,5478400,4125,-836600
2015-07-10,18.3 ( -1.08 %),1096,3786860,3455.16,919,4900690,5333,-1113830
2015-07-09,18.5 ( 0 %),1292,4406530,3410.63,913,4456170,4881,-49640
2015-07-08,18.5 ( -1.07 %),1637,5905140,3607.29,1310,7369190,5625,-1464050
2015-07-07,18.7 ( -2.6 %),2195,7483590,3409.38,1945,10136910,5212,-2653320
2015-07-06,19.2 ( 0.52 %),1363,4946520,3629.14,1385,5888610,4252,-942090
2015-07-03,19.1 ( -1.04 %),1303,4543030,3486.59,1397,6477940,4637,-1934910
2015-07-02,19.3 ( 2.12 %),1107,5427170,4902.59,1557,6962800,4472,-1535630
2015-07-01,18.9 ( -0.53 %),955,3493330,3657.94,1414,5461820,3863,-1968490
2015-06-30,19 ( 1.6 %),1970,10927160,5546.78,2580,12143740,4707,-1216580
2015-06-29,18.7 ( 1.63 %),1485,7652460,5153.17,1749,8503440,4862,-850980
2015-06-26,18.4 ( 0 %),1057,3612240,3417.45,1044,4594440,4401,-982200
2015-06-25,18.4 ( 0 %),951,3554830,3737.99,1129,4893950,4335,-1339120
2015-06-24,18.4 ( 2.22 %),2348,11589710,4935.99,2492,11995560,4814,-405850
2015-06-23,18 ( 0 %),685,2815670,4110.47,1293,4680280,3620,-1864610
2015-06-22,18 ( 2.27 %),922,4210870,4567.1,1063,4665020,4389,-454150
2015-06-19,17.6 ( 0 %),747,4086580,5470.66,1114,8142000,7309,-4055420
2015-06-18,17.6 ( 0 %),831,1947360,2343.39,588,2607380,4434,-660020
2015-06-17,17.6 ( -1.12 %),704,2075090,2947.57,769,3393050,4412,-1317960
2015-06-16,17.8 ( 0.56 %),942,2910400,3089.6,864,3859460,4467,-949060
2015-06-15,17.7 ( -1.12 %),1230,3379750,2747.76,912,4774190,5235,-1394440
2015-06-12,17.9 ( -0.56 %),842,2853950,3389.49,993,4458890,4490,-1604940
2015-06-11,18 ( 0 %),1003,3858500,3846.96,1090,5230430,4799,-1371930
2015-06-10,18 ( -1.1 %),752,3131920,4164.79,948,4127670,4354,-995750
2015-06-09,18.2 ( 0.55 %),1057,4249840,4020.66,1321,5072670,3840,-822830
2015-06-08,18.1 ( 1.12 %),1079,4225930,3916.52,1285,4699740,3657,-473810
2015-06-05,17.9 ( 0 %),1194,4051250,3393.01,1010,4710740,4664,-659490
2015-06-04,17.9 ( 1.7 %),1099,4004290,3643.58,1027,3939540,3836,64750
2015-06-03,17.6 ( 0.57 %),1732,5675220,3276.69,1247,6373040,5111,-697820
2015-06-02,17.5 ( -1.69 %),2004,5490130,2739.59,1058,6611320,6249,-1121190
2015-06-01,17.8 ( -2.73 %),1227,3262310,2658.77,994,4892170,4922,-1629860
2015-05-29,18.3 ( 0 %),762,2815920,3695.43,893,4486640,5024,-1670720
2015-05-28,18.3 ( 1.1 %),968,4517700,4667.05,1218,6024090,4946,-1506390
2015-05-27,18.1 ( 0 %),665,2598590,3907.65,805,3858070,4793,-1259480
2015-05-26,18.1 ( 0.56 %),1138,5557730,4883.77,1299,6141770,4728,-584040
2015-05-25,18 ( 0 %),876,2933550,3348.8,885,4246360,4798,-1312810
2015-05-22,18 ( -0.55 %),886,3742170,4223.67,954,5536700,5804,-1794530
2015-05-21,18.1 ( -0.55 %),860,4107660,4776.35,1108,4869130,4395,-761470
2015-05-20,18.2 ( 4 %),1047,4579920,4374.33,1066,4308470,4042,271450
2015-05-19,17.5 ( 2.34 %),1089,5029230,4618.21,745,2952430,3963,2076800
2015-05-18,17.1 ( -2.29 %),1781,6756440,3793.62,1441,9052620,6282,-2296180
2015-05-15,17.5 ( -2.78 %),1041,2697570,2591.33,743,4251090,5722,-1553520
2015-05-14,18 ( 1.12 %),2692,12896860,4790.81,1762,11991130,6805,905730
2015-05-13,17.8 ( 0 %),2678,13598790,5077.96,1733,11916300,6876,1682490
2015-05-12,17.8 ( -4.3 %),1862,5864710,3149.68,851,7030040,8261,-1165330
2015-05-11,18.6 ( -0.53 %),778,2169430,2788.47,503,2554980,5079,-385550
2015-05-08,18.7 ( 0.54 %),1134,2764030,2437.42,477,2638490,5531,125540
2015-05-07,18.6 ( -1.06 %),1185,3475060,2932.54,521,3226800,6193,248260
2015-05-06,18.8 ( -2.08 %),883,2270240,2571.05,566,2828800,4998,-558560
2015-05-05,19.2 ( 0.52 %),1119,2824810,2524.41,633,2881950,4553,-57140
2015-05-04,19.1 ( -4.98 %),1252,3254680,2599.58,765,3923850,5129,-669170
2015-04-27,20.1 ( -0.99 %),539,1480330,2746.44,426,1844710,4330,-364380
2015-04-24,20.3 ( 0 %),750,2897380,3863.17,480,3130460,6522,-233080
2015-04-23,20.3 ( 0 %),653,1623660,2486.46,453,1906330,4208,-282670
2015-04-22,20.3 ( 0.5 %),726,1895550,2610.95,448,1789760,3995,105790
2015-04-21,20.2 ( -0.49 %),820,2374990,2896.33,525,2670890,5087,-295900
2015-04-20,20.3 ( -1.46 %),756,2320090,3068.9,545,3122290,5729,-802200
2015-04-17,20.6 ( -0.48 %),859,3802780,4426.98,668,3350730,5016,452050
2015-04-16,20.7 ( 0.98 %),873,3241030,3712.52,856,3368710,3935,-127680
2015-04-15,20.5 ( 0.49 %),611,2419550,3959.98,597,2400160,4020,19390
2015-04-14,20.4 ( -0.97 %),520,1523300,2929.42,577,2228590,3862,-705290
2015-04-13,20.6 ( 0.49 %),568,2433230,4283.86,783,2689330,3435,-256100
2015-04-10,20.5 ( 1.49 %),958,4735890,4943.52,963,4019690,4174,716200
2015-04-09,20.2 ( 0 %),787,2722700,3459.59,552,2232980,4045,489720
2015-04-08,20.2 ( 0 %),670,1871070,2792.64,400,1548770,3872,322300
2015-04-07,20.2 ( 1 %),1314,3583350,2727.05,570,3031290,5318,552060
2015-04-06,20 ( -2.44 %),1622,4971420,3064.99,847,4834600,5708,136820
2015-04-03,20.5 ( 0 %),596,1700940,2853.93,498,1728590,3471,-27650
2015-04-02,20.5 ( 1.99 %),936,2976630,3180.16,468,2205800,4713,770830
2015-04-01,20.1 ( -1.95 %),1011,2935230,2903.29,679,3602680,5306,-667450
2015-03-31,20.5 ( 0.99 %),981,3192730,3254.57,559,2760300,4938,432430
2015-03-30,20.3 ( -1.93 %),1037,3085090,2975.01,755,3673080,4865,-587990
2015-03-27,20.7 ( -0.96 %),1047,3032550,2896.42,558,3045550,5458,-13000
2015-03-26,20.9 ( -1.42 %),1252,4252890,3396.88,559,3659610,6547,593280
2015-03-25,21.2 ( -0.93 %),912,2906170,3186.59,473,3063270,6476,-157100
2015-03-24,21.4 ( -0.93 %),1113,3243500,2914.2,611,3177800,5201,65700
2015-03-23,21.6 ( -2.26 %),993,3268460,3291.5,732,3775590,5158,-507130
2015-03-20,22.1 ( 1.38 %),947,7424550,7840.07,1452,11386540,7842,-3961990
2015-03-19,21.8 ( -0.46 %),633,1838470,2904.38,504,2407920,4778,-569450
2015-03-18,21.9 ( -1.79 %),860,2710840,3152.14,581,4138700,7123,-1427860
2015-03-17,22.3 ( 0.45 %),890,3757220,4221.6,635,3586360,5648,170860
2015-03-16,22.2 ( 0 %),780,3229350,4140.19,814,4271450,5247,-1042100
2015-03-13,22.2 ( 0 %),652,2063700,3165.18,552,2883840,5224,-820140
2015-03-12,22.2 ( 0 %),720,1921610,2668.9,455,2139210,4702,-217600
2015-03-11,22.2 ( -0.89 %),818,1979730,2420.21,501,2555150,5100,-575420
2015-03-10,22.4 ( 0 %),672,2082860,3099.49,521,2703790,5190,-620930
2015-03-09,22.4 ( 0 %),824,2616990,3175.96,709,3232320,4559,-615330
2015-03-06,22.4 ( -0.88 %),1010,2851360,2823.13,612,3268110,5340,-416750
2015-03-05,22.6 ( -1.74 %),1187,3457900,2913.14,969,4817540,4972,-1359640
2015-03-04,23 ( 0 %),603,2522650,4183.5,1075,4317310,4016,-1794660
2015-03-03,23 ( 0.88 %),763,3339480,4376.78,954,4084570,4282,-745090
2015-03-02,22.8 ( 0 %),749,2972290,3968.34,1078,3896060,3614,-923770
2015-02-27,22.8 ( -1.72 %),996,3925440,3941.2,1379,5811790,4214,-1886350
2015-02-26,23.2 ( 3.57 %),1130,6237990,5520.35,1773,5803550,3273,434440
2015-02-25,22.4 ( 0.9 %),1331,6908630,5190.56,1576,7105320,4508,-196690
2015-02-24,22.2 ( -0.45 %),739,2127940,2879.49,520,2543080,4891,-415140
2015-02-13,22.3 ( -0.45 %),948,3313140,3494.87,953,4165050,4370,-851910
2015-02-12,22.4 ( 1.82 %),1134,5612140,4948.98,1563,6878450,4401,-1266310
2015-02-11,22 ( 3.29 %),668,4278570,6405.04,1065,3372150,3166,906420
2015-02-10,21.3 ( 0 %),661,3110750,4706.13,566,3138980,5546,-28230
2015-02-09,21.3 ( -0.47 %),539,1872400,3473.84,498,1847140,3709,25260
2015-02-06,21.4 ( 0.94 %),529,2202430,4163.38,617,2190770,3551,11660
2015-02-05,21.2 ( 1.44 %),714,2439760,3417.03,589,2012420,3417,427340
2015-02-04,20.9 ( -0.48 %),868,2668740,3074.59,570,2470220,4334,198520
2015-02-03,21 ( -0.94 %),854,2338650,2738.47,611,2491570,4078,-152920
2015-02-02,21.2 ( -1.85 %),861,2111080,2451.89,617,2472910,4008,-361830
2015-01-30,21.6 ( -1.82 %),865,2907930,3361.77,735,3328610,4529,-420680
2015-01-29,22 ( 1.85 %),1081,4048060,3744.74,643,3303080,5137,744980
2015-01-28,21.6 ( -0.92 %),1367,3922940,2869.74,673,3990140,5929,-67200
2015-01-27,21.8 ( -2.24 %),1352,4093910,3028.04,896,5344890,5965,-1250980
2015-01-26,22.3 ( 0 %),532,1491700,2803.95,591,2214380,3747,-722680
2015-01-23,22.3 ( 0 %),797,2870270,3601.34,750,3585090,4780,-714820
2015-01-22,22.3 ( 0.45 %),1103,4011440,3636.84,690,3946190,5719,65250
2015-01-21,22.2 ( -1.33 %),932,2891410,3102.37,641,3515800,5485,-624390
2015-01-20,22.5 ( 0 %),999,3424230,3427.66,661,3047410,4610,376820
2015-01-19,22.5 ( -2.17 %),1324,4419320,3337.85,992,5092770,5134,-673450
2015-01-16,23 ( -2.13 %),953,5495810,5766.85,1620,8563040,5286,-3067230
2015-01-15,23.5 ( 0.86 %),1047,7720320,7373.75,1459,6605110,4527,1115210
2015-01-14,23.3 ( 0.43 %),1123,7120910,6340.97,1972,9377450,4755,-2256540
2015-01-13,23.2 ( 4.04 %),1654,10183060,6156.63,2416,10069490,4168,113570
2015-01-12,22.3 ( -2.19 %),973,2898340,2978.77,870,3841560,4416,-943220
2015-01-09,22.8 ( 2.24 %),944,4422400,4684.75,1233,4735310,3840,-312910
2015-01-08,22.3 ( -1.76 %),699,2176140,3113.22,1001,3442200,3439,-1266060
2015-01-07,22.7 ( 0.89 %),953,4799310,5036,1606,5459450,3399,-660140
2015-01-06,22.5 ( 1.35 %),1041,4851380,4660.31,1104,4039820,3659,811560
2015-01-05,22.2 ( 0.45 %),978,4078520,4170.27,1417,5153150,3637,-1074630
2014-12-31,22.1 ( 6.25 %),1194,5602000,4691.79,1636,5370990,3283,231010
2014-12-30,20.8 ( 1.96 %),1097,3911380,3565.52,749,2948360,3936,963020
2014-12-29,20.4 ( -0.49 %),1006,3623120,3601.51,964,4148830,4304,-525710
2014-12-26,20.5 ( -2.38 %),1900,5844160,3075.87,1070,6242370,5834,-398210
2014-12-25,21 ( -1.41 %),894,2641880,2955.12,709,3757040,5299,-1115160
2014-12-24,21.3 ( 0 %),733,2340390,3192.89,595,3232570,5433,-892180
2014-12-23,21.3 ( -0.93 %),995,3087520,3103.04,827,4654860,5629,-1567340
2014-12-22,21.5 ( 0.94 %),1243,5431080,4369.33,874,5131330,5871,299750
2014-12-19,21.3 ( -1.84 %),1287,4623870,3592.75,991,5677970,5730,-1054100
2014-12-18,21.7 ( 2.84 %),1460,4377430,2998.24,985,4280480,4346,96950
2014-12-17,21.1 ( -5.38 %),2403,6979650,2904.56,1419,8401840,5921,-1422190
2014-12-16,22.3 ( -3.04 %),1829,4772250,2609.21,973,5662820,5820,-890570
2014-12-15,23 ( -0.86 %),854,2041040,2389.98,965,3763890,3900,-1722850
2014-12-12,23.2 ( 2.2 %),1039,3389410,3262.18,916,3226550,3522,162860
2014-12-11,22.7 ( 0 %),1474,4191850,2843.86,963,3838510,3986,353340
2014-12-10,22.7 ( 0.89 %),2434,7168830,2945.29,1028,7439010,7236,-270180
2014-12-09,22.5 ( -4.26 %),2653,7044690,2655.37,1327,8560880,6451,-1516190
2014-12-08,23.5 ( -2.08 %),2992,8156340,2726.05,1343,10912710,8126,-2756370
2014-12-05,24 ( -0.41 %),1413,4754000,3364.47,942,6068330,6442,-1314330
2014-12-04,24.1 ( -0.41 %),991,4293430,4332.42,1067,7049350,6607,-2755920
2014-12-03,24.2 ( 0.41 %),1086,5016950,4619.66,877,4248790,4845,768160
2014-12-02,24.1 ( -0.82 %),1944,8279690,4259.1,1095,8542920,7802,-263230
2014-12-01,24.3 ( 0.83 %),1229,6949530,5654.62,1403,6997770,4988,-48240
2014-11-28,24.1 ( -0.41 %),1086,3724570,3429.62,1012,4551260,4497,-826690
2014-11-27,24.2 ( 0 %),1438,5232100,3638.46,868,4342750,5003,889350
2014-11-26,24.2 ( -1.63 %),1031,2935830,2847.56,1176,5453630,4637,-2517800
2014-11-25,24.6 ( 2.5 %),1352,4366060,3229.33,957,4045980,4228,320080
2014-11-24,24 ( -1.23 %),1951,5515450,2826.99,941,5565660,5915,-50210
2014-11-21,24.3 ( -1.62 %),990,2992680,3022.91,1021,5161500,5055,-2168820
2014-11-20,24.7 ( 1.23 %),1251,4327850,3459.51,922,3920440,4252,407410
2014-11-19,24.4 ( -0.41 %),1361,4257840,3128.46,825,4823700,5847,-565860
2014-11-18,24.5 ( -1.21 %),1158,3515580,3035.91,907,5190950,5723,-1675370
2014-11-17,24.8 ( 0 %),1311,4166710,3178.27,860,4605250,5355,-438540
2014-11-14,24.8 ( -1.2 %),2035,6317240,3104.29,1142,6477870,5672,-160630
2014-11-13,25.1 ( -0.79 %),1434,4893450,3412.45,1307,7190040,5501,-2296590
2014-11-12,25.3 ( 0 %),1531,5660210,3697.07,1052,4268080,4057,1392130
2014-11-11,25.3 ( -0.39 %),1506,5337620,3544.24,1140,5370290,4711,-32670
2014-11-10,25.4 ( -1.55 %),2845,9612110,3378.6,1997,13909100,6965,-4296990
2014-11-07,25.8 ( 1.18 %),3229,11832500,3664.45,3744,18165390,4852,-6332890
2014-11-06,25.5 ( 1.59 %),1372,8181850,5963.45,2099,8356770,3981,-174920
2014-11-05,25.1 ( 0.8 %),1263,6766110,5357.17,1907,8348650,4378,-1582540
2014-11-04,24.9 ( -0.4 %),774,3211120,4148.73,1280,5208160,4069,-1997040
2014-11-03,25 ( 2.04 %),1035,5388900,5206.67,1641,6173610,3762,-784710
2014-10-31,24.5 ( 1.24 %),1455,6644860,4566.91,946,5117070,5409,1527790
2014-10-30,24.2 ( -1.22 %),914,2772210,3033.05,947,4438940,4687,-1666730
2014-10-29,24.5 ( 2.51 %),1131,5220600,4615.92,1037,4961870,4785,258730
2014-10-28,23.9 ( 0.42 %),1473,5083100,3450.85,843,4350890,5161,732210
2014-10-27,23.8 ( -2.86 %),1768,5740470,3246.87,995,6238670,6270,-498200
2014-10-24,24.5 ( -0.81 %),1664,4996940,3002.97,852,5495270,6450,-498330
2014-10-23,24.7 ( -2.37 %),1793,6622590,3693.58,1202,8373200,6966,-1750610
2014-10-22,25.3 ( 2.02 %),1143,5653580,4946.26,1289,5371150,4167,282430
2014-10-21,24.8 ( 0 %),1243,4805850,3866.33,725,3903890,5385,901960
2014-10-20,24.8 ( -0.4 %),1034,3647170,3527.24,974,5086170,5222,-1439000
2014-10-17,24.9 ( 0.4 %),2061,6905590,3350.6,1110,7472600,6732,-567010
2014-10-16,24.8 ( -2.36 %),2382,8918770,3744.24,2405,13765780,5724,-4847010
2014-10-15,25.4 ( 2.42 %),1749,8219900,4699.77,1388,6894210,4967,1325690
2014-10-14,24.8 ( -1.59 %),1257,5103360,4059.95,1047,6116220,5842,-1012860
2014-10-13,25.2 ( -0.4 %),1258,5132260,4079.7,924,4806090,5201,326170
2014-10-10,25.3 ( -1.56 %),1787,6943680,3885.66,1253,6769330,5402,174350
2014-10-09,25.7 ( -1.91 %),1303,4738810,3636.85,1410,7748270,5495,-3009460
2014-10-08,26.2 ( 0.77 %),1602,9384230,5857.82,1998,8893210,4451,491020
2014-10-07,26 ( -0.76 %),1800,7784630,4324.79,1742,9119030,5235,-1334400
2014-10-06,26.2 ( 0.38 %),1902,12348980,6492.63,2174,13107230,6029,-758250
2014-10-03,26.1 ( -1.14 %),2036,8491350,4170.6,3202,13131880,4101,-4640530
2014-10-02,26.4 ( 3.53 %),2659,17284350,6500.32,4225,16278330,3853,1006020
2014-10-01,25.5 ( 4.51 %),2536,18660980,7358.43,4442,16988690,3825,1672290
2014-09-30,24.4 ( 0.83 %),1066,4782220,4486.14,1640,7340460,4476,-2558240
2014-09-29,24.2 ( 0.41 %),893,3016940,3378.43,947,4670930,4932,-1653990
2014-09-26,24.1 ( -1.23 %),1240,4408830,3555.51,977,6172890,6318,-1764060
2014-09-25,24.4 ( 0 %),1181,4272720,3617.88,862,4312520,5003,-39800
2014-09-24,24.4 ( 0.83 %),947,5712350,6032.05,1274,6995660,5491,-1283310
2014-09-23,24.2 ( -0.41 %),1280,5889560,4601.22,1188,6729270,5664,-839710
2014-09-22,24.3 ( -0.82 %),983,3176260,3231.19,1332,5624940,4223,-2448680
2014-09-19,24.5 ( 0.41 %),1400,10596790,7569.14,2631,14640430,5565,-4043640
2014-09-18,24.4 ( 2.09 %),1989,14236080,7157.41,3922,15885660,4050,-1649580
2014-09-17,23.9 ( -0.83 %),1717,5489220,3196.98,1047,6702430,6402,-1213210
2014-09-16,24.1 ( -0.41 %),0,0,0,0,0,0,0
2014-09-15,24.2 ( -0.82 %),714,2069850,2898.95,908,3634600,4003,-1564750
2014-09-12,24.4 ( 1.24 %),1130,3960550,3504.91,817,3748940,4589,211610
2014-09-11,24.1 ( -0.41 %),1004,3150750,3138.2,735,3815010,5190,-664260
2014-09-10,24.2 ( 0.83 %),2223,6038210,2716.24,929,4192430,4513,1845780
2014-09-09,24 ( -3.61 %),2211,6148910,2781.05,1657,8059290,4864,-1910380
2014-09-08,24.9 ( -0.4 %),1246,3465880,2781.61,1199,5425140,4525,-1959260
2014-09-05,25 ( -0.79 %),970,3334570,3437.7,1200,6102560,5085,-2767990
2014-09-04,25.2 ( 0.8 %),1293,5563370,4302.68,1314,6151980,4682,-588610
2014-09-03,25 ( 0 %),1025,4981300,4859.8,1618,7283610,4502,-2302310
2014-08-29,25 ( -0.79 %),1257,4176840,3322.86,1364,7230510,5301,-3053670
2014-08-28,25.2 ( 5.44 %),2034,8825650,4339.06,1749,8232180,4707,593470
2014-08-27,23.9 ( -8.08 %),2313,5623350,2431.19,1179,7800640,6616,-2177290
2014-08-26,26 ( 0 %),1558,8107090,5203.52,2300,9722160,4227,-1615070
2014-08-25,26 ( 2.77 %),1688,11605640,6875.38,2197,9800600,4461,1805040
2014-08-22,25.3 ( 0 %),1173,5502070,4690.6,1441,6445540,4473,-943470
2014-08-21,25.3 ( 0.4 %),1302,6007570,4614.11,1201,6891540,5738,-883970
2014-08-20,25.2 ( 0 %),1340,4095510,3056.35,780,4303600,5517,-208090
2014-08-19,25.2 ( -0.79 %),1124,4466090,3973.39,1186,6908250,5825,-2442160
2014-08-18,25.4 ( 0.4 %),1128,5922070,5250.06,1427,7431710,5208,-1509640
2014-08-15,25.3 ( -1.17 %),1651,5149330,3118.92,1245,6866200,5515,-1716870
2014-08-14,25.6 ( 1.19 %),1046,4974650,4755.88,1536,6848480,4459,-1873830
2014-08-13,25.3 ( 0.8 %),638,2012250,3154,613,2330620,3802,-318370
2014-08-12,25.1 ( 0.8 %),1071,3462250,3232.73,608,3071000,5051,391250
2014-08-11,24.9 ( -0.8 %),0,0,0,0,0,0,0
2014-08-08,25.1 ( -0.79 %),1977,6763110,3420.9,986,7464260,7570,-701150
2014-08-07,25.3 ( -0.39 %),989,3819440,3861.92,625,3540440,5665,279000
2014-08-06,25.4 ( -1.17 %),868,3862710,4450.13,981,5980500,6096,-2117790
2014-08-05,25.7 ( 0.78 %),726,3705660,5104.21,901,5131340,5695,-1425680
2014-08-04,25.5 ( 0 %),555,1997440,3598.99,487,1903290,3908,94150
2014-08-01,25.5 ( 0.39 %),703,3634590,5170.11,681,2867480,4211,767110
2014-07-31,25.4 ( 0.4 %),722,3302910,4574.67,707,2881550,4076,421360
2014-07-30,25.3 ( 0.4 %),809,5979870,7391.68,608,2791630,4591,3188240
2014-07-29,25.2 ( 0 %),0,0,0,0,0,0,0
2014-07-28,25.2 ( -2.7 %),1064,4352890,4091.06,1183,6131960,5183,-1779070
2014-07-25,25.9 ( 0.39 %),1372,7605840,5543.62,2191,9659350,4409,-2053510
2014-07-24,25.8 ( 0.39 %),738,3988630,5404.65,1271,5077370,3995,-1088740
2014-07-23,25.7 ( 0 %),490,2279710,4652.47,780,3412590,4375,-1132880
2014-07-22,25.7 ( 1.18 %),1423,8103030,5694.33,2088,8872960,4250,-769930
2014-07-21,25.4 ( 0 %),744,2833170,3808.02,1017,4198100,4128,-1364930
2014-07-18,25.4 ( 0 %),858,3200390,3730.06,926,4172950,4506,-972560
2014-07-17,25.4 ( 0.4 %),675,2481990,3677.02,965,3723450,3858,-1241460
2014-07-16,25.3 ( 0 %),892,4344740,4870.78,1444,5992290,4150,-1647550
2014-07-15,25.3 ( -0.39 %),702,2293690,3267.36,805,3641610,4524,-1347920
2014-07-14,25.4 ( 1.6 %),924,4139240,4479.7,931,3854410,4140,284830
2014-07-11,25 ( -0.4 %),1099,3125020,2843.51,626,2813600,4495,311420
2014-07-10,25.1 ( -1.95 %),1531,7300940,4768.74,1488,8956070,6019,-1655130
2014-07-09,25.6 ( -0.39 %),760,3492360,4595.21,967,4888070,5055,-1395710
2014-07-08,25.7 ( 0.78 %),1260,5915400,4694.76,1310,6362240,4857,-446840
2014-07-07,25.5 ( 2 %),1393,7713680,5537.46,1633,7878320,4824,-164640
2014-07-04,25 ( 0 %),867,4846090,5589.49,1363,6761250,4961,-1915160
2014-07-03,25 ( 1.21 %),1035,5724790,5531.2,1680,7593460,4520,-1868670
2014-07-02,24.7 ( 0.82 %),766,3907300,5100.91,1179,4893670,4151,-986370
2014-07-01,24.5 ( 1.24 %),952,4581390,4812.38,1093,4659480,4263,-78090
2014-06-30,24.2 ( -0.41 %),668,1671340,2502.01,622,2643980,4251,-972640
2014-06-27,24.3 ( -0.82 %),610,2266340,3715.31,1033,4028140,3899,-1761800
2014-06-25,24.3 ( 1.67 %),961,5073060,5278.94,1340,6200560,4627,-1127500
2014-06-24,23.9 ( 0.84 %),870,2477690,2847.92,509,2095270,4116,382420
2014-06-23,23.7 ( -0.42 %),920,2448240,2661.13,597,3212500,5381,-764260
2014-06-20,23.8 ( -0.83 %),1030,5569340,5407.13,1292,9697290,7506,-4127950
2014-06-19,24 ( -1.64 %),1821,4890650,2685.69,973,5085390,5227,-194740
2014-06-18,24.4 ( -0.81 %),554,1590640,2871.19,983,3861920,3929,-2271280
2014-06-17,24.6 ( 0.82 %),835,3986030,4773.69,1005,4075570,4055,-89540
2014-06-16,24.4 ( 0.83 %),875,3561480,4070.26,1048,4605850,4395,-1044370
2014-06-13,24.2 ( -0.41 %),1113,3582050,3218.37,730,3720900,5097,-138850
2014-06-12,24.3 ( -0.82 %),1044,3698340,3542.47,1065,4629940,4347,-931600
2014-06-11,24.5 ( 1.24 %),852,4207650,4938.56,1199,5036350,4200,-828700
2014-06-10,24.2 ( 0.83 %),1675,9369590,5593.79,2424,11149050,4599,-1779460
2014-06-09,24 ( 0.84 %),968,4348560,4492.31,1245,4949420,3975,-600860
2014-06-06,23.8 ( 1.71 %),869,3491380,4017.7,602,2811630,4670,679750
2014-06-05,23.4 ( 0 %),1022,2926430,2863.43,480,2046400,4263,880030
2014-06-04,23.4 ( -2.09 %),1064,3014930,2833.58,703,3323950,4728,-309020
2014-06-03,23.9 ( -0.42 %),789,2565390,3251.44,628,2834400,4513,-269010
2014-06-02,24 ( -1.23 %),926,2654900,2867.06,881,3620270,4109,-965370
2014-05-30,24.3 ( 0.41 %),1038,3129400,3014.84,717,2582460,3602,546940
2014-05-29,24.2 ( -1.63 %),1227,4410760,3594.75,1221,5687300,4658,-1276540
2014-05-28,24.6 ( 0.41 %),1298,4685540,3609.82,1575,5864670,3724,-1179130
2014-05-27,24.5 ( 2.08 %),1378,4470710,3244.35,1068,4400770,4121,69940
2014-05-26,24 ( -0.41 %),1375,3521730,2561.26,676,2886220,4270,635510
2014-05-23,24.1 ( -0.82 %),1506,3725200,2473.57,843,3695090,4383,30110
2014-05-22,24.3 ( -2.8 %),1459,3786820,2595.49,1346,5807970,4315,-2021150
2014-05-21,25 ( 1.21 %),1317,4849160,3681.97,1220,4941270,4050,-92110
2014-05-20,24.7 ( 0.82 %),1832,6634430,3621.41,1195,5212770,4362,1421660
2014-05-19,24.5 ( -0.81 %),1637,4282990,2616.37,1266,5765070,4554,-1482080
2014-05-16,24.7 ( 5.56 %),1845,8490250,4601.76,1982,8274300,4175,215950
2014-05-15,23.4 ( 0 %),2396,10310920,4303.39,2577,12953840,5027,-2642920
2014-05-14,23.4 ( 6.85 %),1751,8077050,4612.82,1186,5210120,4393,2866930
2014-05-13,21.9 ( 3.79 %),2041,8699870,4262.55,1594,6341170,3978,2358700
2014-05-12,21.1 ( -6.64 %),2052,7695630,3750.31,1397,8784330,6288,-1088700
2014-05-09,22.6 ( 0 %),2316,9023180,3896.02,1108,5994470,5410,3028710
2014-05-08,22.6 ( -7 %),1836,7404630,4033.02,1583,11112590,7020,-3707960
2014-05-07,24.3 ( -1.22 %),1018,3252940,3195.42,667,3342070,5011,-89130
2014-05-06,24.6 ( -1.99 %),1727,7499430,4342.46,1079,5752700,5332,1746730
2014-05-05,25.1 ( -3.46 %),1254,4123030,3287.9,810,4479060,5530,-356030
2014-04-29,26 ( 0 %),1086,3894010,3585.64,473,2685140,5677,1208870
2014-04-28,26 ( -1.52 %),909,2763040,3039.65,597,3347060,5606,-584020
2014-04-25,26.4 ( -0.38 %),1296,4984740,3846.25,765,4702740,6147,282000
2014-04-24,26.5 ( 0.38 %),919,3600700,3918.06,628,2818260,4488,782440
2014-04-23,26.4 ( -1.49 %),959,2440560,2544.9,834,3586770,4301,-1146210
2014-04-22,26.8 ( 5.1 %),1481,5949230,4017.04,976,4068140,4168,1881090
2014-04-21,25.5 ( -3.04 %),1208,4035340,3340.51,919,4414250,4803,-378910
2014-04-18,26.3 ( -2.23 %),1026,4293760,4184.95,1163,5696000,4898,-1402240
2014-04-17,26.9 ( 1.51 %),1714,7622400,4447.14,1071,6991500,6528,630900
2014-04-16,26.5 ( -3.28 %),1876,6700590,3571.74,1396,7053600,5053,-353010
2014-04-15,27.4 ( -1.79 %),1565,5153120,3292.73,1044,6632640,6353,-1479520
2014-04-14,27.9 ( -1.06 %),1374,4031210,2933.92,811,4870140,6005,-838930
2014-04-11,28.2 ( -1.05 %),2561,8606060,3360.43,1060,8367300,7894,238760
2014-04-10,28.5 ( -0.7 %),1199,3853380,3213.83,1187,6602660,5562,-2749280
2014-04-08,28.7 ( -0.69 %),945,2938120,3109.12,1229,6009750,4890,-3071630
2014-04-07,28.9 ( 0.35 %),1351,5648920,4181.29,1750,7798260,4456,-2149340
2014-04-04,28.8 ( 1.41 %),1239,6114550,4935.07,1838,7833130,4262,-1718580
2014-04-03,28.4 ( 0.71 %),921,3691730,4008.39,1015,4328310,4264,-636580
2014-04-02,28.2 ( -0.7 %),1792,6130070,3420.8,1553,8358910,5382,-2228840
2014-04-01,28.4 ( 1.07 %),2254,11227900,4981.32,2465,10782010,4374,445890
2014-03-31,28.1 ( 0.36 %),1139,5383910,4726.87,1112,4861650,4372,522260
2014-03-28,28 ( -1.41 %),1343,4837270,3601.84,1074,5709890,5316,-872620
2014-03-27,28.4 ( 2.16 %),1856,7109130,3830.35,1125,5243300,4661,1865830
2014-03-26,27.8 ( -2.8 %),2567,10668820,4156.14,1773,11605050,6545,-936230
2014-03-25,28.6 ( -3.38 %),2611,9895940,3790.1,1887,13331340,7065,-3435400
2014-03-24,29.6 ( 0.34 %),2034,7833730,3851.39,1356,7446990,5492,386740
2014-03-21,29.5 ( 1.72 %),1732,11246710,6493.48,2040,12000430,5883,-753720
2014-03-20,29 ( 2.11 %),2328,13883550,5963.72,2789,14634280,5247,-750730
2014-03-19,28.4 ( 1.07 %),1436,6790230,4728.57,1580,7584020,4800,-793790
2014-03-18,28.1 ( -0.35 %),2092,8354070,3993.34,2003,10328770,5157,-1974700
2014-03-17,28.2 ( 4.06 %),2364,12542880,5305.79,2261,11314030,5004,1228850
2014-03-14,27.1 ( 0.37 %),2042,11493960,5628.78,2611,12647550,4844,-1153590
2014-03-13,27 ( 0.37 %),1819,9189400,5051.9,1384,9107220,6580,82180
2014-03-12,26.9 ( -0.37 %),1667,7988130,4791.92,1920,8405830,4378,-417700
2014-03-11,27 ( 1.12 %),2003,8509200,4248.23,1935,8176630,4226,332570
2014-03-10,26.7 ( 0.75 %),1632,7479850,4583.24,1470,8014690,5452,-534840
2014-03-07,26.5 ( -1.49 %),1881,7666250,4075.62,1534,10152280,6618,-2486030
2014-03-06,26.9 ( 2.67 %),789,2565390,3251.44,628,2834400,4513,-269010
2014-03-05,26.2 ( 2.34 %),1699,7840920,4615.02,1080,5647920,5230,2193000
2014-03-04,25.6 ( -1.54 %),2474,9603480,3881.76,1291,7012240,5432,2591240
2014-03-03,26 ( -4.41 %),2867,9400870,3278.99,1814,10368690,5716,-967820
2014-02-28,27.2 ( -1.09 %),2581,10961810,4247.12,1577,8549500,5421,2412310
2014-02-27,27.5 ( -1.79 %),2190,8431780,3850.13,2464,11464570,4653,-3032790
2014-02-26,28 ( 6.87 %),3123,16264720,5208.04,3641,14303300,3928,1961420
2014-02-25,26.2 ( 4.38 %),2029,10890700,5367.52,2141,8987910,4198,1902790
2014-02-24,25.1 ( 1.21 %),1857,8458000,4554.66,1302,8405330,6456,52670
2014-02-21,24.8 ( -0.8 %),2360,9095560,3854.05,1465,7322870,4999,1772690
2014-02-20,25 ( -4.58 %),3436,14327170,4169.72,2720,17588620,6466,-3261450
2014-02-19,26.2 ( 1.16 %),1612,7798900,4838.03,1431,8340420,5828,-541520
2014-02-18,25.9 ( 0 %),1773,6851760,3864.5,1555,7252330,4664,-400570
2014-02-17,25.9 ( 4.02 %),3790,19194050,5064.39,2832,17206380,6076,1987670
2014-02-14,24.9 ( 0.4 %),1466,7395630,5044.77,1572,6966370,4432,429260
2014-02-13,24.8 ( 0.4 %),2439,10882030,4461.68,2307,12226700,5300,-1344670
2014-02-12,24.7 ( 2.92 %),2122,11193160,5274.82,1707,8422000,4934,2771160
2014-02-11,24 ( -1.23 %),1910,8956080,4689.05,2280,10085350,4423,-1129270
2014-02-10,24.3 ( 6.58 %),2212,11053950,4997.26,2235,7249610,3244,3804340
2014-02-07,22.8 ( 3.17 %),1499,9215670,6147.88,2178,8174040,3753,1041630
2014-02-06,22.1 ( 0.91 %),970,4224390,4355.04,858,3998010,4660,226380
2014-01-27,21.9 ( -0.9 %),681,3398380,4990.28,648,3185140,4915,213240
2014-01-24,22.1 ( 2.31 %),1336,8137370,6090.85,1955,7936620,4060,200750
2014-01-23,21.6 ( -0.46 %),597,2176150,3645.14,700,3142230,4489,-966080
2014-01-22,21.7 ( -1.81 %),944,3929910,4163.04,1273,5368230,4217,-1438320
2014-01-21,22.1 ( 1.38 %),1077,5185300,4814.58,1214,5719150,4711,-533850
2014-01-20,21.8 ( 0 %),1101,5925280,5381.73,1953,8462410,4333,-2537130
2014-01-17,21.8 ( 0 %),1799,9176700,5101,2628,12370570,4707,-3193870
2014-01-16,21.8 ( 3.81 %),1421,9327260,6563.87,2188,8283530,3786,1043730
2014-01-15,21 ( -0.94 %),832,3832260,4606.08,1397,5935630,4249,-2103370
2014-01-14,21.2 ( 2.42 %),1311,7292330,5562.42,1731,6045620,3493,1246710
2014-01-13,20.7 ( -0.48 %),653,2500760,3829.65,660,2853690,4324,-352930
2014-01-10,20.8 ( -0.48 %),749,3356550,4481.38,1203,4714850,3919,-1358300
2014-01-09,20.9 ( 0.48 %),629,2802270,4455.12,706,3311380,4690,-509110
2014-01-08,20.8 ( 0 %),534,1887560,3534.76,509,1928110,3788,-40550
2014-01-07,20.8 ( -0.48 %),714,3305750,4629.9,1193,4300410,3605,-994660
2014-01-06,20.9 ( 1.95 %),681,3012880,4424.2,732,2286130,3123,726750
2014-01-03,20.5 ( 0.49 %),578,2724230,4713.2,626,2450920,3915,273310
2014-01-02,20.4 ( -0.49 %),670,2198420,3281.22,527,2530350,4801,-331930
2013-12-31,20.5 ( 1.49 %),998,3540080,3547.17,600,2739210,4565,800870
2013-12-30,20.2 ( -2.42 %),1015,2966140,2922.31,849,4536440,5343,-1570300
2013-12-27,20.7 ( 0 %),665,2425110,3646.78,817,3436790,4207,-1011680
2013-12-26,20.7 ( 0 %),785,2756290,3511.2,704,3337500,4741,-581210
2013-12-25,20.7 ( -0.96 %),844,2306100,2732.35,747,3679600,4926,-1373500
2013-12-24,20.9 ( -1.42 %),675,2336780,3461.9,843,4443310,5271,-2106530
2013-12-23,21.2 ( 1.44 %),1028,4822990,4691.62,1289,5734340,4449,-911350
2013-12-20,20.9 ( -0.48 %),1692,8017150,4738.27,974,6559090,6734,1458060
2013-12-19,21 ( 0.48 %),1002,5065180,5055.07,1064,5336780,5016,-271600
2013-12-18,20.9 ( 0 %),520,1930040,3711.62,616,2532250,4111,-602210
2013-12-17,20.9 ( 0.97 %),860,3291350,3827.15,673,3431670,5099,-140320
2013-12-16,20.7 ( -0.96 %),841,3152410,3748.41,885,4370590,4939,-1218180
2013-12-13,20.9 ( 1.46 %),899,3332930,3707.37,712,2956880,4153,376050
2013-12-12,20.6 ( -0.48 %),962,2791020,2901.27,687,3468770,5049,-677750
2013-12-11,20.7 ( -1.43 %),866,2507000,2894.92,756,3565870,4717,-1058870
2013-12-10,21 ( 0 %),629,2144360,3409.16,744,3409490,4583,-1265130
2013-12-09,21 ( 0 %),1533,6578390,4291.19,1178,7097460,6025,-519070
2013-12-06,21 ( 0.48 %),892,2010880,2254.35,539,2360900,4380,-350020
2013-12-05,20.9 ( -0.48 %),1061,3279180,3090.65,739,4226070,5719,-946890
2013-12-04,21 ( 0 %),1282,4132580,3223.54,689,4580970,6649,-448390
2013-12-03,21 ( 0 %),1470,4231480,2878.56,780,4826140,6187,-594660
2013-12-02,21 ( -1.41 %),1239,3894510,3143.27,719,4997050,6950,-1102540
2013-11-29,21.3 ( 0.95 %),756,1911750,2528.77,476,1927170,4049,-15420
2013-11-28,21.1 ( 0 %),674,1356390,2012.45,444,1973870,4446,-617480
2013-11-27,21.1 ( 0.48 %),1124,2807960,2498.19,704,3160520,4489,-352560
2013-11-26,21 ( -0.94 %),1124,2649770,2357.45,530,3148660,5941,-498890
2013-11-25,21.2 ( -1.4 %),929,2099050,2259.47,658,3292830,5004,-1193780
2013-11-22,21.5 ( 0 %),752,2566110,3412.38,539,2237910,4152,328200
2013-11-21,21.5 ( -0.46 %),755,3155450,4179.4,979,3938520,4023,-783070
2013-11-20,21.6 ( 0.47 %),939,2785080,2966.01,607,3082820,5079,-297740
2013-11-19,21.5 ( -1.38 %),846,2019270,2386.84,626,2835650,4530,-816380
2013-11-18,21.8 ( 1.4 %),836,2974960,3558.56,548,3001320,5477,-26360
2013-11-15,21.5 ( 0.94 %),1297,3269490,2520.81,527,3240540,6149,28950
2013-11-14,21.8 ( -2.68 %),2511,8085200,3219.91,1274,9048460,7102,-963260
2013-11-13,22.4 ( -0.88 %),534,1894890,3548.48,538,2500050,4647,-605160
2013-11-12,22.6 ( -2.59 %),1206,4755370,3943.09,1008,5739950,5694,-984580
2013-11-11,23.2 ( 0.43 %),538,2065990,3840.13,668,2688800,4025,-622810
2013-11-08,23.1 ( 0.43 %),502,1932340,3849.28,657,2560980,3898,-628640
2013-11-07,23 ( -0.86 %),529,1989560,3760.98,782,2922280,3737,-932720
2013-11-06,23.2 ( 1.75 %),1321,6586120,4985.71,1354,6859460,5066,-273340
2013-11-05,22.8 ( 0.88 %),454,1990850,4385.13,550,2123020,3860,-132170
2013-11-04,22.6 ( 0 %),370,1777790,4804.84,469,1817860,3876,-40070
2013-11-01,22.6 ( -0.44 %),338,1301120,3849.47,396,1318170,3329,-17050
2013-10-31,22.7 ( 0.44 %),325,1480670,4555.91,477,1530790,3209,-50120
2013-10-30,22.6 ( 0.44 %),497,2543610,5117.93,624,2938950,4710,-395340
2013-10-29,22.5 ( -0.44 %),603,2464500,4087.06,609,2845510,4672,-381010
2013-10-28,22.6 ( -0.88 %),382,1665980,4361.2,695,2197740,3162,-531760
2013-10-25,22.8 ( 0.88 %),672,3622210,5390.19,943,3830240,4062,-208030
2013-10-24,22.6 ( -0.88 %),992,4982070,5022.25,1154,5097270,4417,-115200
2013-10-23,22.8 ( 1.79 %),725,4464560,6158.01,986,3777030,3831,687530
2013-10-22,22.4 ( -0.88 %),772,2603290,3372.14,890,3891510,4372,-1288220
2013-10-21,22.6 ( 0.89 %),979,4479160,4575.24,1115,4347170,3899,131990
2013-10-18,22.4 ( 0 %),758,2767700,3651.32,712,3065630,4306,-297930
2013-10-17,22.4 ( 0.9 %),1219,4070610,3339.3,1403,5639020,4019,-1568410
2013-10-16,22.2 ( 3.74 %),1423,7483500,5258.96,1790,5935500,3316,1548000
2013-10-15,21.4 ( 1.42 %),384,1218590,3173.41,405,1103200,2724,115390
2013-10-14,21.1 ( -0.47 %),287,1021240,3558.33,336,1361610,4052,-340370
2013-10-11,21.2 ( 0 %),402,1402000,3487.56,504,1712490,3398,-310490
2013-10-10,21.2 ( -1.4 %),578,2155230,3728.77,616,2645030,4294,-489800
2013-10-09,21.5 ( -1.38 %),382,1244900,3258.9,693,1977990,2854,-733090
2013-10-08,21.8 ( 1.87 %),630,2776670,4407.41,1157,3308210,2859,-531540
2013-10-07,21.4 ( 2.88 %),638,2724370,4270.17,893,2934840,3286,-210470
2013-10-04,20.8 ( -0.48 %),441,1535720,3482.36,500,1901980,3804,-366260
2013-10-03,20.9 ( -0.95 %),382,1180830,3091.18,560,2032320,3629,-851490
2013-10-02,21.1 ( 0.48 %),435,1626420,3738.9,697,2110020,3027,-483600
2013-10-01,21 ( 0.96 %),625,2460660,3937.06,1099,3279960,2984,-819300
2013-09-30,20.8 ( 0 %),376,1162460,3091.65,568,1769400,3115,-606940
2013-09-27,20.8 ( -0.48 %),383,1129780,2949.82,544,1598190,2938,-468410
2013-09-26,20.9 ( 0 %),373,986940,2645.95,585,1481380,2532,-494440
2013-09-25,20.9 ( 1.46 %),601,2279140,3792.25,856,2554070,2984,-274930
2013-09-24,20.6 ( 0.49 %),690,2341870,3394.01,821,2680970,3265,-339100
2013-09-23,20.5 ( 0 %),375,989820,2639.52,441,1033270,2343,-43450
2013-09-20,20.5 ( 2.5 %),463,3706300,8004.97,1198,7425970,6199,-3719670
2013-09-19,20 ( 1.01 %),408,1426260,3495.74,419,1732520,4135,-306260
2013-09-18,19.8 ( -1.49 %),459,1039110,2263.86,369,1639730,4444,-600620
2013-09-17,20.1 ( -0.99 %),417,1019470,2444.77,499,1922160,3852,-902690
2013-09-16,20.3 ( 1 %),416,1560360,3750.87,547,1933210,3534,-372850
2013-09-13,20.1 ( -0.5 %),307,1129190,3678.14,383,1457140,3805,-327950
2013-09-12,20.2 ( 0 %),388,1375680,3545.57,377,1404220,3725,-28540
2013-09-11,20.2 ( 0.5 %),426,1477670,3468.71,517,2216610,4287,-738940
2013-09-10,20.1 ( 0.5 %),467,1219070,2610.43,363,1500230,4133,-281160
2013-09-09,20 ( -2.44 %),505,1253460,2482.1,463,1665180,3597,-411720
2013-09-06,20.5 ( 2.5 %),733,2645630,3609.32,730,2542350,3483,103280
2013-09-05,20 ( 1.52 %),529,1860950,3517.86,458,1876810,4098,-15860
2013-09-04,19.7 ( -1.99 %),712,2348480,3298.43,476,2693540,5659,-345060
2013-09-03,20.1 ( -0.99 %),437,1436750,3287.76,382,1744500,4567,-307750
2013-08-30,20.3 ( 1 %),611,2409310,3943.22,437,1861360,4259,547950
2013-08-29,20.1 ( -0.99 %),521,1693530,3250.54,465,1797960,3867,-104430
2013-08-28,20.3 ( -1.46 %),976,3118330,3195.01,739,3278640,4437,-160310
2013-08-27,20.6 ( -1.44 %),431,1380830,3203.78,487,1913950,3930,-533120
2013-08-26,20.9 ( 0.97 %),784,2571190,3279.58,534,1892830,3545,678360
2013-08-23,20.7 ( -1.43 %),1001,2538590,2536.05,587,2497010,4254,41580
2013-08-22,21 ( -2.78 %),930,2737050,2943.06,762,3964870,5203,-1227820
2013-08-21,21.6 ( -0.92 %),889,3144600,3537.23,904,4281250,4736,-1136650
2013-08-20,21.8 ( 0.93 %),1090,5306750,4868.58,1381,7264430,5260,-1957680
2013-08-19,21.6 ( -0.46 %),545,2286980,4196.29,936,3153820,3369,-866840
2013-08-16,21.7 ( -0.46 %),736,3020930,4104.52,1547,5531230,3575,-2510300
2013-08-15,21.8 ( 5.31 %),1272,5520000,4339.62,1373,4404280,3208,1115720
2013-08-14,20.7 ( 1.47 %),476,1547560,3251.18,380,1549370,4077,-1810
2013-08-13,20.4 ( -0.97 %),467,1445470,3095.22,441,1999180,4533,-553710
2013-08-12,20.6 ( 0 %),397,1261320,3177.13,386,1291230,3345,-29910
2013-08-09,20.6 ( 0 %),314,1020720,3250.7,404,1334670,3304,-313950
2013-08-08,20.6 ( 0 %),578,2056420,3557.82,754,2558050,3393,-501630
2013-08-07,20.6 ( -0.48 %),481,1439740,2993.22,397,1588460,4001,-148720
2013-08-06,20.7 ( 0.49 %),547,1348990,2466.16,328,1258720,3838,90270
2013-08-05,20.6 ( -0.96 %),466,1361680,2922.06,374,1594330,4263,-232650
2013-08-02,20.8 ( 0.48 %),285,1227820,4308.14,352,968490,2751,259330
2013-08-01,20.7 ( 0.98 %),496,1802910,3634.9,408,1485580,3641,317330
2013-07-31,20.5 ( -0.49 %),683,2347320,3436.78,414,2028470,4900,318850
2013-07-30,20.6 ( 0 %),549,1868960,3404.3,416,1709440,4109,159520
2013-07-29,20.6 ( -0.96 %),550,2049170,3725.76,503,2019700,4015,29470
2013-07-26,20.8 ( 0.97 %),856,3106490,3629.08,589,2058110,3494,1048380
2013-07-25,20.6 ( -2.83 %),1021,2580820,2527.74,596,3151220,5287,-570400
2013-07-24,21.2 ( -1.85 %),1062,4125010,3884.19,842,4243710,5040,-118700
2013-07-23,21.6 ( 0 %),987,3739690,3788.95,689,3133160,4547,606530
2013-07-22,21.6 ( -1.37 %),839,2792940,3328.89,843,3126370,3709,-333430
2013-07-19,21.9 ( -0.45 %),729,2986740,4097.04,882,3534960,4008,-548220
2013-07-18,22 ( -1.35 %),936,4914220,5250.24,1426,5872200,4118,-957980
2013-07-17,22.3 ( -0.45 %),1078,4564240,4233.99,1387,5211410,3757,-647170
2013-07-16,22.4 ( 2.28 %),1242,6036320,4860.16,1711,5715260,3340,321060
2013-07-15,21.9 ( 1.39 %),1187,4947930,4168.43,1660,5233860,3153,-285930
2013-07-12,21.6 ( 2.37 %),1186,6452670,5440.7,1916,6502410,3394,-49740
2013-07-11,21.1 ( 2.43 %),1091,6858910,6286.81,1244,4010990,3224,2847920
2013-07-10,20.6 ( 0.98 %),442,1749740,3958.69,725,2212920,3052,-463180
2013-07-09,20.4 ( 0.49 %),873,3394570,3888.4,612,2269570,3708,1125000
2013-07-08,20.3 ( -0.98 %),1293,3693030,2856.17,675,4166280,6172,-473250
2013-07-05,20.5 ( -1.44 %),852,2808880,3296.81,883,3709320,4201,-900440
2013-07-04,20.8 ( -0.48 %),664,2863780,4312.92,1097,3347470,3051,-483690
2013-07-03,20.9 ( 0.97 %),972,4989820,5133.56,1287,4455170,3462,534650
2013-07-02,20.7 ( 1.47 %),1031,2919350,2831.57,868,3289070,3789,-369720
2013-07-01,20.4 ( -1.45 %),1489,4214770,2830.6,994,3890220,3914,324550
2013-06-28,20.7 ( -0.96 %),986,3049570,3092.87,1057,3881250,3672,-831680
2013-06-27,20.9 ( 2.45 %),1152,3844210,3336.99,683,2896360,4241,947850
2013-06-26,20.4 ( -0.97 %),1925,6166380,3203.31,905,5267200,5820,899180
2013-06-25,20.6 ( -5.5 %),2105,4823300,2291.35,1112,5018620,4513,-195320
2013-06-24,21.8 ( -3.54 %),1264,3355580,2654.73,1160,4855330,4186,-1499750
2013-06-21,22.6 ( 4.15 %),2592,14178370,5470.05,1363,9403080,6899,4775290
2013-06-20,21.7 ( 0 %),1248,4704460,3769.6,1028,4876300,4743,-171840
2013-06-19,21.7 ( 0.93 %),1254,4341330,3461.99,659,3096740,4699,1244590
2013-06-18,21.5 ( 0 %),1492,3602440,2414.5,634,2429760,3832,1172680
2013-06-17,21.5 ( -4.44 %),1864,5064930,2717.24,1003,5273940,5258,-209010
2013-06-14,22.5 ( -1.32 %),1245,4006900,3218.39,1143,4363560,3818,-356660
2013-06-13,22.8 ( 1.33 %),865,3027040,3499.47,737,2596060,3522,430980
2013-06-12,22.5 ( 0.45 %),1770,6482590,3662.48,969,5509960,5686,972630
2013-06-11,22.4 ( -1.32 %),1595,3287200,2060.94,672,3432530,5108,-145330
2013-06-10,22.7 ( -3.4 %),1575,3957900,2512.95,1077,5062360,4700,-1104460
2013-06-07,23.5 ( -0.84 %),1270,4035080,3177.23,1497,5407700,3612,-1372620
2013-06-06,23.7 ( 4.41 %),1669,7053540,4226.21,1557,5186330,3331,1867210
2013-06-05,22.7 ( 0.44 %),995,3353940,3370.79,757,3175220,4194,178720
2013-06-04,22.6 ( 0.44 %),1468,5628360,3834.03,1362,5192610,3812,435750
2013-06-03,22.5 ( -1.32 %),762,1855600,2435.17,626,2056610,3285,-201010
2013-05-31,22.8 ( 0 %),1451,6117740,4216.22,1502,5806110,3866,311630
2013-05-30,22.8 ( 0 %),793,1671120,2107.34,669,2075420,3102,-404300
2013-05-29,22.8 ( -0.44 %),1076,2898300,2693.59,1155,3761340,3257,-863040
2013-05-28,22.9 ( -0.43 %),938,2472550,2635.98,845,2586460,3061,-113910
2013-05-27,23 ( 5.99 %),1126,3254170,2890.03,1184,2686470,2269,567700
2013-05-24,21.7 ( -1.36 %),1212,2697580,2225.73,761,3115450,4094,-417870
2013-05-23,22 ( -3.93 %),1597,3080910,1929.19,1073,3575500,3332,-494590
2013-05-22,22.9 ( -0.43 %),816,1526710,1870.97,1024,2231400,2179,-704690
2013-05-21,23 ( 4.07 %),1064,4194510,3942.21,1664,3548650,2133,645860
2013-05-20,22.1 ( 1.38 %),1071,3665380,3422.39,1078,2990310,2774,675070
2013-05-17,21.8 ( -0.46 %),696,1663920,2390.69,749,2182060,2913,-518140
2013-05-16,21.9 ( 3.3 %),842,2373780,2819.22,778,1836000,2360,537780
2013-05-15,21.2 ( -0.93 %),1970,4615250,2342.77,690,3130730,4537,1484520
2013-05-14,21.4 ( -6.14 %),2642,5163120,1954.25,827,5737130,6937,-574010
2013-05-13,22.8 ( 0.44 %),536,1153020,2151.16,405,1095990,2706,57030
2013-05-10,22.7 ( -2.58 %),756,1233780,1631.98,440,1697770,3859,-463990
2013-05-09,23.3 ( -0.85 %),611,1071510,1753.7,528,1325290,2510,-253780
2013-05-08,23.5 ( 3.52 %),688,2128870,3094.29,890,2316100,2602,-187230
2013-05-07,22.7 ( -2.16 %),684,1332770,1948.49,686,1680670,2450,-347900
2013-05-06,23.2 ( 4.98 %),764,1706690,2233.89,554,1393410,2515,313280
2013-05-03,22.1 ( 0.45 %),434,1015600,2340.09,333,1029380,3091,-13780
2013-05-02,22 ( -2.65 %),567,1230640,2170.44,535,1535950,2871,-305310
2013-04-26,22.6 ( 4.63 %),742,1930270,2601.44,786,1596990,2032,333280
2013-04-25,21.6 ( 2.37 %),524,1228070,2343.65,340,818580,2408,409490
2013-04-24,21.1 ( -0.47 %),664,1300290,1958.27,367,1241690,3383,58600
2013-04-23,21.2 ( -1.85 %),576,1162770,2018.7,351,1108080,3157,54690
2013-04-22,21.6 ( -2.26 %),452,636340,1407.83,318,703100,2211,-66760
2013-04-18,22.1 ( -0.9 %),464,1011250,2179.42,321,1000650,3117,10600
2013-04-17,22.3 ( 0.45 %),556,912310,1640.85,334,799510,2394,112800
2013-04-16,22.2 ( -1.33 %),1077,1805650,1676.56,546,1568840,2873,236810
2013-04-15,22.5 ( -5.06 %),804,1131150,1406.9,516,1465830,2841,-334680
2013-04-12,23.7 ( -3.66 %),934,1292040,1383.34,477,1561580,3274,-269540
2013-04-11,24.6 ( 1.65 %),805,1335730,1659.29,476,1383490,2906,-47760
2013-04-10,24.2 ( -5.47 %),1065,2155760,2024.19,465,1983790,4266,171970
2013-04-09,25.6 ( -1.54 %),831,1642190,1976.16,437,1859110,4254,-216920
2013-04-08,26 ( 0.78 %),583,1067250,1830.62,396,1229120,3104,-161870
2013-04-05,25.8 ( 1.18 %),730,1289460,1766.38,349,1091770,3128,197690
2013-04-04,25.5 ( 3.24 %),1512,2359720,1560.66,508,2366740,4659,-7020
2013-04-03,27.6 ( -2.47 %),804,1663560,2069.1,706,2058160,2915,-394600
2013-04-02,28.3 ( 0.35 %),720,2006890,2787.35,837,2338530,2794,-331640
2013-04-01,28.2 ( 4.06 %),580,1512540,2607.83,461,1165460,2528,347080
2013-03-29,27.1 ( -1.45 %),845,1222010,1446.17,353,1276490,3616,-54480
2013-03-28,27.5 ( -0.72 %),397,771260,1942.72,474,1362840,2875,-591580
2013-03-27,27.7 ( -1.42 %),501,1145480,2286.39,431,1337770,3104,-192290
2013-03-26,28.1 ( 0.72 %),546,1458740,2671.68,716,1910990,2669,-452250
2013-03-25,27.9 ( 1.82 %),327,1013700,3100,551,1313980,2385,-300280
2013-03-22,27.4 ( -0.72 %),484,1213040,2506.28,622,1526830,2455,-313790
2013-03-21,27.6 ( 1.85 %),554,2069400,3735.38,908,2699230,2973,-629830
2013-03-20,27.1 ( 0.37 %),567,1180000,2081.13,390,1168870,2997,11130
2013-03-19,27 ( -0.74 %),463,724380,1564.54,299,827300,2767,-102920
2013-03-18,27.2 ( -1.45 %),496,826570,1666.47,377,938140,2488,-111570
2013-03-15,27.6 ( 0.73 %),620,2259430,3644.24,575,1947190,3386,312240
2013-03-14,27.4 ( 0.37 %),398,816280,2050.95,427,1256830,2943,-440550
2013-03-13,27.3 ( -0.36 %),425,776540,1827.15,423,1153000,2726,-376460
2013-03-12,27.4 ( -0.36 %),512,1217770,2378.46,608,1883760,3098,-665990
2013-03-11,27.5 ( 2.61 %),722,1690820,2341.86,510,1281770,2513,409050
2013-03-08,26.8 ( 1.52 %),294,669620,2277.62,371,1040840,2805,-371220
2013-03-07,26.4 ( -1.12 %),520,1385340,2664.12,579,1483510,2562,-98170
2013-03-06,26.7 ( 4.71 %),517,1213280,2346.77,351,943010,2687,270270
2013-03-05,25.5 ( -2.67 %),759,1545020,2035.6,482,1344860,2790,200160
2013-03-04,26.2 ( -6.43 %),653,1113280,1704.87,463,1496060,3231,-382780
2013-03-01,28 ( 0.36 %),328,639560,1949.88,383,785220,2050,-145660
2013-02-28,27.9 ( 1.09 %),481,865070,1798.48,307,977930,3185,-112860
2013-02-27,27.6 ( -1.08 %),818,1705840,2085.38,455,1418730,3118,287110
2013-02-26,27.9 ( -6.69 %),755,1196550,1584.83,647,2117400,3273,-920850
2013-02-25,29.9 ( 1.7 %),349,803450,2302.15,491,1385640,2822,-582190
2013-02-22,29.4 ( 1.38 %),829,1994630,2406.07,748,2260530,3022,-265900
2013-02-21,29 ( -5.84 %),797,2082530,2612.96,1040,3305790,3179,-1223260
2013-02-20,30.8 ( 1.65 %),445,1123750,2525.28,540,1439680,2666,-315930
2013-02-19,30.3 ( 1 %),909,2692610,2962.17,991,3731570,3765,-1038960
2013-02-18,30 ( -1.32 %),453,725470,1601.48,345,1083490,3141,-358020
2013-02-08,30.4 ( -0.33 %),368,768410,2088.07,498,1139280,2288,-370870
2013-02-07,30.5 ( 3.04 %),538,1693630,3148.01,901,2642680,2933,-949050
2013-02-06,29.6 ( 5.71 %),390,1503110,3854.13,778,1413250,1817,89860
2013-02-05,28 ( -0.71 %),892,2410280,2702.11,527,2107440,3999,302840
2013-02-04,28.2 ( -2.42 %),633,1531620,2419.62,488,1813480,3716,-281860
2013-02-01,28.9 ( 0.35 %),698,1623810,2326.38,703,2085110,2966,-461300
2013-01-31,28.8 ( -3.03 %),688,1639440,2382.91,800,2523100,3154,-883660
2013-01-30,29.7 ( 0.34 %),489,1673640,3422.58,839,2357000,2809,-683360
2013-01-29,29.6 ( 2.07 %),458,1927270,4208.01,1081,3062280,2833,-1135010
2013-01-28,29 ( 0.35 %),880,2233730,2538.33,1143,3017370,2640,-783640
2013-01-25,28.9 ( 5.86 %),596,2980950,5001.59,1217,3296740,2709,-315790
2013-01-24,27.3 ( 6.23 %),510,1528160,2996.39,598,1166910,1951,361250
2013-01-23,25.7 ( -2.28 %),847,1884150,2224.5,646,1807810,2798,76340
2013-01-22,26.3 ( -3.66 %),740,1530290,2067.96,703,2187410,3112,-657120
2013-01-21,27.3 ( -2.5 %),577,1033620,1791.37,456,1279080,2805,-245460
2013-01-18,28 ( 1.08 %),789,2290460,2902.99,883,2725830,3087,-435370
2013-01-17,27.7 ( -3.15 %),810,2116480,2612.94,930,3195870,3436,-1079390
2013-01-16,28.6 ( 4.76 %),738,2410120,3265.75,945,3254910,3444,-844790
2013-01-15,27.3 ( 3.8 %),715,2175050,3042.03,735,2736310,3723,-561260
2013-01-14,26.3 ( -2.23 %),751,1609630,2143.32,732,2374890,3244,-765260
2013-01-11,26.9 ( 3.46 %),1102,3431800,3114.16,911,3717720,4081,-285920
2013-01-10,26 ( 4.84 %),843,3251230,3856.74,690,1752120,2539,1499110
2013-01-09,24.8 ( -3.88 %),1273,4343300,3411.86,988,4246950,4299,96350
2013-01-08,25.8 ( 4.88 %),1098,3542230,3226.07,706,3062500,4338,479730
2013-01-07,24.6 ( 4.68 %),1060,4130010,3896.24,714,3318340,4648,811670
2013-01-04,23.5 ( 3.98 %),605,2452450,4053.64,635,2017560,3177,434890
2013-01-03,22.6 ( 1.35 %),495,1400590,2829.47,624,1936130,3103,-535540
2013-01-02,22.3 ( 3.24 %),813,2533960,3116.8,469,2134850,4552,399110
2012-12-28,21.6 ( -0.46 %),335,684830,2044.27,258,778180,3016,-93350
2012-12-27,21.7 ( 0.46 %),469,1074320,2290.66,257,1033930,4023,40390
2012-12-26,21.6 ( -0.46 %),650,1688430,2597.58,287,1268310,4419,420120
2012-12-25,21.7 ( -0.46 %),247,544740,2205.43,280,775940,2771,-231200
2012-12-24,21.8 ( 0.46 %),378,860730,2277.06,282,955520,3388,-94790
2012-12-21,21.7 ( 0 %),426,2352460,5522.21,643,4047680,6295,-1695220
2012-12-20,21.7 ( -0.91 %),384,1412170,3677.53,474,1925870,4063,-513700
2012-12-19,21.9 ( 0.92 %),679,2838850,4180.93,549,3167140,5769,-328290
2012-12-18,21.7 ( -0.91 %),296,1128850,3813.68,510,1559630,3058,-430780
2012-12-17,21.9 ( 3.79 %),599,2345560,3915.79,606,1710390,2822,635170
2012-12-14,21.1 ( -1.4 %),335,1011840,3020.42,471,1487780,3159,-475940
2012-12-13,21.4 ( 2.88 %),636,1829360,2876.35,690,1635870,2371,193490
2012-12-12,20.8 ( 1.46 %),532,1508040,2834.66,517,1460800,2826,47240
2012-12-11,20.5 ( 3.54 %),575,2311560,4020.1,690,2172660,3149,138900
2012-12-10,19.8 ( 0 %),323,499790,1547.34,275,619700,2253,-119910
2012-12-07,19.8 ( 0 %),249,587700,2360.24,359,925920,2579,-338220
2012-12-06,19.8 ( 0.51 %),184,369180,2006.41,238,564970,2374,-195790
2012-12-05,19.7 ( 1.03 %),246,437830,1779.8,359,720400,2007,-282570
2012-12-04,19.5 ( 0.52 %),567,1195480,2108.43,308,1255030,4075,-59550
2012-12-03,19.4 ( -2.02 %),325,675980,2079.94,268,1033380,3856,-357400
2012-11-30,19.8 ( 0 %),312,974340,3122.88,408,1629510,3994,-655170
2012-11-29,19.8 ( 0 %),197,467640,2373.81,324,871690,2690,-404050
2012-11-28,19.8 ( -1.49 %),237,550840,2324.22,394,1091380,2770,-540540
2012-11-27,20.1 ( -0.99 %),203,550230,2710.49,407,990270,2433,-440040
2012-11-26,20.3 ( 1 %),613,1550630,2529.58,345,1161350,3366,389280
2012-11-23,20.1 ( -0.99 %),313,619490,1979.2,418,951410,2276,-331920
2012-11-22,20.3 ( 0 %),292,738290,2528.39,451,1120700,2485,-382410
2012-11-21,20.3 ( 1.5 %),377,1229270,3260.66,516,1320800,2560,-91530
2012-11-20,20 ( 4.17 %),526,1222140,2323.46,446,1238230,2776,-16090
2012-11-19,19.2 ( -4.95 %),493,818100,1659.43,250,1245610,4982,-427510
2012-11-16,20.2 ( 0 %),202,245800,1216.83,149,484390,3251,-238590
2012-11-15,20.2 ( 1.51 %),371,1152300,3105.93,370,866980,2343,285320
2012-11-14,19.9 ( -1.97 %),550,874270,1589.58,276,1036930,3757,-162660
2012-11-13,20.3 ( -1.93 %),195,314340,1612,269,521810,1940,-207470
2012-11-12,20.7 ( 2.99 %),310,731480,2359.61,283,687040,2428,44440
2012-11-09,20.1 ( -4.29 %),418,705230,1687.15,273,803340,2943,-98110
2012-11-08,21 ( 3.45 %),136,418020,3073.68,272,690200,2538,-272180
2012-11-07,20.3 ( 2.01 %),247,513610,2079.39,173,502100,2902,11510
2012-11-06,19.9 ( -0.5 %),136,203520,1496.47,131,192220,1467,11300
2012-11-05,20 ( 0.5 %),192,420940,2192.4,138,205510,1489,215430
2012-11-02,19.9 ( -4.78 %),339,515850,1521.68,254,632750,2491,-116900
2012-11-01,20.9 ( 0.48 %),137,190250,1388.69,116,200030,1724,-9780
2012-10-31,20.8 ( 0.48 %),294,649420,2208.91,148,293420,1983,356000
2012-10-30,20.7 ( -0.48 %),167,310150,1857.19,137,292590,2136,17560
2012-10-29,20.8 ( -0.95 %),255,480340,1883.69,151,271740,1800,208600
2012-10-26,21 ( 0.96 %),214,231160,1080.19,114,273380,2398,-42220
2012-10-25,20.8 ( -1.42 %),198,314980,1590.81,117,258560,2210,56420
2012-10-24,21.1 ( -0.94 %),198,283070,1429.65,179,380820,2127,-97750
2012-10-23,21.3 ( 0 %),198,303690,1533.79,135,243460,1803,60230
2012-10-22,21.3 ( 0 %),392,586730,1496.76,185,488590,2641,98140
2012-10-19,21.3 ( -4.48 %),357,582330,1631.18,267,949360,3556,-367030
2012-10-18,22.3 ( -1.76 %),195,409040,2097.64,197,693020,3518,-283980
2012-10-17,22.7 ( -0.44 %),197,430970,2187.66,293,650160,2219,-219190
2012-10-16,22.8 ( 1.33 %),317,811070,2558.58,372,908110,2441,-97040
2012-10-15,22.5 ( -0.44 %),169,630100,3728.4,286,733920,2566,-103820
2012-10-12,22.6 ( 0.44 %),218,919780,4219.17,332,861960,2596,57820
2012-10-11,22.5 ( 0.9 %),321,736810,2295.36,338,856660,2534,-119850
2012-10-10,22.3 ( -0.45 %),213,413810,1942.77,282,621000,2202,-207190
2012-10-09,22.4 ( 0.9 %),386,1134810,2939.92,491,1157290,2357,-22480
2012-10-08,22.2 ( 4.72 %),519,1885500,3632.95,367,1150390,3135,735110
2012-10-05,21.2 ( 2.42 %),417,2044090,4901.89,301,1380210,4585,663880
2012-10-04,20.7 ( -0.96 %),268,907530,3386.31,251,845490,3368,62040
2012-10-03,20.9 ( 2.96 %),438,1285140,2934.11,256,879100,3434,406040
2012-10-02,20.3 ( 0 %),316,1176690,3723.7,218,831160,3813,345530
2012-10-01,20.3 ( -0.49 %),297,838430,2823,185,730550,3949,107880
2012-09-28,20.4 ( -2.39 %),498,738220,1482.37,237,699840,2953,38380
2012-09-27,20.9 ( -4.13 %),444,680590,1532.86,249,856500,3440,-175910
2012-09-26,21.8 ( 0.46 %),473,975600,2062.58,214,848080,3963,127520
2012-09-25,21.7 ( -3.12 %),330,485030,1469.79,283,848380,2998,-363350
2012-09-24,22.4 ( -4.68 %),315,597640,1897.27,229,1194710,5217,-597070
2012-09-21,23.5 ( 3.98 %),462,1114350,2412.01,290,1530200,5277,-415850
2012-09-20,22.6 ( -3 %),423,864160,2042.93,246,1065430,4331,-201270
2012-09-19,23.3 ( -0.85 %),376,958650,2549.6,259,968430,3739,-9780
2012-09-18,23.5 ( -1.67 %),284,614100,2162.32,265,861810,3252,-247710
2012-09-17,23.9 ( -0.42 %),321,638300,1988.47,219,911110,4160,-272810
2012-09-14,24 ( 1.27 %),430,893320,2077.49,307,1144370,3728,-251050
2012-09-13,23.7 ( -0.42 %),261,315980,1210.65,190,447180,2354,-131200
2012-09-12,23.8 ( 0.85 %),302,461420,1527.88,212,616290,2907,-154870
2012-09-11,23.6 ( -4.45 %),597,1244340,2084.32,297,1550260,5220,-305920
2012-09-10,24.7 ( -4.63 %),503,771930,1534.65,295,2000370,6781,-1228440
2012-09-07,25.9 ( -0.38 %),254,356510,1403.58,208,523140,2515,-166630
2012-09-06,26 ( -1.14 %),325,624000,1920,277,846940,3058,-222940
2012-09-05,26.3 ( -0.75 %),537,1545330,2877.71,535,1572790,2940,-27460
2012-09-04,26.5 ( -0.75 %),237,453760,1914.6,277,850660,3071,-396900
2012-08-31,26.7 ( 2.69 %),499,1472460,2950.82,440,1527210,3471,-54750
2012-08-30,26 ( 4.84 %),476,1646400,3458.82,301,1098780,3650,547620
2012-08-29,24.8 ( 0.4 %),647,1262770,1951.73,428,1306450,3052,-43680
2012-08-28,24.7 ( -4.63 %),460,949510,2064.15,454,1417700,3123,-468190
2012-08-27,25.9 ( -4.78 %),208,242320,1165,248,1303110,5254,-1060790
2012-08-24,27.2 ( -0.37 %),717,1581290,2205.43,421,2036140,4836,-454850
2012-08-23,27.3 ( -4.88 %),188,388190,2064.84,215,1129100,5252,-740910
2012-08-22,28.7 ( -0.69 %),475,971040,2044.29,285,829000,2909,142040
2012-08-21,28.9 ( -4.93 %),397,1282200,3229.72,416,2003890,4817,-721690
2012-08-20,30.4 ( 2.36 %),299,1067550,3570.4,422,845630,2004,221920
2012-08-17,29.7 ( 2.41 %),292,851480,2916.03,282,687260,2437,164220
2012-08-16,29 ( -0.68 %),146,219620,1504.25,132,322260,2441,-102640
2012-08-15,29.2 ( 0 %),157,340040,2165.86,143,330820,2313,9220
2012-08-14,29.2 ( -0.34 %),172,336540,1956.63,148,286710,1937,49830
2012-08-13,29.3 ( -1.35 %),122,230660,1890.66,178,349220,1962,-118560
2012-08-10,29.7 ( -0.67 %),153,426410,2786.99,335,582820,1740,-156410
2012-08-09,29.9 ( 1.7 %),229,687710,3003.1,404,690700,1710,-2990
2012-08-08,29.4 ( 1.38 %),150,487620,3250.8,214,374120,1748,113500
2012-08-07,29 ( -0.34 %),147,484280,3294.42,198,381980,1929,102300
2012-08-06,29.1 ( 1.04 %),247,763990,3093.08,217,500410,2306,263580
2012-08-03,28.8 ( -0.35 %),189,363650,1924.07,142,411240,2896,-47590
2012-08-02,28.9 ( -0.69 %),177,642580,3630.4,142,440320,3101,202260
2012-08-01,29.1 ( -0.34 %),231,753130,3260.3,210,530990,2529,222140
2012-07-31,29.2 ( -1.35 %),139,317380,2283.31,197,361270,1834,-43890
2012-07-30,29.6 ( 0 %),194,508780,2622.58,194,339260,1749,169520
2012-07-27,29.6 ( 0.34 %),217,806060,3714.56,489,1291140,2640,-485080
2012-07-26,29.5 ( 0.34 %),199,853950,4291.21,241,486980,2021,366970
2012-07-25,29.4 ( -0.34 %),400,1049310,2623.28,257,804560,3131,244750
2012-07-24,29.5 ( 0 %),217,872430,4020.41,336,862910,2568,9520
2012-07-23,29.5 ( -0.34 %),375,1119540,2985.44,284,654280,2304,465260
2012-07-20,29.6 ( -4.82 %),354,889680,2513.22,872,2012400,2308,-1122720
2012-07-19,31.1 ( 4.71 %),432,2066420,4783.38,832,1743810,2096,322610
2012-07-18,29.7 ( 0.68 %),244,1281860,5253.52,641,1410270,2200,-128410
2012-07-17,29.5 ( 1.72 %),207,934340,4513.72,380,841270,2214,93070
2012-07-16,29 ( 0 %),150,596280,3975.2,389,816590,2099,-220310
2012-07-13,29 ( 2.11 %),237,1166870,4923.5,497,988680,1989,178190
2012-07-12,28.4 ( 0 %),142,559510,3940.21,257,594660,2314,-35150
2012-07-10,28 ( 0 %),179,808720,4517.99,379,1036590,2735,-227870
2012-07-09,28 ( -1.75 %),155,717720,4630.45,391,1048260,2681,-330540
2012-07-06,28.5 ( 2.52 %),215,849330,3950.37,415,814880,1964,34450
2012-07-05,27.8 ( 0.72 %),175,711470,4065.54,174,431040,2477,280430
2012-07-04,27.6 ( 0 %),165,451390,2735.7,206,371380,1803,80010
2012-07-03,27.6 ( -0.72 %),166,574730,3462.23,253,526460,2081,48270
2012-07-02,27.8 ( 0 %),148,388110,2622.36,243,496170,2042,-108060
2012-06-29,27.8 ( 0 %),172,509200,2960.47,450,1037500,2306,-528300
2012-06-28,27.8 ( 1.46 %),122,496830,4072.38,295,516490,1751,-19660
2012-06-27,27.4 ( 1.86 %),308,1017010,3301.98,319,775950,2432,241060
2012-06-26,26.9 ( -1.82 %),276,549400,1990.58,204,520180,2550,29220
2012-06-25,27.4 ( -3.52 %),309,608430,1969.03,244,818380,3354,-209950
2012-06-22,28.4 ( -0.35 %),353,1458190,4130.85,367,1622530,4421,-164340
2012-06-21,28.5 ( -1.04 %),312,929260,2978.4,281,665750,2369,263510
2012-06-20,0 ( 0 %),189,317650,1680.69,263,496590,1888,-178940
2012-06-19,28.9 ( -1.03 %),196,660660,3370.71,466,1131300,2428,-470640
2012-06-18,29.2 ( 0 %),253,795480,3144.19,711,1191550,1676,-396070
2012-06-15,29.2 ( 4.29 %),292,2406440,8241.23,803,2274480,2832,131960
2012-06-14,28 ( 0 %),140,526710,3762.21,384,745810,1942,-219100
2012-06-13,28 ( 0 %),194,859150,4428.61,435,995800,2289,-136650
2012-06-12,28 ( 0.36 %),269,1147090,4264.28,623,1208410,1940,-61320
2012-06-11,27.9 ( 0.36 %),268,846230,3157.57,594,1123580,1892,-277350
2012-06-08,27.8 ( 0 %),329,1238300,3763.83,803,1925990,2398,-687690
2012-06-07,27.8 ( 0.36 %),399,1293560,3242.01,757,1981920,2618,-688360
2012-06-06,27.7 ( 4.14 %),303,1351180,4459.34,906,1441710,1591,-90530
2012-06-05,26.6 ( 4.72 %),511,2097070,4103.86,518,1464910,2828,632160
2012-06-04,25.4 ( -4.51 %),670,2302030,3435.87,858,2577260,3004,-275230
2012-06-01,26.6 ( -0.37 %),366,717890,1961.45,313,635570,2031,82320
2012-05-31,26.7 ( -2.2 %),559,894580,1600.32,401,999490,2492,-104910
2012-05-30,27.3 ( 0 %),443,728350,1644.13,284,633680,2231,94670
2012-05-29,27.3 ( -1.8 %),552,1235400,2238.04,379,1037710,2738,197690
2012-05-28,27.8 ( -0.36 %),343,704630,2054.31,444,1112470,2506,-407840
2012-05-25,27.9 ( 1.82 %),640,1429120,2233,416,1584030,3808,-154910
2012-05-24,27.4 ( -0.72 %),668,1685700,2523.5,409,1556220,3805,129480
2012-05-23,27.6 ( -2.13 %),777,2194630,2824.49,490,1922430,3923,272200
2012-05-22,28.2 ( -2.76 %),559,1182660,2115.67,503,1670460,3321,-487800
2012-05-21,29 ( 4.69 %),752,1862580,2476.84,362,1202300,3321,660280
2012-05-18,27.7 ( -1.07 %),992,3296880,3323.47,718,2749810,3830,547070
2012-05-17,28 ( -2.44 %),652,1365620,2094.51,314,1567800,4993,-202180
2012-05-16,28.7 ( 1.77 %),765,1719060,2247.14,530,1367140,2580,351920
2012-05-15,28.2 ( -3.09 %),941,2446040,2599.4,567,2117360,3734,328680
2012-05-14,29.1 ( -4.9 %),925,2113020,2284.35,807,2441510,3025,-328490
2012-05-11,30.6 ( -4.67 %),607,1820070,2998.47,1397,3120640,2234,-1300570
2012-05-10,32.1 ( 2.88 %),788,2354380,2987.79,1263,2900780,2297,-546400
2012-05-09,31.2 ( 4.7 %),836,3790970,4534.65,1216,2718500,2236,1072470
2012-05-08,29.8 ( 4.93 %),964,4112980,4266.58,1241,2818160,2271,1294820
2012-05-07,28.4 ( 0.35 %),900,1660530,1845.03,789,1837880,2329,-177350
2012-05-04,28.3 ( 0.35 %),451,880760,1952.9,615,1459820,2374,-579060
2012-05-03,28.2 ( 0.36 %),615,1199160,1949.85,503,1286370,2557,-87210
2012-05-02,28.1 ( -1.4 %),737,1549800,2102.85,535,1761720,3293,-211920
2012-04-27,28.5 ( 0.71 %),898,1659460,1847.95,455,1305020,2868,354440
2012-04-26,28.3 ( -3.74 %),1327,1931850,1455.8,741,2370570,3199,-438720
2012-04-25,29.4 ( 2.44 %),811,1551120,1912.6,615,1897650,3086,-346530
2012-04-24,28.7 ( 4.74 %),1234,2360540,1912.92,495,1480010,2990,880530
2012-04-23,31.5 ( 2.27 %),597,1605150,2688.69,844,2133580,2528,-528430
2012-04-20,30.8 ( 1.99 %),996,2135060,2143.63,743,2087350,2809,47710
2012-04-19,30.2 ( -4.73 %),1249,2539430,2033.17,841,3052520,3630,-513090
2012-04-18,31.7 ( -0.31 %),896,2611060,2914.13,978,2726790,2788,-115730
2012-04-17,31.8 ( -0.62 %),1039,2092950,2014.39,896,2621000,2925,-528050
2012-04-16,32 ( 4.23 %),897,2050010,2285.41,727,1761680,2423,288330
2012-04-13,30.7 ( -1.92 %),1235,2425880,1964.28,860,2455440,2855,-29560
2012-04-12,31.3 ( -1.26 %),970,2118280,2183.79,989,2828750,2860,-710470
2012-04-11,31.7 ( 4.97 %),1205,3449420,2862.59,993,3388660,3413,60760
2012-04-10,30.2 ( -2.89 %),773,1824980,2360.91,1048,2582940,2465,-757960
2012-04-09,31.1 ( 2.3 %),689,1854170,2691.1,1030,1890780,1836,-36610
2012-04-06,30.4 ( 4.83 %),1209,4564260,3775.24,1628,3453790,2121,1110470
2012-04-05,29 ( 4.69 %),940,3929240,4180.04,997,2165270,2172,1763970
2012-04-04,27.7 ( -1.42 %),610,1100100,1803.44,602,1216820,2021,-116720
2012-04-03,28.1 ( 4.46 %),952,1776050,1865.6,565,1310970,2320,465080
2012-03-30,26.9 ( -1.47 %),1101,1831330,1663.33,483,1828160,3785,3170
2012-03-29,27.3 ( -3.19 %),1387,2435530,1755.97,567,2185480,3854,250050
2012-03-28,28.2 ( 0 %),1263,2063060,1633.46,532,1460710,2746,602350
2012-03-27,28.2 ( -4.73 %),1103,1785590,1618.85,744,2712530,3646,-926940
2012-03-26,29.6 ( -2.31 %),1129,1928910,1708.51,776,2349870,3028,-420960
2012-03-23,30.3 ( 1 %),756,1813170,2398.37,969,2372930,2449,-559760
2012-03-22,30 ( 3.09 %),747,1871720,2505.65,1028,1968150,1915,-96430
2012-03-21,29.1 ( 0 %),822,2652620,3227.03,915,1946490,2127,706130
2012-03-20,29.1 ( 3.56 %),708,1697560,2397.68,709,1496450,2111,201110
2012-03-19,28.1 ( -0.71 %),955,2387620,2500.13,629,1692150,2690,695470
2012-03-16,28.3 ( -4.71 %),1146,2854930,2491.21,797,3257640,4087,-402710
2012-03-15,29.7 ( 2.77 %),1759,3425690,1947.52,1074,3125730,2910,299960
2012-03-14,28.9 ( -1.03 %),844,2174430,2576.34,652,2514600,3857,-340170
2012-03-13,29.2 ( 0.34 %),1469,3157120,2149.16,1021,3230590,3164,-73470
2012-03-12,29.1 ( -4.9 %),378,598840,1584.23,736,2507960,3408,-1909120
2012-03-09,30.6 ( -4.97 %),948,1775630,1873.03,943,3357260,3560,-1581630
2012-03-08,32.2 ( -4.73 %),861,1999860,2322.72,808,3729350,4616,-1729490
2012-03-07,33.8 ( 2.74 %),1080,2468420,2285.57,907,2598150,2865,-129730
2012-03-06,32.9 ( -0.3 %),1473,3903380,2649.95,1425,4437050,3114,-533670
2012-03-05,33 ( 4.76 %),788,2499100,3171.45,276,1050200,3805,1448900
2012-03-02,31.5 ( 4.3 %),802,2428100,3027.56,724,1860570,2570,567530
2012-03-01,30.2 ( 4.14 %),515,1640620,3185.67,705,1657990,2352,-17370
2012-02-29,29 ( 1.4 %),716,2121400,2962.85,636,1902450,2991,218950
2012-02-28,28.6 ( -1.04 %),931,2583910,2775.41,829,2496480,3011,87430
2012-02-27,28.9 ( 4.71 %),712,2507480,3521.74,611,1373270,2248,1134210
2012-02-24,27.6 ( 0 %),911,2359550,2590.07,741,2306210,3112,53340
2012-02-23,27.6 ( 4.94 %),655,2523480,3852.64,601,1750280,2912,773200
2012-02-22,26.3 ( 4.78 %),646,2027190,3138.07,647,1180080,1824,847110
2012-02-21,25.1 ( 0.4 %),755,2300650,3047.22,997,2763390,2772,-462740
2012-02-20,25 ( 4.6 %),605,1999080,3304.26,664,1717910,2587,281170
2012-02-17,23.9 ( 3.02 %),325,709450,2182.92,345,727680,2109,-18230
2012-02-16,23.2 ( -1.28 %),424,995480,2347.83,359,1110190,3092,-114710
2012-02-15,23.5 ( 0 %),406,983480,2422.36,588,1247100,2121,-263620
2012-02-14,23.5 ( 4.91 %),670,1466950,2189.48,415,791860,1908,675090
2012-02-13,22.4 ( -4.27 %),534,953840,1786.22,438,1088850,2486,-135010
2012-02-10,23.4 ( -4.49 %),489,952440,1947.73,552,1242010,2250,-289570
2012-02-09,24.5 ( -0.41 %),443,910380,2055.03,651,1286180,1976,-375800
2012-02-08,24.6 ( 4.68 %),583,1229190,2108.39,487,949390,1949,279800
2012-02-07,23.5 ( -2.08 %),888,1642320,1849.46,738,1882500,2551,-240180
2012-02-06,24 ( -3.61 %),556,934750,1681.21,804,1416130,1761,-481380
2012-02-03,24.9 ( 4.62 %),726,2475470,3409.74,802,1925950,2401,549520
2012-02-02,23.8 ( 4.85 %),652,1425070,2185.69,390,884770,2269,540300
2012-02-01,22.7 ( 4.61 %),782,2277370,2912.24,865,1836140,2123,441230
2012-01-31,21.7 ( 4.83 %),634,2431870,3835.76,488,1428650,2928,1003220
2012-01-30,20.7 ( 4.55 %),359,1037210,2889.16,428,714810,1670,322400
2012-01-20,19.8 ( 3.13 %),292,1109130,3798.39,611,1189170,1946,-80040
2012-01-19,19.2 ( 4.92 %),332,1258170,3789.67,352,767050,2179,491120
2012-01-18,18.3 ( 0 %),286,533240,1864.48,256,533300,2083,-60
2012-01-17,18.3 ( -1.61 %),263,573080,2179.01,356,903430,2538,-330350
2012-01-16,18.6 ( 1.64 %),336,1263060,3759.11,426,966400,2269,296660
2012-01-13,18.3 ( 2.81 %),355,966370,2722.17,327,783160,2395,183210
2012-01-12,17.8 ( -2.73 %),342,1148370,3357.81,375,1275190,3401,-126820
2012-01-11,18.3 ( 0 %),398,1033670,2597.16,348,1148210,3299,-114540
2012-01-10,18.3 ( 1.67 %),474,1383430,2918.63,336,1263590,3761,119840
2012-01-09,18 ( 2.86 %),492,1573510,3198.19,471,1381600,2933,191910
2012-01-06,17.5 ( -3.85 %),480,762390,1588.31,316,678180,2146,84210
2012-01-05,18.2 ( -4.21 %),352,444840,1263.75,312,808100,2590,-363260
2012-01-04,19 ( 0 %),358,681360,1903.24,428,780200,1823,-98840
2012-01-03,19 ( -2.56 %),330,570880,1729.94,400,1060970,2652,-490090
2011-12-30,19.5 ( 2.63 %),735,1624930,2210.79,595,1972990,3316,-348060
2011-12-29,19 ( 4.97 %),545,1734870,3183.25,86,199770,2323,1535100
2011-12-28,18.1 ( 4.62 %),597,1804780,3023.08,104,306890,2951,1497890
2011-12-27,17.3 ( -4.95 %),372,563880,1515.81,410,1076700,2626,-512820
2011-12-26,18.2 ( -4.71 %),495,597390,1206.85,349,1104100,3164,-506710
2011-12-23,19.1 ( -4.5 %),661,1172300,1773.52,306,1073590,3508,98710
2011-12-22,20 ( -4.76 %),600,888140,1480.23,336,1940600,5776,-1052460
2011-12-21,21 ( -2.78 %),498,814750,1636.04,224,1036520,4627,-221770
2011-12-20,21.6 ( -3.14 %),338,536640,1587.69,328,762650,2325,-226010
2011-12-19,22.3 ( 0.45 %),416,1365010,3281.27,744,1645250,2211,-280240
2011-12-16,22.2 ( 4.72 %),294,1624500,5525.51,253,526990,2083,1097510
2011-12-15,21.2 ( -1.85 %),393,1169660,2976.23,450,1193490,2652,-23830
2011-12-14,21.6 ( -1.82 %),351,954520,2719.43,486,1414090,2910,-459570
2011-12-13,22 ( 0 %),287,836470,2914.53,441,1094840,2483,-258370
2011-12-12,22 ( 0 %),312,679260,2177.12,299,791390,2647,-112130
2011-12-09,22 ( -3.51 %),920,1670710,1815.99,495,1833480,3704,-162770
2011-12-08,22.8 ( -4.2 %),693,1302190,1879.06,408,1336890,3277,-34700
2011-12-07,23.8 ( -0.83 %),354,629640,1778.64,399,620680,1556,8960
2011-12-06,24 ( -0.41 %),606,1383300,2282.67,633,1829910,2891,-446610
2011-12-05,24.1 ( 4.78 %),641,1987620,3100.81,467,1299820,2783,687800
2011-12-02,23 ( 3.6 %),499,1590610,3187.6,525,1298460,2473,292150
2011-12-01,22.2 ( -0.45 %),335,566190,1690.12,267,680080,2547,-113890
2011-11-30,22.3 ( -0.45 %),256,542540,2119.3,320,846260,2645,-303720
2011-11-29,22.4 ( 0 %),268,697330,2601.98,315,842050,2673,-144720
2011-11-28,22.4 ( 0.45 %),392,776290,1980.33,348,929910,2672,-153620
2011-11-25,22.3 ( 0 %),306,406950,1329.9,233,386610,1659,20340
2011-11-24,22.3 ( -2.19 %),464,924080,1991.55,354,1045560,2954,-121480
2011-11-23,22.8 ( 1.33 %),452,748070,1655.02,334,827590,2478,-79520
2011-11-22,22.5 ( 0 %),570,1016190,1782.79,326,831150,2550,185040
2011-11-21,22.5 ( -1.75 %),303,657030,2168.42,255,529410,2076,127620
2011-11-18,22.9 ( -2.55 %),424,895500,2112.03,393,938600,2388,-43100
2011-11-17,23.5 ( 1.73 %),767,1286910,1677.85,630,1395720,2215,-108810
2011-11-16,23.1 ( 5 %),959,2141220,2232.76,496,2141640,4318,-420
2011-11-15,22 ( -2.65 %),620,887720,1431.81,296,1029780,3479,-142060
2011-11-14,22.6 ( -3.42 %),405,602830,1488.47,321,640140,1994,-37310
2011-11-11,23.4 ( -4.88 %),441,448490,1016.98,267,563110,2109,-114620
2011-11-10,24.6 ( -3.15 %),348,392650,1128.3,237,360060,1519,32590
2011-11-09,25.4 ( -1.55 %),500,606710,1213.42,317,540060,1704,66650
2011-11-08,25.8 ( -2.64 %),780,1342520,1721.18,507,1120220,2210,222300
2011-11-07,26.5 ( -4.68 %),654,956100,1461.93,336,1342980,3997,-386880
2011-11-04,27.8 ( -0.36 %),279,367460,1317.06,285,437380,1535,-69920
2011-11-03,27.9 ( -1.41 %),467,652210,1396.6,241,637830,2647,14380
2011-11-02,28.3 ( -3.08 %),359,398460,1109.92,209,478780,2291,-80320
2011-11-01,29.2 ( -1.02 %),298,416440,1397.45,347,530920,1530,-114480
2011-10-31,29.5 ( -2.96 %),328,510760,1557.2,335,714250,2132,-203490
2011-10-28,30.4 ( 4.83 %),478,949820,1987.07,402,772790,1922,177030
2011-10-27,29 ( 1.75 %),366,451590,1233.85,230,354250,1540,97340
2011-10-26,28.5 ( -3.06 %),501,580450,1158.58,307,730650,2380,-150200
2011-10-25,29.4 ( -1.01 %),221,372610,1686.02,239,526930,2205,-154320
2011-10-24,29.7 ( -0.34 %),290,290190,1000.66,231,511800,2216,-221610
2011-10-21,29.8 ( 0.34 %),569,960830,1688.63,313,988880,3159,-28050
2011-10-20,29.7 ( -0.67 %),332,687520,2070.84,226,702670,3109,-15150
2011-10-19,29.9 ( -0.33 %),320,737570,2304.91,232,788300,3398,-50730
2011-10-18,30 ( -1.96 %),346,672800,1944.51,238,575560,2418,97240
2011-10-17,30.6 ( -0.33 %),235,336600,1432.34,205,370390,1807,-33790
2011-10-14,30.7 ( 0.66 %),242,328040,1355.54,195,295260,1514,32780
2011-10-13,30.5 ( 0 %),353,510530,1446.26,228,511980,2246,-1450
2011-10-12,30.5 ( -2.24 %),352,497020,1411.99,297,681000,2293,-183980
2011-10-11,31.2 ( 0 %),274,424690,1549.96,201,441760,2198,-17070
2011-10-10,31.2 ( 0 %),411,573490,1395.35,242,517980,2140,55510
2011-10-07,31.2 ( -1.27 %),435,542530,1247.2,213,640250,3006,-97720
2011-10-06,31.6 ( 0.64 %),496,805500,1623.99,237,715390,3019,90110
2011-10-05,31.4 ( -0.32 %),374,472340,1262.94,191,544810,2852,-72470
2011-10-04,31.5 ( -0.94 %),382,607760,1590.99,298,599510,2012,8250
2011-10-03,31.8 ( -1.55 %),333,658530,1977.57,287,702960,2449,-44430
2011-09-30,32.3 ( 0.31 %),616,1123200,1823.38,335,900420,2688,222780
2011-09-29,32.2 ( -2.13 %),747,888080,1188.86,320,1019840,3187,-131760
2011-09-28,32.9 ( -1.5 %),966,1328420,1375.18,428,1770360,4136,-441940
2011-09-27,33.4 ( -0.6 %),560,843030,1505.41,254,785960,3094,57070
2011-09-26,33.6 ( -1.18 %),560,790740,1412.04,275,702940,2556,87800
2011-09-23,34 ( -1.45 %),428,752440,1758.04,259,632240,2441,120200
2011-09-22,34.5 ( 1.17 %),783,1436530,1834.65,327,1464210,4478,-27680
2011-09-21,34.1 ( -1.73 %),555,814330,1467.26,400,1284620,3212,-470290
2011-09-20,34.7 ( 0 %),686,1450760,2114.81,477,1568280,3288,-117520
2011-09-19,34.7 ( 4.83 %),624,1386620,2222.15,315,518520,1646,868100
2011-09-16,33.1 ( -4.89 %),836,1984090,2373.31,354,1973100,5574,10990
2011-09-15,34.8 ( -3.06 %),813,1742020,2142.71,317,1918710,6053,-176690
2011-09-14,35.9 ( -2.71 %),452,981610,2171.7,426,1233890,2896,-252280
2011-09-13,36.9 ( -0.54 %),631,1288550,2042.08,421,1167620,2773,120930
2011-09-12,37.1 ( 1.92 %),427,1024420,2399.11,607,1124750,1853,-100330
2011-09-09,36.4 ( 1.39 %),304,945530,3110.3,519,931390,1795,14140
2011-09-08,35.9 ( 2.87 %),476,1454380,3055.42,575,1589470,2764,-135090
2011-09-07,34.9 ( 2.35 %),268,365510,1363.84,155,401940,2593,-36430
2011-09-06,34.1 ( -2.01 %),419,660520,1576.42,265,730710,2757,-70190
2011-09-05,34.8 ( -2.25 %),315,643810,2043.84,264,733220,2777,-89410
2011-09-01,35.6 ( -0.56 %),583,1256630,2155.45,316,733070,2320,523560
2011-08-31,35.8 ( -0.28 %),344,820660,2385.64,423,819150,1937,1510
2011-08-30,35.9 ( 0.56 %),265,486170,1834.6,390,645840,1656,-159670
2011-08-29,35.7 ( 5 %),176,517680,2941.36,314,345720,1101,171960
2011-08-26,34 ( 1.49 %),174,281690,1618.91,202,182640,904,99050
2011-08-25,33.5 ( 0.3 %),352,379800,1078.98,132,244940,1856,134860
2011-08-24,33.4 ( -4.3 %),337,711990,2112.73,222,678600,3057,33390
2011-08-23,34.9 ( -0.85 %),186,427970,2300.91,214,453120,2117,-25150
2011-08-22,35.2 ( 1.15 %),216,404130,1870.97,327,545950,1670,-141820
2011-08-19,34.8 ( -0.85 %),237,519320,2191.22,412,481070,1168,38250
2011-08-18,35.1 ( 3.24 %),212,562670,2654.1,367,602430,1641,-39760
2011-08-17,34 ( 4.94 %),180,358760,1993.11,242,271420,1122,87340
2011-08-16,32.4 ( 0.93 %),150,247380,1649.2,182,262750,1444,-15370
2011-08-15,32.1 ( 0.63 %),142,205290,1445.7,151,161920,1072,43370
2011-08-12,31.9 ( -0.62 %),178,307820,1729.33,144,254920,1770,52900
2011-08-11,32.1 ( -0.62 %),206,290420,1409.81,162,249270,1539,41150
2011-08-10,32.3 ( 0.94 %),276,836850,3032.07,215,587160,2731,249690
2011-08-09,32 ( -3.9 %),304,689740,2268.88,220,472630,2148,217110
2011-08-08,33.3 ( -2.63 %),262,378430,1444.39,185,364410,1970,14020
2011-08-05,34.2 ( 0.59 %),180,194700,1081.67,211,194160,920,540
2011-08-04,34 ( 0.29 %),385,603060,1566.39,227,431060,1899,172000
2011-08-03,33.9 ( -0.29 %),211,411710,1951.23,219,334610,1528,77100
2011-08-02,34 ( -2.02 %),311,788960,2536.85,262,699940,2672,89020
2011-08-01,34.7 ( 0.58 %),257,576630,2243.7,205,469370,2290,107260
2011-07-29,34.5 ( -3.9 %),313,429140,1371.05,203,575660,2836,-146520
2011-07-28,35.9 ( 0 %),204,407470,1997.4,246,407550,1657,-80
2011-07-27,35.9 ( 0 %),658,991060,1506.17,286,943090,3298,47970
2011-07-26,35.9 ( -0.55 %),236,249570,1057.5,123,91960,748,157610
2011-07-25,36.1 ( -0.28 %),154,336560,2185.45,330,437190,1325,-100630
2011-07-22,36.2 ( 0.56 %),250,477170,1908.68,212,332400,1568,144770
2011-07-21,36 ( -1.91 %),174,235810,1355.23,221,310600,1405,-74790
2011-07-20,36.7 ( 4.86 %),199,503760,2531.46,178,296290,1665,207470
2011-07-19,35 ( -3.58 %),202,174240,862.57,146,229910,1575,-55670
2011-07-18,36.3 ( -1.09 %),130,263160,2024.31,121,173010,1430,90150
2011-07-15,36.7 ( 0.55 %),129,314570,2438.53,226,372070,1646,-57500
2011-07-14,36.5 ( 1.39 %),208,518300,2491.83,223,492700,2209,25600
2011-07-13,36 ( 4.65 %),464,852280,1836.81,190,638420,3360,213860
2011-07-12,34.4 ( -3.37 %),413,550630,1333.24,150,371300,2475,179330
2011-07-11,35.6 ( -4.81 %),307,287820,937.52,118,334500,2835,-46680
2011-07-08,37.4 ( -2.09 %),209,207530,992.97,139,220830,1589,-13300
2011-07-07,38.2 ( 0.53 %),150,187360,1249.07,113,187100,1656,260
2011-07-06,38 ( -2.56 %),111,263400,2372.97,169,389400,2304,-126000
2011-07-05,39 ( 3.45 %),180,229130,1272.94,100,287450,2874,-58320
2011-07-04,37.7 ( -1.05 %),274,421240,1537.37,142,422870,2978,-1630
2011-07-01,38.1 ( -2.31 %),256,346370,1353.01,168,373010,2220,-26640
2011-06-30,39 ( -1.52 %),252,251280,997.14,144,316220,2196,-64940
2011-06-29,39.6 ( 0 %),233,505220,2168.33,172,623760,3627,-118540
2011-06-28,39.6 ( -1 %),284,455170,1602.71,157,386740,2463,68430
2011-06-27,40 ( -3.15 %),217,217490,1002.26,158,331670,2099,-114180
2011-06-24,41.3 ( -1.67 %),190,248650,1308.68,198,454110,2293,-205460
2011-06-23,42 ( -2.1 %),188,319440,1699.15,229,448180,1957,-128740
2011-06-22,42.9 ( 0.23 %),215,622070,2893.35,443,1119600,2527,-497530
2011-06-21,42.8 ( 4.39 %),253,1013090,4004.31,418,814820,1949,198270
2011-06-20,41 ( -2.38 %),182,377570,2074.56,363,603970,1664,-226400
2011-06-17,42 ( 4.48 %),289,1466170,5073.25,744,1379530,1854,86640
2011-06-16,40.2 ( 1.26 %),206,736000,3572.82,353,684260,1938,51740
2011-06-15,39.7 ( -0.75 %),162,554190,3420.93,433,838030,1935,-283840
2011-06-14,40 ( 1.01 %),334,1243800,3723.95,531,1311650,2470,-67850
2011-06-13,39.6 ( -0.25 %),346,864120,2497.46,417,1059620,2541,-195500
2011-06-10,39.7 ( -0.75 %),357,640130,1793.08,472,1186070,2513,-545940
2011-06-09,40 ( -0.74 %),367,902670,2459.59,442,921720,2085,-19050
2011-06-08,40.3 ( -0.25 %),520,841080,1617.46,511,1048760,2052,-207680
2011-06-07,40.4 ( 4.94 %),410,935960,2282.83,358,654090,1827,281870
2011-06-06,38.5 ( 0 %),307,694050,2260.75,436,658120,1509,35930
2011-06-03,38.5 ( 0 %),611,1677240,2745.07,866,2206670,2548,-529430
2011-06-02,38.5 ( 4.9 %),575,1631700,2837.74,366,1099960,3005,531740
2011-06-01,36.7 ( 4.86 %),514,2035490,3960.1,420,995530,2370,1039960
2011-05-31,35 ( 2.64 %),433,1355860,3131.32,542,940150,1735,415710
2011-05-30,34.1 ( 4.6 %),591,2510920,4248.6,791,1829810,2313,681110
2011-05-27,32.6 ( 4.82 %),574,2034340,3544.15,191,880390,4609,1153950
2011-05-26,31.1 ( 4.71 %),580,1444820,2491.07,296,696130,2352,748690
2011-05-25,29.7 ( -4.81 %),308,864390,2806.46,414,1419260,3428,-554870
2011-05-24,31.2 ( -4.88 %),424,898230,2118.47,398,1385700,3482,-487470
2011-05-23,32.8 ( -4.93 %),377,959080,2543.98,457,1336880,2925,-377800
2011-05-20,34.5 ( -1.43 %),494,881710,1784.84,298,949320,3186,-67610
2011-05-19,35 ( -4.89 %),666,1213840,1822.58,342,1641480,4800,-427640
2011-05-18,36.8 ( -4.91 %),525,776010,1478.11,359,1763950,4914,-987940
2011-05-17,38.7 ( -4.91 %),530,613820,1158.15,306,1056690,3453,-442870
2011-05-16,40.7 ( -3.33 %),372,506570,1361.75,249,770230,3093,-263660
2011-05-13,42.1 ( 0.24 %),187,414850,2218.45,224,403060,1799,11790
2011-05-12,42 ( -1.18 %),155,351030,2264.71,166,380340,2291,-29310
2011-05-11,42.5 ( 0.71 %),187,588860,3148.98,288,531680,1846,57180
2011-05-10,42.2 ( 0 %),178,397530,2233.31,243,460390,1895,-62860
2011-05-09,42.2 ( 0 %),254,401390,1580.28,162,450520,2781,-49130
2011-05-06,42.2 ( -0.24 %),234,489830,2093.29,247,470840,1906,18990
2011-05-05,42.3 ( -1.17 %),229,417660,1823.84,323,676720,2095,-259060
2011-05-04,42.8 ( 1.66 %),292,607530,2080.58,425,633240,1490,-25710
2011-04-29,42.1 ( 1.45 %),338,1013990,2999.97,349,764140,2190,249850
2011-04-28,41.5 ( -2.58 %),459,501460,1092.51,274,827740,3021,-326280
2011-04-27,42.6 ( -1.62 %),314,439440,1399.49,294,767860,2612,-328420
2011-04-26,43.3 ( -0.92 %),196,412850,2106.38,319,733400,2299,-320550
2011-04-25,43.7 ( 1.63 %),228,387650,1700.22,375,668720,1783,-281070
2011-04-22,43 ( -1.38 %),477,747320,1566.71,382,1312860,3437,-565540
2011-04-21,43.6 ( -0.91 %),635,985120,1551.37,367,1349420,3677,-364300
2011-04-20,44 ( 0 %),384,795480,2071.56,345,1269170,3679,-473690
2011-04-19,44 ( -3.93 %),312,688970,2208.24,441,1303230,2955,-614260
2011-04-18,45.8 ( 4.57 %),308,797270,2588.54,280,689700,2463,107570
2011-04-15,43.8 ( -0.9 %),380,627980,1652.58,279,710790,2548,-82810
2011-04-14,44.2 ( -1.12 %),364,476650,1309.48,190,423920,2231,52730
2011-04-13,44.7 ( -1.32 %),204,253160,1240.98,303,535710,1768,-282550
2011-04-08,45.3 ( -0.44 %),215,501630,2333.16,380,704830,1855,-203200
2011-04-07,45.5 ( 0.22 %),404,749140,1854.31,783,1035140,1322,-286000
2011-04-06,45.4 ( 3.18 %),325,750850,2310.31,277,367560,1327,383290
2011-04-05,44 ( -0.45 %),331,526940,1591.96,210,333500,1588,193440
2011-04-04,44.2 ( -1.12 %),400,900180,2250.45,299,570380,1908,329800
2011-04-01,44.7 ( -0.89 %),514,1130810,2200.02,301,662300,2200,468510
2011-03-31,45.1 ( -0.44 %),381,1177450,3090.42,339,727820,2147,449630
2011-03-30,45.3 ( -0.88 %),463,1222460,2640.3,370,672830,1818,549630
2011-03-29,45.7 ( -0.22 %),541,2034030,3759.76,607,1073030,1768,961000
2011-03-28,45.8 ( 0.88 %),567,1569550,2768.17,688,1402620,2039,166930
2011-03-25,45.4 ( -2.37 %),477,651580,1366,646,1521250,2355,-869670
2011-03-24,46.5 ( -0.43 %),640,1202360,1878.69,1199,1830000,1526,-627640
2011-03-23,46.7 ( 3.09 %),610,1608060,2636.16,968,1357930,1403,250130
2011-03-22,45.3 ( -3 %),753,1220050,1620.25,709,1495940,2110,-275890
2011-03-21,46.7 ( 4.94 %),629,1237600,1967.57,468,696170,1488,541430
2011-03-18,44.5 ( -2.2 %),2145,3822120,1781.87,550,3300300,6001,521820
2011-03-17,45.5 ( 1.79 %),1883,2717890,1443.38,401,1613480,4024,1104410
2011-03-16,44.7 ( -4.89 %),1333,1913930,1435.81,366,2084380,5695,-170450
2011-03-15,47 ( -4.86 %),514,931930,1813.09,538,2988870,5556,-2056940
2011-03-14,49.4 ( -5 %),132,130000,984.85,429,1401120,3266,-1271120
2011-03-11,52 ( 4 %),339,712120,2100.65,465,885780,1905,-173660
2011-03-10,50 ( 3.95 %),368,775580,2107.55,357,634290,1777,141290
2011-03-09,48.1 ( 4.11 %),478,855290,1789.31,469,732630,1562,122660
2011-03-08,46.2 ( 5 %),380,857510,2256.61,282,447430,1587,410080
2011-03-07,44 ( 1.62 %),282,605410,2146.84,184,476910,2592,128500
2011-03-04,43.3 ( -0.69 %),231,215090,931.13,179,260980,1458,-45890
2011-03-03,43.6 ( -4.18 %),298,367880,1234.5,228,357860,1570,10020
2011-03-02,45.5 ( -4.81 %),378,488900,1293.39,288,695560,2415,-206660
2011-03-01,47.8 ( -0.42 %),274,367150,1339.96,222,395970,1784,-28820
2011-02-28,48 ( -2.44 %),307,437630,1425.5,238,395340,1661,42290
2011-02-25,49.2 ( 0.41 %),238,362370,1522.56,168,277300,1651,85070
2011-02-24,49 ( -2.97 %),386,591670,1532.82,267,606390,2271,-14720
2011-02-23,50.5 ( 2.02 %),342,405490,1185.64,196,370710,1891,34780
2011-02-22,49.5 ( -1.98 %),398,1152530,2895.8,365,663220,1817,489310
2011-02-21,50.5 ( -4.72 %),298,555790,1865.07,305,761400,2496,-205610
2011-02-18,53 ( -2.75 %),284,382240,1345.92,192,477740,2488,-95500
2011-02-17,54.5 ( 0 %),243,368390,1516.01,216,321190,1487,47200
2011-02-16,54.5 ( -2.68 %),278,408320,1468.78,268,506990,1892,-98670
2011-02-15,56 ( 1.82 %),401,631190,1574.04,215,564620,2626,66570
2011-02-14,55 ( -1.79 %),312,425060,1362.37,256,617800,2413,-192740
2011-02-11,56 ( 0 %),280,367690,1313.18,228,457640,2007,-89950
2011-02-10,56 ( -1.75 %),264,343700,1301.89,258,549440,2130,-205740
2011-02-09,57 ( -2.56 %),392,565140,1441.68,444,1049990,2365,-484850
2011-02-08,58.5 ( 4.46 %),364,923730,2537.72,429,702250,1637,221480
2011-01-28,56 ( 1.82 %),332,984270,2964.67,400,1049070,2623,-64800
2011-01-27,55 ( 1.85 %),272,793210,2916.21,258,695840,2697,97370
2011-01-26,54 ( 1.89 %),271,581190,2144.61,184,530120,2881,51070
2011-01-25,53 ( -1.85 %),239,399040,1669.62,367,720660,1964,-321620
2011-01-24,54 ( -1.82 %),284,348880,1228.45,239,460280,1926,-111400
2011-01-21,55 ( 0 %),300,462880,1542.93,225,624990,2778,-162110
2011-01-20,55 ( -0.9 %),362,437710,1209.14,317,1025990,3237,-588280
2011-01-19,55.5 ( 4.72 %),986,2003620,2032.07,272,1616440,5943,387180
2011-01-18,79.5 ( -0.62 %),400,1010310,2525.78,388,1014510,2615,-4200
2011-01-17,80 ( 0.63 %),261,405340,1553.03,279,685050,2455,-279710
2011-01-14,79.5 ( 1.27 %),241,671550,2786.51,264,599410,2270,72140
2011-01-13,78.5 ( -0.63 %),208,416060,2000.29,202,521620,2582,-105560
2011-01-12,79 ( 0 %),223,285810,1281.66,181,336410,1859,-50600
2011-01-11,79 ( -1.25 %),185,494740,2674.27,296,790530,2671,-295790
2011-01-10,80 ( 0 %),185,703260,3801.41,362,899280,2484,-196020
2011-01-07,80 ( 0 %),233,664100,2850.21,332,756170,2278,-92070
2011-01-06,80 ( 0.63 %),186,650470,3497.15,297,658510,2217,-8040
2011-01-05,79.5 ( 0 %),262,524790,2003.02,334,785360,2351,-260570
2011-01-04,79.5 ( -1.85 %),330,720200,2182.42,389,1052960,2707,-332760
2010-12-31,81 ( 4.52 %),424,1208850,2851.06,278,834250,3001,374600
2010-12-30,77.5 ( 0 %),351,968530,2759.34,205,707440,3451,261090
2010-12-29,77.5 ( 0.65 %),214,476400,2226.17,191,591860,3099,-115460
2010-12-28,77 ( 0 %),212,402650,1899.29,180,503660,2798,-101010
2010-12-27,77 ( -0.65 %),119,213470,1793.87,181,382600,2114,-169130
2010-12-24,77.5 ( 0.65 %),170,310340,1825.53,215,434720,2022,-124380
2010-12-23,77 ( 0.65 %),220,607440,2761.09,210,748850,3566,-141410
2010-12-22,76.5 ( 0 %),168,269460,1603.93,172,385090,2239,-115630
2010-12-21,76.5 ( -2.55 %),299,667610,2232.81,182,744960,4093,-77350
2010-12-20,78.5 ( -1.26 %),149,423430,2841.81,276,671790,2434,-248360
2010-12-17,79.5 ( 1.27 %),539,1188330,2204.69,252,1116080,4429,72250
2010-12-16,78.5 ( -2.48 %),146,351760,2409.32,215,614410,2858,-262650
2010-12-15,80.5 ( 0 %),212,590260,2784.25,292,709450,2430,-119190
2010-12-14,80.5 ( 0 %),174,769610,4423.05,412,960260,2331,-190650
2010-12-13,80.5 ( 3.21 %),426,1603940,3765.12,409,1204720,2946,399220
2010-12-10,78 ( 1.3 %),184,700240,3805.65,325,619970,1908,80270
2010-12-09,77 ( 0.65 %),168,440950,2624.7,196,477840,2438,-36890
2010-12-08,76.5 ( -0.65 %),166,499870,3011.27,226,570970,2526,-71100
2010-12-07,77 ( 0.65 %),258,725110,2810.5,207,740050,3575,-14940
2010-12-06,76.5 ( -1.92 %),364,683850,1878.71,263,864800,3288,-180950
2010-12-03,78 ( 1.3 %),323,658190,2037.74,297,720610,2426,-62420
2010-12-02,77 ( 0.65 %),252,580620,2304.05,165,412750,2502,167870
2010-12-01,76.5 ( 0 %),394,894920,2271.37,188,820860,4366,74060
2010-11-30,76.5 ( -0.65 %),423,974680,2304.21,192,1058260,5512,-83580
2010-11-29,77 ( 0 %),188,498010,2648.99,145,666390,4596,-168380
2010-11-26,77 ( 0 %),173,257740,1489.83,122,368880,3024,-111140
2010-11-25,77 ( -0.65 %),119,287400,2415.13,182,512370,2815,-224970
2010-11-24,77.5 ( -0.64 %),136,459460,3378.38,180,447500,2486,11960
2010-11-23,78 ( 1.3 %),216,732560,3391.48,175,511210,2921,221350
2010-11-22,77 ( 0 %),189,425550,2251.59,156,508790,3261,-83240
2010-11-19,77 ( 0 %),202,590350,2922.52,206,749470,3638,-159120
2010-11-18,77 ( 4.76 %),224,730660,3261.88,170,682170,4013,48490
2010-11-17,73.5 ( -3.92 %),313,406310,1298.12,129,486700,3773,-80390
2010-11-16,76.5 ( -0.65 %),185,584890,3161.57,188,650680,3461,-65790
2010-11-15,77 ( -0.65 %),119,251650,2114.71,146,377290,2584,-125640
2010-11-12,77.5 ( 0.65 %),133,426730,3208.5,198,432720,2185,-5990
2010-11-11,77 ( -0.65 %),110,261320,2375.64,111,359550,3239,-98230
2010-11-10,77.5 ( 0.65 %),99,161800,1634.34,111,302080,2721,-140280
2010-11-09,77 ( 0 %),123,275100,2236.59,165,391660,2374,-116560
2010-11-08,77 ( -1.28 %),139,244630,1759.93,138,352260,2553,-107630
2010-11-05,78 ( 0 %),172,699480,4066.74,226,945940,4186,-246460
2010-11-04,78 ( -0.64 %),129,326380,2530.08,169,561680,3324,-235300
2010-11-03,78.5 ( -0.63 %),136,417160,3067.35,169,518090,3066,-100930
2010-11-02,79 ( 0 %),179,430970,2407.65,201,519570,2585,-88600
2010-11-01,79 ( 0 %),129,357310,2769.84,151,497910,3297,-140600
2010-10-29,79 ( -0.63 %),214,409410,1913.13,202,604990,2995,-195580
2010-10-28,79.5 ( 0 %),111,317420,2859.64,172,530810,3086,-213390
2010-10-27,79.5 ( -0.62 %),112,291430,2602.05,272,596970,2195,-305540
2010-10-26,80 ( 0 %),160,639070,3994.19,386,927740,2403,-288670
2010-10-25,80 ( 0 %),169,726020,4295.98,373,1011970,2713,-285950
2010-10-22,80 ( 1.27 %),134,439860,3282.54,273,623280,2283,-183420
2010-10-21,79 ( 1.28 %),109,361630,3317.71,210,466020,2219,-104390
2010-10-20,78 ( -2.5 %),214,656510,3067.8,310,705320,2275,-48810
2010-10-19,80 ( 0 %),162,652020,4024.81,382,996690,2609,-344670
2010-10-18,80 ( 1.91 %),225,881280,3916.8,426,770890,1810,110390
2010-10-15,78.5 ( 0.64 %),196,630290,3215.77,270,586350,2172,43940
2010-10-14,78 ( 1.3 %),146,464680,3182.74,254,541680,2133,-77000
2010-10-13,77 ( -1.28 %),152,398850,2624.01,183,519010,2836,-120160
2010-10-12,78 ( -0.64 %),135,410170,3038.3,300,566150,1887,-155980
2010-10-11,78.5 ( 0.64 %),96,280410,2920.94,251,339940,1354,-59530
2010-10-08,78 ( 0 %),158,573690,3630.95,383,606480,1583,-32790
2010-10-07,78 ( 0.65 %),217,877220,4042.49,507,1160710,2289,-283490
2010-10-06,77.5 ( 2.65 %),199,1025240,5151.96,428,892850,2086,132390
2010-10-05,75.5 ( 1.34 %),175,670100,3829.14,318,531400,1671,138700
2010-10-04,74.5 ( 0.68 %),107,521930,4877.85,346,620990,1795,-99060
2010-10-01,74 ( 1.37 %),131,530390,4048.78,325,507500,1562,22890
2010-09-30,73 ( 0.69 %),231,811420,3512.64,438,956560,2184,-145140
2010-09-29,72.5 ( -1.36 %),99,102650,1036.87,200,294590,1473,-191940
2010-09-28,73.5 ( 2.08 %),153,429370,2806.34,234,430930,1842,-1560
2010-09-27,72 ( -1.37 %),180,292730,1626.28,154,359320,2333,-66590
2010-09-24,73 ( -0.68 %),110,121790,1107.18,137,150540,1099,-28750
2010-09-23,73.5 ( -0.68 %),109,183970,1687.8,187,392460,2099,-208490
2010-09-22,74 ( 0 %),110,214300,1948.18,212,231440,1092,-17140
2010-09-21,74 ( 0 %),151,308910,2045.76,279,591010,2118,-282100
2010-09-20,74 ( 0 %),140,334040,2386,248,521570,2103,-187530
2010-09-17,74 ( 2.78 %),172,392070,2279.48,237,409840,1729,-17770
2010-09-16,72 ( -0.69 %),193,261250,1353.63,175,230780,1319,30470
2010-09-15,72.5 ( 1.4 %),204,592100,2902.45,241,576450,2392,15650
2010-09-14,71.5 ( -0.69 %),229,295850,1291.92,192,299610,1560,-3760
2010-09-13,72 ( 0 %),272,427120,1570.29,180,415340,2307,11780
2010-09-10,72 ( -3.36 %),175,308100,1760.57,290,703030,2424,-394930
2010-09-09,74.5 ( 0.68 %),156,369520,2368.72,304,590880,1944,-221360
2010-09-08,74 ( 0 %),187,443940,2374.01,212,484460,2285,-40520
2010-09-07,74 ( -1.99 %),191,500200,2618.85,293,750900,2563,-250700
2010-09-06,75.5 ( 0 %),244,523030,2143.57,238,675590,2839,-152560
2010-09-01,75.5 ( 0 %),180,385230,2140.17,299,705370,2359,-320140
2010-08-31,75.5 ( 2.72 %),253,1440940,5695.42,433,1497560,3459,-56620
2010-08-30,73.5 ( 4.26 %),294,578780,1968.64,234,635670,2717,-56890
2010-08-27,70.5 ( -0.7 %),307,415750,1354.23,184,528480,2872,-112730
2010-08-26,71 ( 0 %),260,505530,1944.35,208,732350,3521,-226820
2010-08-25,71 ( 0 %),260,634370,2439.88,303,773630,2553,-139260
2010-08-24,71 ( -4.05 %),327,684700,2093.88,246,1028370,4180,-343670
2010-08-23,74 ( 0.68 %),220,380340,1728.82,151,446170,2955,-65830
2010-08-20,73.5 ( -0.68 %),326,898130,2755,192,798900,4161,99230
2010-08-19,74 ( -1.33 %),272,673310,2475.4,190,656190,3454,17120
2010-08-18,75 ( 0 %),552,1143040,2070.72,263,1267000,4817,-123960
2010-08-17,75 ( -3.23 %),290,618110,2131.41,250,969410,3878,-351300
2010-08-16,77.5 ( 1.97 %),342,674060,1970.94,154,453240,2943,220820
2010-08-13,76 ( 0 %),255,584860,2293.57,257,785530,3057,-200670
2010-08-12,76 ( 0 %),338,766580,2267.99,189,827640,4379,-61060
2010-08-11,76 ( -0.65 %),412,644970,1565.46,148,770440,5206,-125470
2010-08-10,76.5 ( -1.29 %),394,1128560,2864.37,219,1091780,4985,36780
2010-08-09,77.5 ( -1.9 %),141,353850,2509.57,192,624080,3250,-270230
2010-08-06,79 ( 0 %),207,464010,2241.59,133,493200,3708,-29190
2010-08-05,79 ( 0 %),184,640740,3482.28,189,744540,3939,-103800
2010-08-04,79 ( -1.86 %),230,629080,2735.13,239,876950,3669,-247870
2010-08-03,80.5 ( 1.9 %),141,521340,3697.45,189,673190,3562,-151850
2010-08-02,80 ( -1.84 %),144,375980,2610.97,204,572620,2807,-196640
2010-07-30,81.5 ( 0.62 %),167,550160,3294.37,208,487230,2342,62930
2010-07-29,81 ( 0.62 %),117,624840,5340.51,261,559370,2143,65470
2010-07-28,80.5 ( 0 %),167,564280,3378.92,202,624170,3090,-59890
2010-07-27,80.5 ( -0.62 %),168,552730,3290.06,277,596190,2152,-43460
2010-07-26,81 ( 0 %),129,326270,2529.22,213,369490,1735,-43220
2010-07-23,81 ( 0.62 %),142,294210,2071.9,309,357480,1157,-63270
2010-07-22,80.5 ( -1.23 %),205,444070,2166.2,305,477740,1566,-33670
2010-07-21,81.5 ( -0.61 %),103,213750,2075.24,340,542760,1596,-329010
2010-07-20,82 ( 0.61 %),154,755760,4907.53,415,801080,1930,-45320
2010-07-19,81.5 ( 0 %),182,477260,2622.31,371,617510,1664,-140250
2010-07-16,81.5 ( 0.62 %),171,928640,5430.64,523,1035350,1980,-106710
2010-07-15,81 ( 0 %),102,519080,5089.02,479,657710,1373,-138630
2010-07-14,81 ( 0.62 %),115,384570,3344.09,333,572040,1718,-187470
2010-07-13,80.5 ( 0.62 %),154,587090,3812.27,353,601880,1705,-14790
2010-07-12,80 ( 0.63 %),105,215720,2054.48,176,172650,981,43070
2010-07-09,79.5 ( 0 %),110,218810,1989.18,176,285360,1621,-66550
2010-07-08,79.5 ( 1.92 %),133,197840,1487.52,195,239720,1229,-41880
2010-07-07,78 ( -0.64 %),140,347850,2484.64,225,493430,2193,-145580
2010-07-06,78.5 ( -1.26 %),147,329850,2243.88,168,346140,2060,-16290
2010-07-05,79.5 ( 1.27 %),163,515780,3164.29,224,487050,2174,28730
2010-07-02,78.5 ( -0.63 %),188,235460,1252.45,153,285870,1868,-50410
2010-07-01,79 ( -0.63 %),227,379920,1673.66,155,344060,2220,35860
2010-06-30,79.5 ( -0.62 %),314,609140,1939.94,160,225140,1407,384000
2010-06-29,80 ( 0.63 %),204,490110,2402.5,225,546280,2428,-56170
2010-06-28,79.5 ( 0.63 %),277,553210,1997.15,232,443040,1910,110170
2010-06-25,79 ( -2.47 %),303,683850,2256.93,276,736330,2668,-52480
2010-06-24,81 ( -0.61 %),154,444830,2888.51,263,448570,1706,-3740
2010-06-23,81.5 ( -0.61 %),153,424080,2771.76,291,352910,1213,71170
2010-06-22,82 ( -1.2 %),211,697060,3303.6,490,1105540,2256,-408480
2010-06-21,83 ( 0.61 %),182,529630,2910.05,637,1009320,1584,-479690
2010-06-18,82.5 ( -0.6 %),233,729150,3129.4,745,1554230,2086,-825080
2010-06-17,83 ( 0 %),201,644210,3205.02,694,1110140,1600,-465930
2010-06-16,83 ( 1.84 %),207,783390,3784.49,598,790830,1322,-7440
2010-06-15,81.5 ( 0 %),159,479360,3014.84,534,565060,1058,-85700
2010-06-14,81.5 ( 1.24 %),265,988080,3728.6,575,1050220,1826,-62140
2010-06-11,80.5 ( 3.21 %),441,2219730,5033.4,932,1798270,1929,421460
2010-06-10,78 ( 0.65 %),160,451970,2824.81,271,287900,1062,164070
2010-06-09,77.5 ( 0.65 %),177,689990,3898.25,394,808530,2052,-118540
2010-06-08,77 ( 0 %),226,625340,2766.99,221,356490,1613,268850
2010-06-07,77 ( -1.91 %),369,1181060,3200.7,325,724080,2228,456980
2010-06-04,78.5 ( -0.63 %),178,485870,2729.61,429,576060,1343,-90190
2010-06-03,79 ( -0.63 %),225,726080,3227.02,445,1017720,2287,-291640
2010-06-02,79.5 ( 0.63 %),198,661260,3339.7,357,626180,1754,35080
2010-06-01,79 ( 1.94 %),308,1062130,3448.47,308,770300,2501,291830
2010-05-31,77.5 ( 0.65 %),208,586830,2821.3,363,590090,1626,-3260
2010-05-28,77 ( 2.67 %),434,1405660,3238.85,375,1190050,3173,215610
2010-05-27,75 ( 0.67 %),385,1058940,2750.49,347,820150,2364,238790
2010-05-26,74.5 ( -0.67 %),287,552580,1925.37,269,635860,2364,-83280
2010-05-25,75 ( -0.66 %),243,427200,1758.02,260,534970,2058,-107770
2010-05-24,75.5 ( 2.03 %),305,702080,2301.9,285,547520,1921,154560
2010-05-21,74 ( -4.52 %),500,784390,1568.78,492,1006360,2045,-221970
2010-05-20,77.5 ( 1.97 %),475,1253620,2639.2,368,784630,2132,468990
2010-05-19,76 ( -2.56 %),430,1176600,2736.28,404,1232090,3050,-55490
2010-05-18,78 ( 0 %),388,1095960,2824.64,283,820330,2899,275630
2010-05-17,78 ( -1.89 %),343,648410,1890.41,366,847260,2315,-198850
2010-05-14,79.5 ( 0 %),395,653800,1655.19,245,617770,2522,36030
2010-05-13,79.5 ( 0.63 %),481,780310,1622.27,277,740220,2672,40090
2010-05-12,79 ( -1.86 %),710,972620,1369.89,402,1276880,3176,-304260
2010-05-11,80.5 ( 0.62 %),612,970400,1585.62,338,897900,2657,72500
2010-05-10,80 ( -1.23 %),632,990890,1567.86,382,1012120,2650,-21230
2010-05-07,81 ( -3.57 %),1071,2011810,1878.44,651,1935360,2973,76450
2010-05-06,84 ( -0.59 %),461,834800,1810.85,459,1011210,2203,-176410
2010-05-05,84.5 ( -0.59 %),377,1003590,2662.04,617,1216010,1971,-212420
2010-05-04,85 ( 0.59 %),370,1328620,3590.86,622,1422570,2287,-93950
2010-04-29,84.5 ( -0.59 %),340,872910,2567.38,650,1286210,1979,-413300
2010-04-28,85 ( 0 %),436,1151450,2640.94,693,1377680,1988,-226230
2010-04-27,85 ( 0.59 %),418,1334520,3192.63,588,1324470,2252,10050
2010-04-26,84.5 ( -1.17 %),354,957910,2705.96,899,1948580,2167,-990670
2010-04-22,85.5 ( 3.01 %),623,2185340,3507.77,1050,2353530,2241,-168190
2010-04-21,83 ( 0 %),284,476100,1676.41,478,869330,1819,-393230
2010-04-20,83 ( 0 %),335,704900,2104.18,403,943200,2340,-238300
2010-04-19,83 ( -0.6 %),315,547130,1736.92,498,929740,1867,-382610
2010-04-16,83.5 ( -0.6 %),353,673640,1908.33,647,1340580,2072,-666940
2010-04-15,84 ( 1.2 %),437,955230,2185.88,660,1365070,2068,-409840
2010-04-14,83 ( -0.6 %),431,851310,1975.2,532,1112830,2092,-261520
2010-04-13,83.5 ( -0.6 %),421,925430,2198.17,526,1098310,2088,-172880
2010-04-12,84 ( 0.6 %),467,945260,2024.11,564,1100940,1952,-155680
2010-04-09,83.5 ( 0.6 %),474,1444300,3047.05,697,1630160,2339,-185860
2010-04-08,83 ( -1.19 %),479,932100,1945.93,548,1147390,2094,-215290
2010-04-07,84 ( 0.6 %),444,1020740,2298.96,543,984610,1813,36130
2010-04-06,83.5 ( -0.6 %),470,1248480,2656.34,764,1931770,2528,-683290
2010-04-05,84 ( 0.6 %),350,935210,2672.03,658,1557220,2367,-622010
2010-04-02,83.5 ( 0.6 %),404,1165300,2884.41,884,1922300,2175,-757000
2010-04-01,83 ( 2.47 %),430,1454920,3383.53,612,1224160,2000,230760
2010-03-31,81 ( 1.25 %),653,1471160,2252.92,559,1375060,2460,96100
2010-03-30,80 ( -3.03 %),723,1015020,1403.9,345,1283960,3722,-268940
2010-03-29,82.5 ( 0.61 %),501,1268820,2532.57,422,974870,2310,293950
2010-03-26,82 ( 1.23 %),847,1302640,1537.95,472,1174430,2488,128210
2010-03-25,81 ( -3.57 %),1344,2040210,1518.01,513,1727010,3366,313200
2010-03-24,84 ( 0.6 %),983,2048820,2084.25,518,1871520,3613,177300
2010-03-23,83.5 ( -2.34 %),749,1546970,2065.38,644,2212020,3435,-665050
2010-03-22,85.5 ( -1.72 %),661,956360,1446.84,530,1409300,2659,-452940
2010-03-19,87 ( 0 %),586,1481650,2528.41,857,2424330,2829,-942680
2010-03-18,87 ( 1.75 %),1112,2660420,2392.46,589,2572520,4368,87900
2010-03-17,85.5 ( -0.58 %),947,2405420,2540.04,1106,3163690,2860,-758270
2010-03-16,86 ( -2.82 %),1076,1986210,1845.92,1102,2502650,2271,-516440
2010-03-15,88.5 ( -1.12 %),678,1332680,1965.6,1083,2419360,2234,-1086680
2010-03-12,89.5 ( 4.07 %),1319,5205150,3946.29,1724,4886600,2834,318550
2010-03-11,86 ( 2.38 %),957,2754940,2878.73,1269,2549620,2009,205320
2010-03-10,84 ( 0 %),836,2501180,2991.84,1031,2461670,2388,39510
2010-03-09,84 ( 0 %),719,1472000,2047.29,895,1555470,1738,-83470
2010-03-08,84 ( 0 %),782,1527920,1953.86,1118,2382790,2131,-854870
2010-03-05,84 ( 1.82 %),1492,3148840,2110.48,2007,4547060,2266,-1398220
2010-03-04,82.5 ( 4.43 %),1468,4693460,3197.18,535,2071210,3871,2622250
2010-03-03,79 ( 0 %),305,572850,1878.2,448,949820,2120,-376970
2010-03-02,79 ( 0 %),480,558170,1162.85,275,644130,2342,-85960
2010-03-01,79 ( 0 %),272,379920,1396.76,394,728990,1850,-349070
2010-02-26,79 ( -0.63 %),565,905540,1602.73,490,1486590,3034,-581050
2010-02-25,79.5 ( 0.63 %),480,836750,1743.23,319,1099450,3447,-262700
2010-02-24,79 ( -0.63 %),657,846060,1287.76,260,919100,3535,-73040
2010-02-23,79.5 ( -3.05 %),361,472170,1307.95,546,967910,1773,-495740
2010-02-22,82 ( 1.86 %),242,558330,2307.15,449,705550,1571,-147220
2010-02-12,80.5 ( 0.62 %),344,609140,1770.76,394,773780,1964,-164640
2010-02-11,80 ( 0 %),327,665610,2035.5,296,811670,2742,-146060
2010-02-10,80 ( 0 %),325,549000,1689.23,362,615590,1701,-66590
2010-02-09,80 ( 0 %),295,612880,2077.56,383,805530,2103,-192650
2010-02-08,80 ( 0 %),314,740910,2359.59,399,882410,2212,-141500
2010-02-05,80 ( -1.23 %),326,908150,2785.74,678,1131550,1669,-223400
2010-02-04,81 ( 1.25 %),370,1215330,3284.68,759,1145610,1509,69720
2010-02-03,80 ( 0 %),328,931490,2839.91,918,1509500,1644,-578010
2010-02-02,80 ( 0 %),244,739370,3030.2,1060,1694910,1599,-955540
2010-02-01,80 ( 1.27 %),315,706460,2242.73,397,723200,1822,-16740
2010-01-29,79 ( 1.28 %),392,719790,1836.2,496,851370,1716,-131580
2010-01-28,78 ( -1.27 %),391,666740,1705.22,401,619600,1545,47140
2010-01-27,79 ( -3.07 %),343,728200,2123.03,1032,1827650,1771,-1099450
2010-01-26,81.5 ( 4.49 %),613,1265430,2064.32,660,1166990,1768,98440
2010-01-25,78 ( -0.64 %),399,529530,1327.14,432,641380,1485,-111850
2010-01-22,78.5 ( 1.29 %),487,896530,1840.92,467,681640,1460,214890
2010-01-21,77.5 ( -2.52 %),369,797340,2160.81,798,1236900,1550,-439560
2010-01-20,79.5 ( -1.24 %),288,635850,2207.81,750,959710,1280,-323860
2010-01-19,80.5 ( 3.87 %),449,1126800,2509.58,714,900840,1262,225960
2010-01-18,77.5 ( -4.91 %),582,767800,1319.24,771,1453440,1885,-685640
2010-01-15,81.5 ( -0.61 %),411,925720,2252.36,923,1529650,1657,-603930
2010-01-14,82 ( 1.86 %),548,993440,1812.85,824,1484430,1801,-490990
2010-01-13,80.5 ( 4.55 %),834,1800250,2158.57,846,1356720,1604,443530
2010-01-12,77 ( -1.91 %),803,1331270,1657.87,876,1399860,1598,-68590
2010-01-11,78.5 ( -1.88 %),809,1197240,1479.9,717,1125810,1570,71430
2010-01-08,80 ( -3.03 %),694,1205170,1736.56,1160,2012230,1735,-807060
2010-01-07,82.5 ( -2.37 %),921,1398890,1518.88,1209,2155500,1783,-756610
2010-01-06,84.5 ( -1.17 %),890,1770290,1989.09,1713,3306380,1930,-1536090
2010-01-05,85.5 ( 4.91 %),586,2218440,3785.73,815,2231510,2738,-13070
2010-01-04,81.5 ( 4.49 %),490,1614050,3293.98,532,1183670,2225,430380
2009-12-31,78 ( 1.3 %),609,1356610,2227.6,1307,2387590,1827,-1030980
2009-12-30,77 ( 4.05 %),931,1817440,1952.14,953,1725200,1810,92240
2009-12-29,74 ( -3.27 %),932,1348090,1446.45,1131,2069080,1829,-720990
2009-12-28,76.5 ( 0 %),904,1773460,1961.79,1273,2319960,1822,-546500
2009-12-25,76.5 ( 4.79 %),999,2006810,2008.82,829,1626660,1962,380150
2009-12-24,73 ( 1.39 %),1283,2379420,1854.58,1343,2299900,1713,79520
2009-12-23,72 ( 4.35 %),1210,2277140,1881.93,1335,1814950,1360,462190
2009-12-22,69 ( 4.55 %),885,2737600,3093.33,1391,2094080,1505,643520
2009-12-21,66 ( 4.76 %),577,1567960,2717.44,539,750730,1393,817230
2009-12-18,63 ( 5 %),902,3699500,4101.44,705,1631620,2314,2067880
2009-12-17,60 ( 0.84 %),951,1291360,1357.9,540,1083240,2006,208120
2009-12-16,59.5 ( -4.8 %),612,1096700,1791.99,1034,2107400,2038,-1010700
2009-12-15,62.5 ( 3.31 %),583,1505450,2582.25,1011,1813480,1794,-308030
2009-12-14,60.5 ( 4.31 %),642,1021640,1591.34,476,635580,1335,386060
2009-12-11,58 ( -4.92 %),580,656000,1131.03,567,1304820,2301,-648820
2009-12-10,61 ( -4.69 %),774,999670,1291.56,523,1048760,2005,-49090
2009-12-09,64 ( -3.76 %),680,1062050,1561.84,461,950070,2061,111980
2009-12-08,66.5 ( -2.21 %),583,1137460,1951.05,733,1365620,1863,-228160
2009-12-07,68 ( 4.62 %),455,1313130,2886,662,998930,1509,314200
2009-12-04,65 ( 1.56 %),509,1052340,2067.47,405,762200,1882,290140
2009-12-03,64 ( -1.54 %),559,772850,1382.56,327,562970,1722,209880
2009-12-02,65 ( -4.41 %),423,594650,1405.79,552,922060,1670,-327410
2009-12-01,68 ( 0.74 %),452,624120,1380.8,565,913610,1617,-289490
2009-11-30,67.5 ( 3.85 %),624,782640,1254.23,418,788940,1887,-6300
2009-11-27,65 ( 0.78 %),1030,1781980,1730.08,605,1829880,3025,-47900
2009-11-26,64.5 ( -4.44 %),371,778570,2098.57,592,1985540,3354,-1206970
2009-11-25,67.5 ( -4.93 %),1012,1234930,1220.29,547,2093340,3827,-858410
2009-11-24,71 ( -2.07 %),992,1542940,1555.38,447,1711740,3829,-168800
2009-11-23,72.5 ( -4.61 %),835,1535600,1839.04,508,1984560,3907,-448960
2009-11-20,76 ( -3.18 %),1036,1793340,1731.02,864,2419680,2801,-626340
2009-11-19,78.5 ( 4.67 %),1229,4214930,3429.56,562,2496200,4442,1718730
2009-11-18,75 ( 4.9 %),966,3899630,4036.88,519,1499980,2890,2399650
2009-11-17,71.5 ( 0.7 %),593,1040020,1753.83,371,1088100,2933,-48080
2009-11-16,71 ( -1.39 %),461,1029320,2232.8,454,1483790,3268,-454470
2009-11-13,72 ( -1.37 %),540,1022500,1893.52,355,821240,2313,201260
2009-11-12,73 ( -0.68 %),621,1197400,1928.18,440,1456110,3309,-258710
2009-11-11,73.5 ( 2.08 %),505,1251370,2477.96,427,1029750,2412,221620
2009-11-10,72 ( -4.64 %),346,716420,2070.58,522,1135500,2175,-419080
2009-11-09,75.5 ( -4.43 %),227,372030,1638.9,469,1296830,2765,-924800
2009-11-06,79 ( 5.33 %),892,2321540,2602.62,356,1377840,3870,943700
2009-11-05,113 ( 2.73 %),758,1598930,2109.41,532,1384570,2603,214360
2009-11-04,110 ( 0.92 %),719,1401670,1949.47,453,1235990,2728,165680
2009-11-03,109 ( -4.39 %),543,820800,1511.6,520,1131110,2175,-310310
2009-11-02,114 ( -4.2 %),426,741640,1740.94,369,1276610,3460,-534970
2009-10-30,119 ( 0 %),668,1087470,1627.95,376,1629160,4333,-541690
2009-10-29,119 ( -1.65 %),890,1225180,1376.61,425,1020330,2401,204850
2009-10-28,121 ( 0.83 %),911,1225260,1344.96,342,1395570,4081,-170310
2009-10-27,120 ( -1.64 %),812,1353800,1667.24,396,1155210,2917,198590
2009-10-26,122 ( -2.4 %),1213,2444470,2015.23,474,2311870,4877,132600
2009-10-23,125 ( -4.58 %),643,1251920,1947,760,2141070,2817,-889150
2009-10-22,131 ( -0.76 %),724,1711810,2364.38,732,2261380,3089,-549570
2009-10-21,132 ( 0 %),1030,2064100,2003.98,942,3375980,3584,-1311880
2009-10-20,132 ( 4.76 %),809,3758920,4646.38,1035,3084840,2981,674080
2009-10-19,126 ( 2.44 %),354,1409120,3980.56,598,1406940,2353,2180
2009-10-16,123 ( -1.6 %),673,1663750,2472.14,671,2081410,3102,-417660
2009-10-15,125 ( 0.81 %),516,1599700,3100.19,982,2506710,2553,-907010
2009-10-14,124 ( 0 %),690,1929650,2796.59,556,1651030,2969,278620
2009-10-13,124 ( -2.36 %),472,1276300,2704.03,976,2651090,2716,-1374790
2009-10-12,127 ( 3.25 %),555,2127870,3834,1109,2874180,2592,-746310
2009-10-09,123 ( 1.65 %),547,2506850,4582.91,849,2476670,2917,30180
2009-10-08,121 ( 0 %),489,1188980,2431.45,571,1393060,2440,-204080
2009-10-07,121 ( 2.54 %),768,1705500,2220.7,578,1912340,3309,-206840
2009-10-06,118 ( -1.67 %),648,1326140,2046.51,517,2081970,4027,-755830
2009-10-05,120 ( 0 %),743,2446190,3292.31,544,1497750,2753,948440
2009-10-02,120 ( -3.23 %),929,2600160,2798.88,884,3044680,3444,-444520
2009-10-01,124 ( -1.59 %),546,2181590,3995.59,715,2344060,3278,-162470
2009-09-30,126 ( -0.79 %),582,2386280,4100.14,898,2945570,3280,-559290
2009-09-29,127 ( 4.96 %),1161,4552630,3921.3,701,3263550,4656,1289080
2009-09-28,121 ( -2.42 %),818,1673710,2046.1,734,2301890,3136,-628180
2009-09-25,124 ( 0.81 %),989,1876730,1897.6,547,1689590,3089,187140
2009-09-24,123 ( -2.38 %),1440,2508610,1742.09,825,2960410,3588,-451800
2009-09-23,126 ( -4.55 %),1577,3616240,2293.11,1113,4255860,3824,-639620
2009-09-22,132 ( 2.33 %),1470,3377280,2297.47,691,2752930,3984,624350
2009-09-21,129 ( 4.88 %),1219,3643920,2989.27,433,2079150,4802,1564770
2009-09-18,123 ( 3.36 %),827,2786940,3369.94,527,2100540,3986,686400
2009-09-17,119 ( 3.48 %),1136,3968960,3493.8,702,2625180,3740,1343780
2009-09-16,115 ( -4.17 %),1090,2686900,2465.05,984,2938610,2986,-251710
2009-09-15,120 ( 4.35 %),1511,4568940,3023.79,881,3039760,3450,1529180
2009-09-14,115 ( 4.55 %),576,2323860,4034.48,114,456090,4001,1867770
2009-09-11,110 ( 4.76 %),645,3454840,5356.34,270,998770,3699,2456070
2009-09-10,105 ( 5 %),844,4052310,4801.32,640,1649990,2578,2402320
2009-09-09,100 ( -0.99 %),468,1383470,2956.13,496,1390690,2804,-7220
2009-09-08,101 ( 1.51 %),581,1613240,2776.66,448,1240100,2768,373140
2009-09-07,99.5 ( -0.5 %),794,3182710,4008.45,1030,2754750,2675,427960
2009-09-04,100 ( -4.76 %),771,1816340,2355.82,1043,3790520,3634,-1974180
2009-09-03,105 ( 3.96 %),1113,3716440,3339.12,650,2313160,3559,1403280
2009-09-01,101 ( 4.66 %),951,3190170,3354.54,535,1528390,2857,1661780
2009-08-31,96.5 ( 4.89 %),652,2852080,4374.36,380,1039670,2736,1812410
2009-08-28,92 ( 4.55 %),678,2469770,3642.73,653,1464670,2243,1005100
2009-08-27,88 ( 0 %),642,1303250,2029.98,487,1410280,2896,-107030
2009-08-26,88 ( -0.56 %),740,1815220,2453,493,1595090,3235,220130
2009-08-25,88.5 ( -2.75 %),662,1611180,2433.81,920,1927610,2095,-316430
2009-08-24,91 ( 4.6 %),744,3182400,4277.42,597,1446310,2423,1736090
2009-08-21,87 ( 2.96 %),478,1736950,3633.79,725,1398070,1928,338880
2009-08-20,84.5 ( 3.05 %),471,1286310,2731.02,760,1614860,2125,-328550
2009-08-19,82 ( 3.14 %),471,1462590,3105.29,537,1125270,2095,337320
2009-08-18,79.5 ( 0 %),636,1971120,3099.25,553,1167420,2111,803700
2009-08-17,79.5 ( -1.85 %),460,1382870,3006.24,699,1905200,2726,-522330
2009-08-14,81 ( 1.89 %),763,2108680,2763.67,1092,3273300,2998,-1164620
2009-08-13,79.5 ( 4.61 %),854,3581680,4194,711,1610390,2265,1971290
2009-08-12,76 ( 1.33 %),575,1449140,2520.24,691,1321510,1912,127630
2009-08-11,75 ( 0 %),374,1088140,2909.47,695,1144530,1647,-56390
2009-08-10,75 ( 2.04 %),411,1398010,3401.48,618,1041270,1685,356740
2009-08-07,73.5 ( 0 %),348,886960,2548.74,565,994030,1759,-107070
2009-08-06,73.5 ( 0.68 %),496,1486490,2996.96,770,1509750,1961,-23260
2009-08-05,73 ( 0.69 %),443,1200550,2710.05,556,931930,1676,268620
2009-08-04,72.5 ( 0.69 %),635,1477850,2327.32,508,1495060,2943,-17210
2009-08-03,72 ( -1.37 %),488,876730,1796.58,441,1055250,2393,-178520
2009-07-31,73 ( 2.82 %),455,906700,1992.75,432,780140,1806,126560
2009-07-30,71 ( -0.7 %),693,1704990,2460.3,308,906930,2945,798060
2009-07-29,71.5 ( -1.38 %),415,889470,2143.3,471,1157070,2457,-267600
2009-07-28,72.5 ( -3.33 %),463,1090050,2354.32,922,1875510,2034,-785460
2009-07-27,75 ( 0 %),648,1499440,2313.95,1347,2756740,2047,-1257300
2009-07-24,75 ( 4.9 %),394,2342470,5945.36,439,1015360,2313,1327110
2009-07-23,71.5 ( 3.62 %),376,1146110,3048.16,369,731240,1982,414870
2009-07-22,69 ( 0 %),339,706130,2082.98,410,813110,1983,-106980
2009-07-21,69 ( 2.99 %),590,1134560,1922.98,388,1019930,2629,114630
2009-07-20,67 ( -3.6 %),678,1124010,1657.83,481,1244800,2588,-120790
2009-07-17,69.5 ( -0.71 %),540,968320,1793.19,416,988940,2377,-20620
2009-07-16,70 ( -0.71 %),715,1538980,2152.42,583,1519420,2606,19560
2009-07-15,70.5 ( -0.7 %),468,1057370,2259.34,527,1366290,2593,-308920
2009-07-14,71 ( -1.39 %),503,1494440,2971.05,708,1929190,2725,-434750
2009-07-13,72 ( 0.7 %),992,1804410,1818.96,902,3165830,3510,-1361420
2009-07-10,71.5 ( -2.05 %),405,840520,2075.36,1014,2100100,2071,-1259580
2009-07-09,73 ( 4.29 %),561,1578320,2813.4,528,980550,1857,597770
2009-07-08,70 ( 0 %),366,1264570,3455.11,591,1166320,1973,98250
2009-07-07,70 ( -0.71 %),417,1364150,3271.34,739,1691110,2288,-326960
2009-07-06,70.5 ( 4.44 %),374,1457470,3896.98,241,477390,1981,980080
2009-07-03,67.5 ( 1.5 %),469,1432950,3055.33,317,749140,2363,683810
2009-07-02,66.5 ( 2.31 %),721,1678290,2327.73,326,1044710,3205,633580
2009-07-01,65 ( -4.41 %),762,1614290,2118.49,509,2046370,4020,-432080
2009-06-30,68 ( -4.9 %),596,1252580,2101.64,570,2086270,3660,-833690
2009-06-29,71.5 ( -1.38 %),383,850100,2219.58,553,1178210,2131,-328110
2009-06-26,72.5 ( 0.69 %),572,1495480,2614.48,668,2132050,3192,-636570
2009-06-25,72 ( 1.41 %),757,2273920,3003.86,992,3515720,3544,-1241800
2009-06-24,71 ( 4.41 %),855,2462070,2879.61,140,846370,6046,1615700
2009-06-23,68 ( -4.23 %),720,1785870,2480.38,644,1679240,2608,106630
2009-06-22,71 ( -4.05 %),340,1378740,4055.12,771,1910360,2478,-531620
2009-06-19,74 ( 0.68 %),762,1702180,2233.83,903,2687450,2976,-985270
2009-06-18,73.5 ( 5 %),826,2310550,2797.28,302,1359370,4501,951180
2009-06-17,70 ( 4.48 %),1001,3126000,3122.88,415,2030320,4892,1095680
2009-06-16,67 ( -2.9 %),476,1716630,3606.37,550,1767630,3214,-51000
2009-06-15,69 ( -4.83 %),489,1436930,2938.51,689,2071650,3007,-634720
2009-06-12,72.5 ( 0 %),1103,2397600,2173.71,772,2819070,3652,-421470
2009-06-11,72.5 ( 0 %),882,2156010,2444.46,703,2095330,2981,60680
2009-06-10,72.5 ( -4.61 %),316,845140,2674.49,846,2361500,2791,-1516360
2009-06-09,76 ( 3.4 %),804,1944600,2418.66,863,2360890,2736,-416290
2009-06-08,73.5 ( 5 %),702,1808370,2576.03,248,1168800,4713,639570
2009-06-05,70 ( 4.48 %),1103,2952040,2676.37,543,3011800,5547,-59760
2009-06-04,67 ( 4.69 %),687,2035080,2962.27,743,1611470,2169,423610
2009-06-03,64 ( 3.23 %),930,2499640,2687.78,611,1802060,2949,697580
2009-06-02,62 ( -1.59 %),724,1338330,1848.52,763,2143130,2809,-804800
2009-06-01,63 ( 2.44 %),560,1124990,2008.91,318,848920,2670,276070
2009-05-29,61.5 ( -3.91 %),779,1533290,1968.28,327,1652770,5054,-119480
2009-05-28,64 ( -4.48 %),429,643950,1501.05,536,1680720,3136,-1036770
2009-05-27,67 ( 4.69 %),1600,4369430,2730.89,688,4107820,5971,261610
2009-05-26,64 ( 2.4 %),452,1292280,2859.03,532,1380580,2595,-88300
2009-05-25,62.5 ( 4.17 %),416,902950,2170.55,281,895680,3187,7270
2009-05-22,60 ( -4 %),248,431270,1738.99,414,856490,2069,-425220
2009-05-21,62.5 ( 4.17 %),767,1714000,2234.68,562,1381260,2458,332740
2009-05-20,60 ( 0 %),361,686790,1902.47,361,476270,1319,210520
2009-05-19,60 ( 0 %),284,434020,1528.24,437,944440,2161,-510420
2009-05-18,60 ( 0 %),268,559950,2089.37,350,813570,2324,-253620
2009-05-15,60 ( 4.35 %),420,968900,2306.9,246,549720,2235,419180
2009-05-14,57.5 ( -1.71 %),402,512450,1274.75,204,353500,1733,158950
2009-05-13,58.5 ( -0.85 %),419,682870,1629.76,290,683020,2355,-150
2009-05-12,59 ( 0.85 %),552,711470,1288.89,199,404530,2033,306940
2009-05-11,58.5 ( -0.85 %),476,602720,1266.22,303,566180,1869,36540
2009-05-08,59 ( -1.67 %),328,706180,2152.99,249,623690,2505,82490
2009-05-07,60 ( 0.84 %),416,809880,1946.83,291,813800,2797,-3920
2009-05-06,59.5 ( -4.8 %),180,295650,1642.5,384,763690,1989,-468040
2009-05-05,62.5 ( 3.31 %),674,1057770,1569.39,406,1266620,3120,-208850
2009-05-04,60.5 ( 4.31 %),199,579850,2913.82,103,197330,1916,382520
2009-04-29,58 ( 0 %),150,357090,2380.6,234,345200,1475,11890
2009-04-28,58 ( 0 %),106,422840,3989.06,241,370060,1536,52780
2009-04-27,58 ( 1.75 %),101,325500,3222.77,192,316350,1648,9150
2009-04-24,57 ( 4.59 %),329,480220,1459.64,145,255080,1759,225140
2009-04-23,54.5 ( -4.39 %),218,474880,2178.35,183,466650,2550,8230
2009-04-22,57 ( 3.64 %),590,1036130,1756.15,251,763690,3043,272440
2009-04-21,55 ( -4.35 %),70,59410,848.71,315,1014620,3221,-955210
2009-04-20,57.5 ( -4.96 %),47,48070,1022.77,332,1187520,3577,-1139450
2009-04-17,60.5 ( -4.72 %),235,414300,1762.98,263,831740,3163,-417440
2009-04-16,63.5 ( -4.51 %),441,526670,1194.26,216,1272590,5892,-745920
2009-04-15,66.5 ( -5 %),238,302030,1269.03,208,688150,3308,-386120
2009-04-14,70 ( 3.7 %),442,579680,1311.49,199,816160,4101,-236480
2009-04-13,67.5 ( 4.65 %),428,1606080,3752.52,117,1347550,11518,258530
2009-04-10,64.5 ( 4.88 %),547,3177570,5809.09,74,736820,9957,2440750
2009-04-09,61.5 ( 4.24 %),275,1090380,3965.02,107,340730,3184,749650
2009-04-08,59 ( 0.85 %),97,269040,2773.61,170,399650,2351,-130610
2009-04-07,58.5 ( 4.46 %),148,548450,3705.74,131,392460,2996,155990
2009-04-03,56 ( 4.67 %),123,266820,2169.27,154,256000,1662,10820
2009-04-02,53.5 ( 0 %),90,61080,678.67,110,99920,908,-38840
2009-04-01,53.5 ( -0.93 %),73,48830,668.9,83,86070,1037,-37240
2009-03-31,54 ( 2.86 %),143,179040,1252.03,60,115850,1931,63190
2009-03-30,52.5 ( -0.94 %),39,45580,1168.72,58,72910,1257,-27330
2009-03-27,53 ( 0 %),81,44700,551.85,100,99700,997,-55000
2009-03-26,53 ( 0 %),77,94290,1224.55,87,68000,782,26290
2009-03-25,53 ( 0.95 %),84,92390,1099.88,72,64650,898,27740
2009-03-24,52.5 ( 0 %),170,190280,1119.29,98,168960,1724,21320
2009-03-23,52.5 ( -2.78 %),42,44730,1065,60,65790,1096,-21060
2009-03-20,54 ( 0 %),72,55490,770.69,58,73800,1272,-18310
2009-03-19,54 ( -1.82 %),71,65270,919.3,118,146870,1245,-81600
2009-03-18,55 ( 1.85 %),127,121930,960.08,115,165190,1436,-43260
2009-03-17,54 ( 1.89 %),86,57040,663.26,83,101500,1223,-44460
2009-03-16,53 ( 0 %),76,61450,808.55,46,76170,1656,-14720
2009-03-13,53 ( -1.85 %),65,47280,727.38,82,103420,1261,-56140
2009-03-12,54 ( 0 %),52,48770,937.88,63,47690,757,1080
2009-03-11,54 ( 0 %),68,39020,573.82,73,105520,1445,-66500
2009-03-10,54 ( 0 %),156,83810,537.24,78,192970,2474,-109160
2009-03-09,54 ( 4.85 %),235,214590,913.15,61,123760,2029,90830
2009-03-06,51.5 ( 0 %),41,19600,478.05,52,31750,611,-12150
2009-03-05,51.5 ( 3 %),36,58970,1638.06,57,54190,951,4780
2009-03-04,50 ( 3.09 %),45,31680,704,19,25930,1365,5750
2009-03-03,48.5 ( -3.96 %),44,21000,477.27,36,25330,704,-4330
2009-03-02,52 ( 1.96 %),65,27970,430.31,44,46350,1053,-18380
2009-02-27,52 ( 1.96 %),43,40450,940.7,36,20990,583,19460
2009-02-26,51 ( 2.41 %),34,21340,627.65,54,37780,700,-16440
2009-02-25,49.8 ( 4.84 %),68,67130,987.21,22,38420,1746,28710
2009-02-24,47.5 ( -5 %),40,66240,1656,44,83260,1892,-17020
2009-02-23,50 ( -4.76 %),56,114530,2045.18,70,63280,904,51250
2009-02-20,52.5 ( -1.87 %),64,109520,1711.25,48,51070,1064,58450
2009-02-19,53.5 ( -0.93 %),85,110970,1305.53,47,76940,1637,34030
2009-02-18,54 ( -3.57 %),81,98180,1212.1,41,71170,1736,27010
2009-02-17,56 ( -3.45 %),56,94970,1695.89,33,69370,2102,25600
2009-02-16,58 ( -0.85 %),45,89220,1982.67,27,35630,1320,53590
2009-02-13,58.5 ( -3.31 %),47,56890,1210.43,41,54900,1339,1990
2009-02-12,60.5 ( 4.31 %),74,223900,3025.68,120,165700,1381,58200
2009-02-11,58 ( 0 %),44,88480,2010.91,48,47260,985,41220
2009-02-10,58 ( -0.85 %),53,84830,1600.57,76,58890,775,25940
2009-02-09,58.5 ( 4.46 %),64,102470,1601.09,21,18660,889,83810
2009-02-06,56 ( 0.9 %),92,124720,1355.65,33,39800,1206,84920
2009-02-05,55.5 ( -4.31 %),68,129400,1902.94,69,133250,1931,-3850
2009-02-04,58 ( -1.69 %),51,74420,1459.22,47,58120,1237,16300
2009-02-03,59 ( -1.67 %),40,140410,3510.25,67,111000,1657,29410
2009-02-02,60 ( -0.83 %),38,125400,3300,61,78530,1287,46870
2009-01-23,60.5 ( 0 %),51,97460,1910.98,39,36450,935,61010
2009-01-22,60.5 ( 0.83 %),46,123530,2685.43,44,72780,1654,50750
2009-01-21,60 ( 0 %),33,136560,4138.18,60,66030,1100,70530
2009-01-20,60 ( 0 %),37,145060,3920.54,61,62010,1017,83050
2009-01-19,60 ( 0 %),28,114150,4076.79,69,97900,1419,16250
2009-01-16,60 ( 1.69 %),37,93010,2513.78,75,82020,1094,10990
2009-01-15,59 ( -1.67 %),37,89170,2410,61,83110,1362,6060
2009-01-14,60 ( 0.84 %),81,147720,1823.7,75,101250,1350,46470
2009-01-13,59.5 ( -1.65 %),58,96620,1665.86,75,75230,1003,21390
2009-01-12,60.5 ( -0.82 %),68,118180,1737.94,54,80810,1496,37370
2009-01-09,61 ( 1.67 %),101,200370,1983.86,92,103190,1122,97180
2009-01-08,60 ( -1.64 %),141,201790,1431.13,88,177760,2020,24030
2009-01-07,61 ( 0 %),94,170390,1812.66,111,206200,1858,-35810
2009-01-06,61 ( 0 %),87,119940,1378.62,83,185030,2229,-65090
2009-01-05,61 ( 1.67 %),153,206340,1348.63,106,184820,1744,21520
2009-01-02,60 ( -4.76 %),73,57640,789.59,137,236840,1729,-179200
2008-12-31,63 ( 0 %),191,149770,784.14,103,199020,1932,-49250
2008-12-30,63 ( 5 %),262,283850,1083.4,43,214180,4981,69670
2008-12-29,60 ( 4.35 %),186,210900,1133.87,18,84900,4717,126000
2008-12-26,57.5 ( 4.55 %),273,642260,2352.6,64,324630,5072,317630
2008-12-25,55 ( 4.86 %),251,613110,2442.67,16,156110,9757,457000
2008-12-24,52.5 ( 5 %),236,743750,3151.48,1,1000,1000,742750
2008-12-23,50 ( 4.6 %),363,1163770,3205.98,2,3010,1505,1160760
2008-12-22,48 ( 20 %),416,1292000,3105.77,3,2830,943,1289170
