Ngày,Thay đổi,Số lệnh mua,Kl mua,KLTB 1 lệnh mua,Số lệnh bán,Kl bán,KLTB 1 lệnh bán,Kl ròng
2025-05-07,57.2 ( 0.53 %),0,0,0,0,0,0,0
2025-05-06,56.9 ( 0 %),0,0,0,0,0,0,0
2025-05-05,56.9 ( -1.22 %),0,0,0,0,0,0,0
2025-04-29,57.6 ( 0.17 %),2738,4674900,1707.41,2891,6285200,2174,-1610300
2025-04-28,57.5 ( -1.37 %),3965,4477200,1129.18,3818,6986100,1830,-2508900
2025-04-25,58.3 ( 3.55 %),5626,12683100,2254.37,7962,13847900,1739,-1164800
2025-04-24,56.3 ( -0.18 %),3801,4831800,1271.19,3842,4708600,1226,123200
2025-04-23,56.4 ( 0.71 %),3290,6133800,1864.38,4460,7489300,1679,-1355500
2025-04-22,56 ( -1.23 %),9282,13193300,1421.39,4940,11113600,2250,2079700
2025-04-21,56.7 ( 0.18 %),4228,5509200,1303.03,3987,6359000,1595,-849800
2025-04-18,56.6 ( 1.07 %),4444,5895100,1326.53,5252,7475400,1423,-1580300
2025-04-17,56 ( 0 %),9235,13505600,1462.44,4266,11092600,2600,2413000
2025-04-16,56 ( -0.53 %),4572,5747900,1257.2,4347,7513600,1728,-1765700
2025-04-15,56.3 ( -1.05 %),6174,7686100,1244.91,4260,8111700,1904,-425600
2025-04-14,56.9 ( -1.04 %),8575,9844800,1148.08,4745,9802500,2066,42300
2025-04-11,57.5 ( 3.42 %),10304,16937100,1643.74,8198,18318600,2235,-1381500
2025-04-10,55.6 ( 6.92 %),8483,18924800,2230.91,377,1514300,4017,17410500
2025-04-09,52 ( -4.59 %),12252,21423600,1748.58,5897,14576600,2472,6847000
2025-04-08,54.5 ( -6.84 %),13652,17308200,1267.81,5144,19934000,3875,-2625800
2025-04-04,58.5 ( 3.54 %),13907,21139100,1520.03,7640,14825700,1941,6313400
2025-04-03,56.5 ( -6.61 %),18662,25096800,1344.81,7772,24165400,3109,931400
2025-04-02,60.5 ( -0.49 %),5561,11702900,2104.46,3721,11487300,3087,215600
2025-04-01,60.8 ( 0.33 %),5764,6045300,1048.8,3214,6631800,2063,-586500
2025-03-31,60.6 ( 0.5 %),5754,8934000,1552.66,4888,8298100,1698,635900
2025-03-28,60.3 ( -1.31 %),10160,9510000,936.02,3917,9348500,2387,161500
2025-03-27,61.1 ( -0.16 %),3932,4721300,1200.74,2252,4551100,2021,170200
2025-03-26,61.2 ( -0.33 %),3644,3976600,1091.27,3445,4293700,1246,-317100
2025-03-25,61.4 ( 0 %),4135,5349500,1293.71,3158,4765000,1509,584500
2025-03-24,61.4 ( 0.16 %),4056,5208200,1284.07,2174,5807500,2671,-599300
2025-03-21,61.3 ( -0.81 %),6003,5796100,965.53,3100,6106200,1970,-310100
2025-03-20,61.8 ( -0.8 %),6044,6956600,1150.99,2759,8146100,2953,-1189500
2025-03-19,62.3 ( -0.32 %),4673,5498700,1176.7,3681,7765300,2110,-2266600
2025-03-18,62.5 ( -0.79 %),3367,5468400,1624.12,4062,8285600,2040,-2817200
2025-03-17,63 ( 1.45 %),3195,12853800,4023.1,5872,9970200,1698,2883600
2025-03-14,62.1 ( 0.16 %),3144,5392500,1715.17,3537,6713700,1898,-1321200
2025-03-12,62.2 ( -0.32 %),3977,5315000,1336.43,3861,6225000,1612,-910000
2025-03-11,62.4 ( -0.16 %),4310,5075500,1177.61,2229,5186900,2327,-111400
2025-03-10,62.5 ( -0.32 %),3029,4727500,1560.75,3288,6016700,1830,-1289200
2025-03-07,62.7 ( -0.32 %),3932,5547500,1410.86,2969,5645800,1902,-98300
2025-03-06,0 ( 0 %),4922,6061200,1231.45,3052,6362000,2085,-300800
2025-03-05,62.7 ( -1.26 %),3880,3650200,940.77,3351,8189400,2444,-4539200
2025-03-04,63.5 ( 0.47 %),4400,24907400,5660.77,7450,11748000,1577,13159400
2025-03-03,63.2 ( 1.61 %),3168,9513100,3002.87,3834,7018800,1831,2494300
2025-02-28,62.2 ( 0 %),3429,8566600,2498.28,4033,9730400,2413,-1163800
2025-02-27,62.2 ( -1.43 %),5005,6117500,1222.28,3891,8240900,2118,-2123400
2025-02-26,63.1 ( 0.32 %),2991,5598100,1871.65,3670,8599700,2343,-3001600
2025-02-25,62.9 ( -1.41 %),4731,7354400,1554.51,5119,11100700,2169,-3746300
2025-02-24,63.8 ( 3.91 %),6899,42864800,6213.19,10460,19965400,1909,22899400
2025-02-21,61.4 ( 1.15 %),5732,9629600,1679.97,6126,10648900,1738,-1019300
2025-02-20,60.7 ( -0.16 %),4001,6646600,1661.23,3023,5923700,1960,722900
2025-02-19,60.8 ( 0.83 %),4491,11172500,2487.75,4146,6548300,1579,4624200
2025-02-18,60.3 ( 0.5 %),5160,8960600,1736.55,3005,5393000,1795,3567600
2025-02-17,60 ( -0.5 %),6944,9225900,1328.61,3468,7330000,2114,1895900
2025-02-14,60.3 ( -0.66 %),6467,13345400,2063.62,2873,10323200,3593,3022200
2025-02-13,60.7 ( -0.49 %),4814,6417200,1333.03,3221,5847700,1815,569500
2025-02-12,61 ( 0.99 %),2993,9463000,3161.71,2938,6318400,2151,3144600
2025-02-11,60.4 ( -0.33 %),6321,8688800,1374.59,3766,6997300,1858,1691500
2025-02-10,60.6 ( -0.33 %),3821,6613400,1730.8,2320,4838300,2085,1775100
2025-02-07,60.8 ( 0.16 %),4549,6222800,1367.95,2556,4619300,1807,1603500
2025-02-06,60.7 ( -1.3 %),5254,6524100,1241.74,2543,5984300,2353,539800
2025-02-05,61.5 ( 2.16 %),5683,8940300,1573.17,4542,5084700,1119,3855600
2025-02-04,60.2 ( -0.5 %),10566,12986800,1229.11,2972,9008300,3031,3978500
2025-02-03,0 ( 0 %),10012,10600700,1058.8,3013,11723200,3891,-1122500
2025-01-24,62.2 ( 0.32 %),2173,4873600,2242.8,1893,3194600,1688,1679000
2025-01-23,62 ( 0.65 %),1872,3970000,2120.73,1755,3249000,1851,721000
2025-01-22,61.6 ( -0.32 %),2155,3600600,1670.81,1520,3826600,2518,-226000
2025-01-21,61.8 ( -0.16 %),2342,4492700,1918.32,2268,3398300,1498,1094400
2025-01-20,61.9 ( -0.16 %),2312,3630400,1570.24,1747,3893900,2229,-263500
2025-01-17,62 ( 0.16 %),1573,2414100,1534.71,1566,2635000,1683,-220900
2025-01-16,61.9 ( 0.32 %),2360,3800800,1610.51,2269,3601400,1587,199400
2025-01-15,61.7 ( 0.16 %),2296,3860200,1681.27,1695,2978900,1757,881300
2025-01-14,61.6 ( 0.33 %),2191,3512300,1603.06,1409,2682200,1904,830100
2025-01-13,61.4 ( 0.16 %),2333,4068600,1743.93,1671,2410000,1442,1658600
2025-01-10,61.3 ( -0.81 %),2532,2662200,1051.42,1707,2780000,1629,-117800
2025-01-09,61.8 ( 0.16 %),3689,3849400,1043.48,4009,2984500,744,864900
2025-01-08,61.7 ( 0 %),4383,4272100,974.7,4528,3606600,797,665500
2025-01-07,61.7 ( -1.28 %),5360,4048600,755.34,4746,4088800,862,-40200
2025-01-06,62.5 ( -0.79 %),3627,3017300,831.9,3250,3472700,1069,-455400
2025-01-03,63 ( -0.16 %),3992,3316000,830.66,2909,3723100,1280,-407100
2025-01-02,63.1 ( -0.47 %),3615,2560400,708.27,2166,2828100,1306,-267700
2024-12-31,63.4 ( 0.16 %),2270,2851900,1256.34,1590,3660200,2302,-808300
2024-12-30,63.3 ( -0.78 %),3534,2787000,788.62,2087,3288300,1576,-501300
2024-12-27,63.8 ( 0 %),2473,3961700,1601.98,4203,4206400,1001,-244700
2024-12-26,63.8 ( -0.16 %),3403,3296300,968.65,3587,4253900,1186,-957600
2024-12-25,64.4 ( 0.16 %),1914,2595800,1356.22,2324,3904400,1680,-1308600
2024-12-24,64.3 ( -0.16 %),2784,3339800,1199.64,3632,3400600,936,-60800
2024-12-23,64.4 ( -0.92 %),2478,2705200,1091.69,2935,3961000,1350,-1255800
2024-12-20,65 ( 1.72 %),2444,5771700,2361.58,4005,7599000,1897,-1827300
2024-12-19,63.9 ( -1.24 %),4146,4558900,1099.59,1720,4624200,2688,-65300
2024-12-18,64.7 ( 0.15 %),1893,2634100,1391.49,2591,4429800,1710,-1795700
2024-12-17,64.6 ( -0.62 %),4324,2328800,538.58,2035,3587100,1763,-1258300
2024-12-16,65 ( 1.25 %),2659,4021400,1512.37,2678,4010100,1497,11300
2024-12-13,64.2 ( -0.62 %),3110,3363800,1081.61,1745,3556700,2038,-192900
2024-12-12,64.6 ( 0.62 %),2357,4678800,1985.07,3214,5092300,1584,-413500
2024-12-11,64.2 ( 0.47 %),2813,4311600,1532.74,3114,3932900,1263,378700
2024-12-10,63.9 ( -0.31 %),3489,3601700,1032.3,2857,3619100,1267,-17400
2024-12-09,64.1 ( 0 %),3402,3803100,1117.9,3449,3693900,1071,109200
2024-12-06,64.1 ( -0.31 %),2496,3111200,1246.47,2604,4243400,1630,-1132200
2024-12-05,64.3 ( 1.58 %),4106,4814000,1172.43,2487,3740600,1504,1073400
2024-12-04,63.3 ( -0.94 %),5249,4688500,893.22,1714,4466800,2606,221700
2024-12-03,63.9 ( -0.93 %),3866,3765100,973.9,2763,4588900,1661,-823800
2024-12-02,64.5 ( -0.15 %),1952,1890600,968.55,2281,2914100,1278,-1023500
2024-11-29,64.6 ( 0.16 %),1777,2141300,1205.01,1597,3096500,1939,-955200
2024-11-28,64.5 ( -0.15 %),1417,2137100,1508.19,1963,3130700,1595,-993600
2024-11-27,64.6 ( -0.31 %),1844,2910900,1578.58,1816,3631600,2000,-720700
2024-11-26,64.8 ( 0.78 %),2073,3664400,1767.68,2365,4116600,1741,-452200
2024-11-25,64.3 ( 0 %),3085,3548900,1150.37,3383,4170300,1233,-621400
2024-11-22,64.3 ( 0.63 %),2879,4005400,1391.25,3183,5267700,1655,-1262300
2024-11-21,63.9 ( 0.47 %),3101,4686300,1511.22,2464,4316400,1752,369900
2024-11-20,63.6 ( 0.95 %),4936,5347600,1083.39,3455,4460600,1291,887000
2024-11-19,63 ( -0.32 %),4259,5209300,1223.13,2440,4278900,1754,930400
2024-11-18,63.2 ( -0.78 %),4898,5773600,1178.77,3046,5871300,1928,-97700
2024-11-14,65 ( 0 %),4100,3572400,871.32,1568,3145600,2006,426800
2024-11-13,65 ( 0.15 %),3520,4779700,1357.87,2246,3953800,1760,825900
2024-11-12,64.9 ( -0.46 %),3785,3105500,820.48,2040,3638500,1784,-533000
2024-11-11,65.2 ( -0.76 %),5901,5074400,859.92,1901,4438000,2335,636400
2024-11-08,65.7 ( -0.3 %),2384,2728100,1144.34,1765,3851500,2182,-1123400
2024-11-07,65.9 ( 0.15 %),2660,2602600,978.42,1663,2532500,1523,70100
2024-11-06,65.8 ( 0.46 %),5275,4889200,926.86,1768,4115500,2328,773700
2024-11-05,0 ( 0 %),3233,2654900,821.19,1952,2262900,1159,392000
2024-11-04,65.6 ( -0.3 %),2696,3352100,1243.36,2324,4072200,1752,-720100
2024-11-01,65.8 ( -0.45 %),3756,3933000,1047.12,1803,3387300,1879,545700
2024-10-31,66.1 ( -0.3 %),8996,9530200,1059.38,2802,8884700,3171,645500
2024-10-30,66.3 ( -1.04 %),5211,5374200,1031.32,2568,5344300,2081,29900
2024-10-29,67 ( -0.3 %),4044,4003800,990.06,2108,4207500,1996,-203700
2024-10-28,67.2 ( -1.18 %),4146,4331300,1044.69,1647,5636500,3422,-1305200
2024-10-25,68 ( -0.58 %),2278,3429800,1505.62,2225,5284500,2375,-1854700
2024-10-24,68.4 ( 1.63 %),3926,7603000,1936.58,6009,8829900,1469,-1226900
2024-10-23,67.3 ( 0 %),2397,3306500,1379.43,1540,3464200,2249,-157700
2024-10-22,67.3 ( 0 %),2078,3775300,1816.79,2264,4640900,2050,-865600
2024-10-21,67.3 ( -0.15 %),2274,3532700,1553.52,2599,4270400,1643,-737700
2024-10-18,67.4 ( -0.3 %),1952,2989800,1531.66,2175,4528800,2082,-1539000
2024-10-17,67.6 ( 0.15 %),1975,3597300,1821.42,2397,4271800,1782,-674500
2024-10-16,67.5 ( 1.05 %),3305,5942500,1798.03,3716,4919300,1324,1023200
2024-10-15,66.8 ( -0.6 %),5580,6211300,1113.14,2685,5417800,2018,793500
2024-10-14,67.2 ( -0.74 %),4911,5864500,1194.16,2918,5072700,1738,791800
2024-10-11,67.7 ( 0 %),4102,5532500,1348.73,2479,4933000,1990,599500
2024-10-10,67.7 ( -0.15 %),3370,4723900,1401.75,2895,5727000,1978,-1003100
2024-10-09,67.8 ( -0.59 %),3707,5830700,1572.89,4171,6790900,1628,-960200
2024-10-08,68.2 ( 1.64 %),4151,6548900,1577.67,2985,5110700,1712,1438200
2024-10-07,67.1 ( -2.04 %),7035,9250200,1314.88,2661,9778500,3675,-528300
2024-10-04,68.5 ( -2.56 %),6721,8301400,1235.14,4427,11998700,2710,-3697300
2024-10-03,70.3 ( 0.29 %),2097,4935100,2353.41,3292,5223200,1587,-288100
2024-10-02,70.1 ( 0 %),3269,3947700,1207.62,1860,4592900,2469,-645200
2024-10-01,70.1 ( 0 %),2804,4133800,1474.25,2577,4716100,1830,-582300
2024-09-30,70.1 ( -1.27 %),2478,3592000,1449.56,1905,4248000,2230,-656000
2024-09-27,71 ( 0.42 %),2065,4471000,2165.13,3709,7250500,1955,-2779500
2024-09-26,70.7 ( 1.58 %),4836,7445500,1539.6,3597,7046200,1959,399300
2024-09-25,69.6 ( -1 %),6725,7015300,1043.17,4406,7694000,1746,-678700
2024-09-24,70.3 ( -0.21 %),3328,3628400,1090.26,2053,5195000,2530,-1566600
2024-09-23,72.9 ( 0.28 %),2924,4746300,1623.22,2799,6337600,2264,-1591300
2024-09-20,72.7 ( -0.82 %),3735,11093900,2970.25,3860,11563300,2996,-469400
2024-09-19,73.3 ( 0 %),2019,2998300,1485.04,1907,4756500,2494,-1758200
2024-09-18,73.3 ( -0.14 %),2691,4497400,1671.27,2652,6134900,2313,-1637500
2024-09-17,73.4 ( 2.09 %),3195,6959100,2178.12,1857,4902200,2640,2056900
2024-09-16,71.9 ( -1.37 %),4906,7480700,1524.81,4329,7102600,1641,378100
2024-09-13,72.9 ( -2.41 %),5138,7901300,1537.82,3493,10599800,3035,-2698500
2024-09-12,74.7 ( 0.13 %),1915,3969000,2072.58,2943,5488100,1865,-1519100
2024-09-11,74.6 ( -0.4 %),3135,7334000,2339.39,2563,6634500,2589,699500
2024-09-10,74.9 ( 0.13 %),2481,7115400,2867.96,4418,8430500,1908,-1315100
2024-09-09,74.8 ( -0.8 %),2822,4840800,1715.38,2825,4960600,1756,-119800
2024-09-06,75.4 ( 0.94 %),2952,7224200,2447.22,4401,8135900,1849,-911700
2024-09-05,74.7 ( 0.54 %),4150,8980200,2163.9,5040,11622800,2306,-2642600
2024-09-04,74.3 ( 0.54 %),3646,6075500,1666.35,3206,5384900,1680,690600
2024-08-30,73.9 ( 0.54 %),3497,6571900,1879.3,4559,7749500,1700,-1177600
2024-08-29,73.5 ( -0.54 %),2582,3807200,1474.52,3911,5229500,1337,-1422300
2024-08-28,73.9 ( 0.54 %),3343,6115700,1829.4,2793,7013700,2511,-898000
2024-08-27,73.5 ( 0.14 %),5295,9176200,1732.99,4270,7836300,1835,1339900
2024-08-26,73.4 ( -2 %),6784,10256100,1511.81,4175,11553800,2767,-1297700
2024-08-23,74.9 ( 0.94 %),3503,7835300,2236.74,4083,8099300,1984,-264000
2024-08-22,74.2 ( -1.46 %),6172,11355400,1839.83,5409,12843800,2375,-1488400
2024-08-21,75.3 ( -0.4 %),2787,8381600,3007.39,4013,8947200,2230,-565600
2024-08-20,75.6 ( -0.53 %),3996,6684500,1672.8,4182,10678200,2553,-3993700
2024-08-19,76 ( 2.98 %),4178,15334500,3670.3,7204,14626600,2030,707900
2024-08-16,73.8 ( 0 %),4528,12191800,2692.54,5162,16367300,3171,-4175500
2024-08-15,73.8 ( -0.27 %),3669,7831200,2134.42,4791,9908500,2068,-2077300
2024-08-14,74 ( 0.27 %),3524,9979300,2831.81,5357,12367300,2309,-2388000
2024-08-13,73.8 ( 1.1 %),3678,13776000,3745.51,6700,12352300,1844,1423700
2024-08-12,73 ( -0.41 %),3633,10695800,2944.07,5886,11870100,2017,-1174300
2024-08-08,0 ( 0 %),4570,10911100,2387.55,5707,13080700,2292,-2169600
2024-08-07,73.8 ( 1.51 %),5993,21276700,3550.26,8262,18017600,2181,3259100
2024-08-06,72.7 ( 4.76 %),6296,37047300,5884.26,10416,22743600,2184,14303700
2024-08-05,69.4 ( -2.94 %),7461,21379000,2865.43,6373,20057500,3147,1321500
2024-08-02,71.5 ( 1.71 %),6140,19895500,3240.31,8531,17025300,1996,2870200
2024-08-01,70.3 ( -1.82 %),5092,16508200,3241.99,11161,18696600,1675,-2188400
2024-07-31,71.6 ( 5.76 %),9499,51618100,5434.06,21078,33039300,1567,18578800
2024-07-30,67.7 ( 0.74 %),3386,11870500,3505.76,8921,14328400,1606,-2457900
2024-07-29,67.2 ( 2.13 %),2499,11284400,4515.57,8153,11788800,1446,-504400
2024-07-26,65.8 ( 0.3 %),2564,6750100,2632.64,3177,5969100,1879,781000
2024-07-25,65.6 ( 0 %),3072,4468200,1454.49,1584,3836300,2422,631900
2024-07-24,65.6 ( -0.46 %),2397,5960400,2486.61,2948,6365600,2159,-405200
2024-07-22,65.4 ( 0.15 %),3296,5584600,1694.36,2854,6161700,2159,-577100
2024-07-19,65.3 ( -0.91 %),6087,7183800,1180.19,3167,6017800,1900,1166000
2024-07-18,65.9 ( 0.3 %),3772,5292600,1403.13,2259,3972700,1759,1319900
2024-07-17,65.7 ( -0.61 %),3592,4971900,1384.16,3309,6115400,1848,-1143500
2024-07-16,66.1 ( -0.15 %),2273,4113400,1809.68,2801,4764700,1701,-651300
2024-07-15,66.2 ( -0.15 %),2471,4063000,1644.27,2586,4546000,1758,-483000
2024-07-12,66.3 ( 0 %),3332,5221000,1566.93,1752,4396600,2509,824400
2024-07-11,66.3 ( -0.75 %),3780,6788800,1795.98,2549,7682200,3014,-893400
2024-07-10,0 ( 0 %),3262,6352000,1947.27,4278,8733800,2042,-2381800
2024-07-09,67.5 ( -0.15 %),2980,9226700,3096.21,5080,10286300,2025,-1059600
2024-07-08,67.6 ( 0.6 %),3213,9640300,3000.4,6838,9334000,1365,306300
2024-07-05,67.2 ( 1.2 %),3185,8540100,2681.35,6729,9577700,1423,-1037600
2024-07-04,66.4 ( 0.3 %),2932,6690400,2281.86,4458,9701100,2176,-3010700
2024-07-03,66.2 ( 0 %),1863,2807000,1506.71,2923,4509800,1543,-1702800
2024-07-02,66.2 ( 0.3 %),2162,3721400,1721.28,3259,5208900,1598,-1487500
2024-07-01,66 ( 0.76 %),2467,4279900,1734.86,2090,4535600,2170,-255700
2024-06-28,65.5 ( 0.31 %),2689,4669800,1736.63,4104,5989300,1459,-1319500
2024-06-27,65.3 ( 0.15 %),3924,5955700,1517.76,2534,5334400,2105,621300
2024-06-26,65.2 ( -0.46 %),4294,4885100,1137.66,2136,5204800,2437,-319700
2024-06-25,65.5 ( 0 %),2735,4687100,1713.75,2976,5639500,1895,-952400
2024-06-24,65.5 ( -0.76 %),4204,5697100,1355.16,4096,7644700,1866,-1947600
2024-06-21,66 ( 0 %),3733,7699400,2062.52,5460,8900300,1630,-1200900
2024-06-20,66 ( 1.07 %),4154,7265100,1748.94,4877,8012500,1643,-747400
2024-06-19,65.3 ( -0.91 %),9812,9789900,997.75,4425,9617000,2173,172900
2024-06-18,65.9 ( -0.15 %),5125,5314600,1037,3097,6834900,2207,-1520300
2024-06-17,66 ( -0.3 %),5788,6860400,1185.28,4507,7221700,1602,-361300
2024-06-14,66.2 ( -1.05 %),3419,5884300,1721.06,4219,8919300,2114,-3035000
2024-06-13,66.9 ( -0.15 %),3098,5265800,1699.74,3483,7777800,2233,-2512000
2024-06-12,67 ( 0.75 %),5129,7685200,1498.38,3328,6494400,1951,1190800
2024-06-11,66.5 ( -1.04 %),7893,11810700,1496.35,3616,11444200,3165,366500
2024-06-10,67.2 ( -0.88 %),5504,7456000,1354.65,4833,10464800,2165,-3008800
2024-06-07,67.8 ( 0.89 %),4398,7804900,1774.65,5696,9978700,1752,-2173800
2024-06-06,67.2 ( -1.9 %),4725,7476600,1582.35,6818,13420400,1968,-5943800
2024-06-05,68.5 ( 3.79 %),8001,22479300,2809.56,16256,23029100,1417,-549800
2024-06-04,66 ( -0.15 %),3392,4946300,1458.23,3418,6731100,1969,-1784800
2024-06-03,66.1 ( 1.07 %),2745,5834200,2125.39,3753,6500300,1732,-666100
2024-05-31,65.4 ( -0.46 %),5672,7893200,1391.61,3047,6159900,2022,1733300
2024-05-30,65.7 ( -0.9 %),6187,7181500,1160.74,3206,7667600,2392,-486100
2024-05-29,66.3 ( -0.75 %),3938,5312500,1349.04,4458,7520200,1687,-2207700
2024-05-28,66.8 ( 1.06 %),3812,8657200,2271.04,5815,9869000,1697,-1211800
2024-05-27,66.1 ( 0.15 %),3121,4647900,1489.23,3779,5173800,1369,-525900
2024-05-24,66 ( -1.49 %),5187,7492400,1444.46,4405,7791200,1769,-298800
2024-05-23,67 ( 1.82 %),3827,5901900,1542.17,4022,5922600,1473,-20700
2024-05-22,65.8 ( -0.6 %),5690,6219500,1093.06,3438,6664800,1939,-445300
2024-05-21,66.2 ( -0.3 %),6112,6562400,1073.69,2335,6351200,2720,211200
2024-05-20,66.4 ( -0.9 %),6454,7438300,1152.51,4175,9904600,2372,-2466300
2024-05-17,67 ( -0.3 %),4276,6361600,1487.75,5377,8797600,1636,-2436000
2024-05-16,67.2 ( 0.3 %),2355,4401000,1868.79,4679,7121900,1522,-2720900
2024-05-15,67 ( 0.75 %),2472,5157600,2086.41,4579,7479800,1634,-2322200
2024-05-14,66.5 ( 1.06 %),2700,4781500,1770.93,3239,5228500,1614,-447000
2024-05-13,65.8 ( -1.05 %),5096,5214200,1023.19,2953,5492900,1860,-278700
2024-05-10,66.5 ( -0.15 %),3794,5646200,1488.19,2651,5484300,2069,161900
2024-05-09,66.6 ( -1.91 %),3892,5484300,1409.12,3371,7916300,2348,-2432000
2024-05-08,67.9 ( -0.15 %),3311,5191900,1568.08,4264,7542500,1769,-2350600
2024-05-07,68 ( 3.34 %),4057,15728100,3876.78,9357,14117400,1509,1610700
2024-05-06,65.8 ( 0.3 %),2819,3634200,1289.18,2848,5077700,1783,-1443500
2024-05-03,65.6 ( 0.31 %),2134,3853400,1805.72,2867,5832600,2034,-1979200
2024-05-02,65.4 ( 0.62 %),3141,3891400,1238.9,3314,5172300,1561,-1280900
2024-04-26,65 ( 0.46 %),3462,4940800,1427.15,3818,6346500,1662,-1405700
2024-04-25,64.7 ( 1.09 %),2993,4344000,1451.39,3022,4021400,1331,322600
2024-04-24,64 ( 0.79 %),3497,4474500,1279.53,2668,5719000,2144,-1244500
2024-04-23,63.5 ( -0.78 %),4529,3951000,872.38,2226,3848400,1729,102600
2024-04-22,64 ( -0.31 %),2850,3182100,1116.53,2554,4863900,1904,-1681800
2024-04-19,64.2 ( 0 %),6231,7154500,1148.21,3036,6704000,2208,450500
2024-04-17,64.2 ( 0.31 %),6859,7132000,1039.8,3384,7882800,2329,-750800
2024-04-16,64 ( -1.39 %),10184,10854400,1065.83,4698,10600600,2256,253800
2024-04-15,64.9 ( -2.7 %),7913,7751600,979.6,3320,10419500,3138,-2667900
2024-04-12,66.7 ( 0.15 %),4548,4997300,1098.79,2229,5567500,2498,-570200
2024-04-11,66.6 ( -0.3 %),7633,6681100,875.29,2155,5814400,2698,866700
2024-04-10,66.8 ( -0.3 %),4989,5293700,1061.07,2392,5457100,2281,-163400
2024-04-09,67 ( 0 %),4819,5198500,1078.75,2274,6069000,2669,-870500
2024-04-08,67 ( -1.33 %),5274,6188700,1173.44,4602,6738600,1464,-549900
2024-04-05,67.9 ( -0.44 %),3677,7486500,2036.03,7479,9345500,1250,-1859000
2024-04-04,68.2 ( 2.25 %),5292,13090800,2473.7,9012,14223000,1578,-1132200
2024-04-03,66.7 ( -0.89 %),8817,8276000,938.64,5787,7835900,1354,440100
2024-04-02,67.3 ( 0.45 %),8616,10256600,1190.41,3810,7040900,1848,3215700
2024-04-01,67 ( -0.89 %),9464,8491800,897.27,4021,8077900,2009,413900
2024-03-29,67.6 ( -0.15 %),6853,7548900,1101.55,3753,7044800,1877,504100
2024-03-28,67.7 ( 0 %),5188,8068400,1555.2,5152,9607200,1865,-1538800
2024-03-27,67.7 ( 0 %),5216,5338800,1023.54,3079,6959100,2260,-1620300
2024-03-26,67.7 ( 0.59 %),5218,5806300,1112.74,3571,6317900,1769,-511600
2024-03-25,67.3 ( -0.74 %),8598,9464900,1100.83,4279,9292700,2172,172200
2024-03-22,67.8 ( -0.88 %),9594,10377400,1081.66,5230,8996600,1720,1380800
2024-03-21,68.4 ( 0.59 %),5987,7943800,1326.84,5395,7230000,1340,713800
2024-03-20,68 ( 0.29 %),7069,7838200,1108.81,3332,5337200,1602,2501000
2024-03-19,67.8 ( -0.15 %),5425,6525200,1202.8,3318,4841500,1459,1683700
2024-03-18,67.9 ( -1.31 %),10862,11237900,1034.61,4237,10205900,2409,1032000
2024-03-15,68.8 ( -1.15 %),8678,8567800,987.3,3197,8616800,2695,-49000
2024-03-14,70.5 ( -0.42 %),6228,9383300,1506.63,4200,8871700,2112,511600
2024-03-13,70.8 ( 1.14 %),4554,9537200,2094.25,3735,8423100,2255,1114100
2024-03-12,70 ( -0.43 %),5335,6764800,1268,2137,6599700,3088,165100
2024-03-11,70.3 ( 0.43 %),6137,8643200,1408.38,2925,7149900,2444,1493300
2024-03-08,70 ( -2.78 %),8267,13109700,1585.79,4086,11964800,2928,1144900
2024-03-07,72 ( 0.28 %),5439,10369900,1906.58,2919,8494300,2910,1875600
2024-03-06,72.1 ( -1.23 %),4817,8623400,1790.2,3878,12508400,3225,-3885000
2024-03-05,73 ( 1.39 %),4020,11181700,2781.52,4088,8792900,2151,2388800
2024-03-04,72 ( 0.7 %),3741,10307900,2755.39,3796,8538800,2249,1769100
2024-03-01,71.5 ( -0.69 %),6126,7839600,1279.73,4328,8473300,1958,-633700
2024-02-29,72 ( -0.28 %),4404,12083100,2743.66,6476,12486000,1928,-402900
2024-02-28,72.2 ( 0.28 %),2721,7169800,2634.99,3573,8013200,2243,-843400
2024-02-27,72 ( 1.41 %),3282,11247000,3426.87,4790,10143900,2118,1103100
2024-02-26,71 ( 0 %),3320,5161400,1554.64,2684,6822300,2542,-1660900
2024-02-23,71 ( -0.84 %),4800,8487900,1768.31,5430,13221500,2435,-4733600
2024-02-22,71.6 ( 0.42 %),3353,8570600,2556.1,5185,9520900,1836,-950300
2024-02-21,71.3 ( -0.28 %),3659,7524200,2056.35,3879,7028500,1812,495700
2024-02-20,71.5 ( -0.56 %),4292,8890200,2071.34,5679,10322500,1818,-1432300
2024-02-19,71.9 ( 2.71 %),5808,13437900,2313.69,7216,13599800,1885,-161900
2024-02-16,70 ( 3.55 %),7715,22336900,2895.26,9018,16522400,1832,5814500
2024-02-15,67.6 ( 0 %),3636,6281900,1727.7,2605,8930100,3428,-2648200
2024-02-07,67.6 ( 0 %),0,0,0,0,0,0,0
2024-02-06,67.6 ( -0.59 %),3013,4060000,1347.49,2486,5593600,2250,-1533600
2024-02-05,68 ( 0.89 %),2746,6491000,2363.8,3998,7145000,1787,-654000
2024-02-02,67.4 ( -0.15 %),3927,4604600,1172.55,2025,6920900,3418,-2316300
2024-02-01,67.5 ( 0.75 %),2197,4204000,1913.52,3304,6369500,1928,-2165500
2024-01-31,67 ( 0.15 %),3780,6361500,1682.94,3475,8242300,2372,-1880800
2024-01-30,66.9 ( -0.15 %),3151,3144000,997.78,3099,4156100,1341,-1012100
2024-01-29,67 ( 0 %),3096,3575100,1154.75,2177,2984900,1371,590200
2024-01-26,67 ( 0.15 %),2861,3490900,1220.17,1580,3306100,2092,184800
2024-01-25,66.9 ( -0.59 %),5227,4994000,955.42,1760,4521800,2569,472200
2024-01-24,67.3 ( -0.59 %),3161,3792400,1199.75,2420,3808400,1574,-16000
2024-01-23,67.7 ( -0.88 %),3133,3375100,1077.27,2137,4010900,1877,-635800
2024-01-22,68.3 ( 0.44 %),1846,3624300,1963.33,3493,4875800,1396,-1251500
2024-01-19,68 ( 0.89 %),3049,5294100,1736.34,3958,5517300,1394,-223200
2024-01-18,67.4 ( 0.45 %),2220,2789300,1256.44,1770,3099200,1751,-309900
2024-01-17,67.1 ( -0.45 %),3273,3449100,1053.8,2423,3467200,1431,-18100
2024-01-16,67.4 ( 0.6 %),4637,4613000,994.82,3029,3559800,1175,1053200
2024-01-15,67 ( -0.3 %),3587,5134600,1431.45,3043,3497600,1149,1637000
2024-01-12,67.2 ( -1.03 %),5509,5981300,1085.73,2789,4816500,1727,1164800
2024-01-11,67.9 ( 0.59 %),3542,3945100,1113.81,1972,4030600,2044,-85500
2024-01-10,67.5 ( -0.88 %),0,0,0,0,0,0,0
2024-01-09,68.1 ( -0.15 %),2938,4920600,1674.81,2594,4073900,1571,846700
2024-01-08,68.2 ( -0.87 %),3174,4251800,1339.57,2658,4993900,1879,-742100
2024-01-05,68.8 ( -0.29 %),2439,3003600,1231.49,2699,3781300,1401,-777700
2024-01-04,69 ( 0 %),2321,5032600,2168.29,4226,7213700,1707,-2181100
2024-01-03,69 ( 1.02 %),2068,3695500,1786.99,2477,3410400,1377,285100
2024-01-02,68.3 ( 1.04 %),2515,4144400,1647.87,2966,4448800,1500,-304400
2023-12-29,67.6 ( -1.31 %),0,0,0,0,0,0,0
2023-12-28,68.5 ( 1.48 %),3577,4855200,1357.34,3448,4352100,1262,503100
2023-12-27,67.5 ( 0 %),2290,2725800,1190.31,2451,3547500,1447,-821700
2023-12-26,68 ( 0.15 %),4997,3343900,669.18,2584,5426700,2100,-2082800
2023-12-25,67.9 ( 0.44 %),2717,4162200,1531.91,2809,4412500,1571,-250300
2023-12-22,67.6 ( -0.29 %),9209,4246900,461.17,2840,3728100,1313,518800
2023-12-21,67.8 ( -0.44 %),6263,4983900,795.77,3322,4605800,1386,378100
2023-12-20,68.1 ( 1.64 %),6231,5057100,811.6,3302,4627700,1401,429400
2023-12-19,67 ( 0 %),5290,6004600,1135.09,3625,4521000,1247,1483600
2023-12-18,67 ( -1.62 %),5534,6142400,1109.94,3113,5522000,1774,620400
2023-12-15,68.1 ( -0.44 %),2782,5355900,1925.2,3127,7147700,2286,-1791800
2023-12-14,68.4 ( 0.29 %),2734,3278200,1199.05,2311,2576500,1115,701700
2023-12-13,68.2 ( -1.73 %),5837,6616600,1133.56,3501,6988200,1996,-371600
2023-12-12,69.4 ( -0.86 %),3971,4208000,1059.68,3130,5243100,1675,-1035100
2023-12-11,70 ( 1.45 %),3008,7339800,2440.09,6005,8142100,1356,-802300
2023-12-08,69 ( 0.88 %),3648,8292100,2273.05,4490,6348400,1414,1943700
2023-12-07,68.4 ( -0.15 %),5967,6782600,1136.69,5756,6924600,1203,-142000
2023-12-06,68.5 ( 0.59 %),2693,3242800,1204.16,2446,3078200,1258,164600
2023-12-05,68.1 ( -1.02 %),4048,4785800,1182.26,2738,4223000,1542,562800
2023-12-04,68.8 ( 0.58 %),2693,4596300,1706.76,3817,6269000,1642,-1672700
2023-12-01,68.4 ( 1.48 %),2301,3249300,1412.13,1776,2496200,1406,753100
2023-11-30,67.4 ( -1.46 %),2822,3592200,1272.93,1944,4111900,2115,-519700
2023-11-29,68.4 ( -0.15 %),2424,2891600,1192.9,1968,4011400,2038,-1119800
2023-11-28,68.5 ( 0.59 %),3452,3726200,1079.43,1880,3001800,1597,724400
2023-11-27,68.1 ( -0.29 %),2557,3063800,1198.2,1272,2522900,1983,540900
2023-11-24,68.3 ( -0.58 %),4490,5264700,1172.54,2154,4634800,2152,629900
2023-11-23,68.7 ( -1.01 %),2534,2927000,1155.09,2082,3431100,1648,-504100
2023-11-22,69.4 ( -0.14 %),2564,2977500,1161.27,1964,2868300,1460,109200
2023-11-21,69.5 ( 0.29 %),3902,5750200,1473.65,2702,4302100,1592,1448100
2023-11-20,69.3 ( -1 %),3449,3689600,1069.76,1974,2782900,1410,906700
2023-11-17,70 ( -0.43 %),3303,4032600,1220.89,2566,4499300,1753,-466700
2023-11-16,70.3 ( -0.57 %),3322,3993100,1202.02,2506,4257000,1699,-263900
2023-11-15,70.7 ( 2.61 %),3439,7416800,2156.67,4465,6483300,1452,933500
2023-11-14,68.9 ( 0.29 %),5228,5712600,1092.69,2232,4452100,1995,1260500
2023-11-13,68.7 ( -1.29 %),2987,3021000,1011.38,1491,3104800,2082,-83800
2023-11-10,69.6 ( -1.56 %),3266,4609900,1411.48,1907,4453000,2335,156900
2023-11-09,70.7 ( -0.98 %),3875,5074200,1309.47,4108,5923800,1442,-849600
2023-11-08,71.4 ( 0.85 %),2338,3905200,1670.32,2174,4140400,1905,-235200
2023-11-07,70.8 ( -0.28 %),1908,2495200,1307.76,1362,2823200,2073,-328000
2023-11-06,71 ( 1.43 %),1936,2230600,1152.17,3166,2921700,923,-691100
2023-11-03,70 ( -1.27 %),2350,2680100,1140.47,2433,3272500,1345,-592400
2023-11-01,70.4 ( 3.53 %),2432,3887400,1598.44,2458,3766400,1532,121000
2023-10-31,68 ( 0.59 %),2246,3489300,1553.56,2730,3753800,1375,-264500
2023-10-30,67.6 ( -0.59 %),1606,2024500,1260.59,1559,1901400,1220,123100
2023-10-27,68 ( 1.49 %),2895,4076700,1408.19,2959,2735500,924,1341200
2023-10-26,67 ( -2.9 %),6566,8215000,1251.14,2920,7028900,2407,1186100
2023-10-25,69 ( -1.85 %),2852,3517500,1233.35,2530,4247400,1679,-729900
2023-10-24,70.3 ( 0.14 %),1982,2836000,1430.88,1349,2170900,1609,665100
2023-10-23,70.2 ( -2.9 %),3547,4961300,1398.73,1804,3828000,2122,1133300
2023-10-20,72.3 ( 1.26 %),3613,4244300,1174.73,1743,3644800,2091,599500
2023-10-19,71.4 ( -3.38 %),4444,6083200,1368.86,2675,5567800,2081,515400
2023-10-18,73.9 ( -1.2 %),2757,3874300,1405.26,2855,4179500,1464,-305200
2023-10-17,0 ( 0 %),1393,2479600,1780.04,2092,2542600,1215,-63000
2023-10-16,75.2 ( -0.79 %),1671,2143000,1282.47,1255,2457900,1958,-314900
2023-10-13,75.8 ( 0.4 %),1063,2348200,2209.03,2261,2762200,1222,-414000
2023-10-12,75.5 ( 1.48 %),1264,3715400,2939.4,2734,3877900,1418,-162500
2023-10-11,74.4 ( 0 %),1472,2566700,1743.68,1353,2304600,1703,262100
2023-10-10,74.4 ( 0.95 %),1324,2590100,1956.27,2072,1901200,918,688900
2023-10-09,73.7 ( -0.67 %),1588,1847600,1163.48,1143,1507800,1319,339800
2023-10-06,74.2 ( 2.06 %),2029,3140500,1547.81,1547,1974700,1276,1165800
2023-10-05,72.7 ( -2.28 %),3172,4121600,1299.37,1653,3860800,2336,260800
2023-10-04,74.4 ( 0.54 %),3847,2731300,709.98,1185,1791300,1512,940000
2023-10-03,74 ( -2.12 %),2743,3991200,1455.05,1376,3127600,2273,863600
2023-10-02,75.6 ( 1.89 %),2058,3486500,1694.12,1424,1840000,1292,1646500
2023-09-29,74.2 ( -0.8 %),1791,3213400,1794.19,1446,2466500,1706,746900
2023-09-28,74.8 ( -2.35 %),3281,3567500,1087.32,1924,3263200,1696,304300
2023-09-27,76.6 ( 0.66 %),2564,4358300,1699.8,2375,3365600,1417,992700
2023-09-26,76.1 ( -1.93 %),2782,4017000,1443.93,3714,4230800,1139,-213800
2023-09-25,77.6 ( 0.13 %),2566,4327900,1686.63,3119,4970200,1594,-642300
2023-09-22,77.5 ( -0.64 %),4910,8461300,1723.28,2268,6197400,2733,2263900
2023-09-21,78 ( -0.38 %),3604,4327500,1200.75,1879,4232200,2252,95300
2023-09-20,78.3 ( -0.76 %),2504,3882500,1550.52,1419,3620200,2551,262300
2023-09-19,78.9 ( 0 %),3031,4805700,1585.52,1800,4447700,2471,358000
2023-09-18,78.9 ( -0.75 %),1616,2650200,1639.98,1798,2799400,1557,-149200
2023-09-15,79.5 ( 0.13 %),3294,8255300,2506.16,4980,8991600,1806,-736300
2023-09-14,79.4 ( 0.38 %),2605,4735600,1817.89,2081,4222000,2029,513600
2023-09-13,79.1 ( -1.49 %),3194,5458800,1709.08,4053,4827400,1191,631400
2023-09-12,80.3 ( 1.01 %),2272,6131600,2698.77,5334,4548600,853,1583000
2023-09-11,79.5 ( -0.62 %),3890,6323800,1625.66,3350,7146200,2133,-822400
2023-09-08,80 ( 0.63 %),1985,5337800,2689.07,2735,4313800,1577,1024000
2023-09-07,79.5 ( -0.62 %),3553,5367300,1510.64,3114,6282800,2018,-915500
2023-09-06,80 ( -0.12 %),2466,4439600,1800.32,3104,4383800,1412,55800
2023-09-05,80.1 ( 2.96 %),3488,12254100,3513.22,6759,9598800,1420,2655300
2023-08-31,77.8 ( 0 %),3122,7014500,2246.8,4252,7873500,1852,-859000
2023-08-30,77.8 ( 0.52 %),2775,5634400,2030.41,3055,5461700,1788,172700
2023-08-29,77.4 ( -0.64 %),4608,6170900,1339.17,3358,7267600,2164,-1096700
2023-08-28,77.9 ( 4.01 %),5119,9156600,1788.75,7601,8816300,1160,340300
2023-08-25,74.9 ( 0.27 %),4034,4709900,1167.55,4415,6024800,1365,-1314900
2023-08-24,74.7 ( 1.63 %),3878,6926700,1786.15,4980,7248300,1455,-321600
2023-08-23,73.5 ( 1.1 %),4276,6779200,1585.41,3677,5482500,1491,1296700
2023-08-22,72.7 ( -0.27 %),4412,5662000,1283.32,2712,5533200,2040,128800
2023-08-21,72.9 ( -0.55 %),3855,6325600,1640.88,3418,5418000,1585,907600
2023-08-18,73.3 ( -0.41 %),4285,8812900,2056.69,6959,12957500,1862,-4144600
2023-08-17,73.6 ( 0.68 %),3312,8192500,2473.58,5318,8051900,1514,140600
2023-08-16,73.1 ( 0.41 %),2771,3940800,1422.16,2603,4264900,1638,-324100
2023-08-15,72.8 ( -0.82 %),3155,3868200,1226.05,2698,3956000,1466,-87800
2023-08-14,73.4 ( -0.14 %),2551,4980300,1952.29,3413,5884300,1724,-904000
2023-08-11,73.5 ( 0.55 %),2871,3797700,1322.78,2351,4499300,1914,-701600
2023-08-10,73.1 ( 0 %),2140,4690900,2192.01,3612,5846900,1619,-1156000
2023-08-09,73.1 ( -1.88 %),3240,5206700,1607.01,2836,8912900,3143,-3706200
2023-08-08,74.5 ( -0.53 %),2317,5706800,2463.01,3125,7303700,2337,-1596900
2023-08-07,74.9 ( 2.6 %),3336,8350400,2503.12,3322,6559800,1975,1790600
2023-08-04,73 ( 0.55 %),4276,6938300,1622.61,1768,5077700,2872,1860600
2023-08-03,72.6 ( -1.36 %),4119,4659600,1131.25,1778,5225800,2939,-566200
2023-08-02,76.1 ( 0.13 %),3578,5048700,1411.04,3040,4794700,1577,254000
2023-08-01,76 ( -2.56 %),4031,7642100,1895.83,3918,10662100,2721,-3020000
2023-07-31,78 ( 0.78 %),2607,6454600,2475.87,3372,6359200,1886,95400
2023-07-28,77.4 ( 2.25 %),2688,9706300,3610.97,4949,8651100,1748,1055200
2023-07-27,75.7 ( 0.93 %),3080,7144900,2319.77,4188,6592900,1574,552000
2023-07-26,75 ( 0.67 %),2211,5839400,2641.07,4084,6054200,1482,-214800
2023-07-25,74.5 ( 1.22 %),3362,8442000,2511.01,4680,7321200,1564,1120800
2023-07-24,73.6 ( 0.14 %),2567,3880400,1511.65,3037,5245600,1727,-1365200
2023-07-21,73.5 ( 1.24 %),2646,5537700,2092.86,4060,6449400,1589,-911700
2023-07-20,72.6 ( 0 %),2285,4556300,1994,2529,5207800,2059,-651500
2023-07-19,72.6 ( 0.28 %),2870,4270200,1487.87,2854,5575400,1954,-1305200
2023-07-18,72.4 ( 0.14 %),3042,4748000,1560.82,3168,5234400,1652,-486400
2023-07-17,72.3 ( -1.36 %),4982,6048000,1213.97,3275,7360800,2248,-1312800
2023-07-14,73.3 ( 0.27 %),4863,8356700,1718.42,3798,8843800,2329,-487100
2023-07-13,73.1 ( -0.54 %),3525,5939100,1684.85,4196,7855200,1872,-1916100
2023-07-12,73.5 ( 0.96 %),3430,7251000,2113.99,4856,8377500,1725,-1126500
2023-07-11,72.8 ( 0.97 %),4198,10214100,2433.09,6575,10735300,1633,-521200
2023-07-10,72.1 ( 1.69 %),3840,11730600,3054.84,7422,11345600,1529,385000
2023-07-07,70.9 ( 0.57 %),3210,13265900,4132.68,5601,10423400,1861,2842500
2023-07-06,70.5 ( 1 %),5142,13902700,2703.75,5483,11011300,2008,2891400
2023-07-05,69.8 ( -1.13 %),6459,10598000,1640.81,4574,10264300,2244,333700
2023-07-04,70.6 ( -0.14 %),4366,14091700,3227.6,2267,7833200,3455,6258500
2023-07-03,70.7 ( -0.42 %),4663,8561700,1836.09,5870,6028100,1027,2533600
2023-06-30,71 ( -1.25 %),3461,5951000,1719.45,4231,8813900,2083,-2862900
2023-06-29,71.9 ( 1.84 %),3882,18357800,4728.95,8523,13234700,1553,5123100
2023-06-28,70.6 ( 0.14 %),4260,11898000,2792.96,5048,10880500,2155,1017500
2023-06-27,70.5 ( -0.14 %),4389,10060500,2292.21,5016,10726700,2138,-666200
2023-06-26,70.6 ( 2.17 %),5914,18359000,3104.33,10700,16970600,1586,1388400
2023-06-23,69.1 ( 3.29 %),0,0,0,0,0,0,0
2023-06-22,66.9 ( 0.9 %),4250,8634400,2031.62,6030,10459700,1735,-1825300
2023-06-21,66.3 ( 1.22 %),4971,6742000,1356.27,3836,5868400,1530,873600
2023-06-20,65.5 ( -0.46 %),5444,5581900,1025.33,2707,5293600,1956,288300
2023-06-19,65.8 ( -0.45 %),5451,6269400,1150.14,2998,6945700,2317,-676300
2023-06-16,66.1 ( -0.3 %),6848,9366900,1367.83,3095,9731600,3144,-364700
2023-06-15,66.3 ( -1.19 %),7490,7639500,1019.96,4512,8485200,1881,-845700
2023-06-14,67.1 ( -0.74 %),5817,8461700,1454.65,4292,8948300,2085,-486600
2023-06-13,67.6 ( -0.44 %),6060,7920800,1307.06,5352,9817200,1834,-1896400
2023-06-12,67.9 ( 3.19 %),5591,9618800,1720.41,6529,9122900,1397,495900
2023-06-09,65.8 ( 0.46 %),3955,3969200,1003.59,2672,4723300,1768,-754100
2023-06-08,65.5 ( -1.06 %),8359,7301100,873.44,3646,8800900,2414,-1499800
2023-06-07,66.2 ( -0.3 %),5473,6080700,1111.04,3253,5920400,1820,160300
2023-06-06,66.4 ( -0.15 %),5102,5811200,1139,3535,6295600,1781,-484400
2023-06-05,66.5 ( 0.91 %),4297,5435600,1264.98,3451,6094900,1766,-659300
2023-06-02,65.9 ( -0.3 %),6065,5221500,860.92,2515,5418000,2154,-196500
2023-06-01,66.1 ( 0 %),3130,2448700,782.33,1835,2621800,1429,-173100
2023-05-31,66.1 ( -0.6 %),3380,2784300,823.76,1756,3168000,1804,-383700
2023-05-30,66.5 ( -0.89 %),3639,3370400,926.19,2149,3894000,1812,-523600
2023-05-29,67.1 ( 0 %),2022,1735300,858.21,1958,2888300,1475,-1153000
2023-05-26,67.1 ( 0 %),2154,1880500,873.03,2240,2491600,1112,-611100
2023-05-25,67.1 ( 1.21 %),3366,3045100,904.66,2175,2472600,1137,572500
2023-05-24,66.3 ( -1.04 %),5332,4212800,790.1,2336,3883500,1662,329300
2023-05-23,67 ( -1.76 %),5169,3985500,771.04,3085,4968300,1610,-982800
2023-05-22,68.2 ( -0.58 %),2775,2602300,937.77,1715,3012600,1757,-410300
2023-05-19,68.6 ( -0.87 %),2651,2207800,832.82,1516,2308600,1523,-100800
2023-05-18,69.2 ( 0.29 %),3160,3857800,1220.82,2446,4235400,1732,-377600
2023-05-17,69 ( -1 %),3229,3316700,1027.16,1585,3019900,1905,296800
2023-05-16,69.7 ( 1.01 %),2266,2451600,1081.91,1225,1973700,1611,477900
2023-05-15,69 ( -0.86 %),4021,2949600,733.55,3832,2570100,671,379500
2023-05-12,69.6 ( -0.57 %),3022,2133500,705.99,2065,1995200,966,138300
2023-05-11,70 ( -0.71 %),1928,977600,507.05,1207,1187500,984,-209900
2023-05-10,70.5 ( -0.28 %),1527,1485900,973.08,1556,1939200,1246,-453300
2023-05-09,70.7 ( 0.43 %),2014,1927300,956.95,2000,1867300,934,60000
2023-05-08,70.4 ( 2.33 %),2237,2785900,1245.37,2446,2004600,820,781300
2023-05-05,68.8 ( 0.29 %),2336,1594200,682.45,1226,1359800,1109,234400
2023-05-04,68.6 ( -2 %),4390,3882900,884.49,1701,3671900,2159,211000
2023-04-28,70 ( 0.72 %),0,0,0,0,0,0,0
2023-04-27,69.5 ( -2.11 %),3560,2243800,630.28,2669,2297000,861,-53200
2023-04-26,71 ( 1.57 %),0,0,0,0,0,0,0
2023-04-25,69.9 ( -0.85 %),2740,2337500,853.1,2050,2294700,1119,42800
2023-04-24,70.5 ( -0.56 %),2131,1988400,933.08,1744,1874300,1075,114100
2023-04-21,70.9 ( -1.39 %),2978,2099000,704.84,1537,2058000,1339,41000
2023-04-20,71.9 ( -0.14 %),1924,1613200,838.46,1210,1687200,1394,-74000
2023-04-19,72 ( -1.37 %),0,0,0,0,0,0,0
2023-04-18,73 ( 1.81 %),1927,2048700,1063.16,1391,1639000,1178,409700
2023-04-17,71.7 ( -1.51 %),3264,2308600,707.29,1311,2200700,1679,107900
2023-04-14,72.8 ( -0.95 %),2863,2381400,831.78,2011,2291900,1140,89500
2023-04-13,73.5 ( -1.08 %),2610,1496500,573.37,1567,2100500,1340,-604000
2023-04-12,74.3 ( -0.13 %),2215,1602700,723.57,1300,1986000,1528,-383300
2023-04-11,74.4 ( 0 %),1306,1451700,1111.56,1848,1608100,870,-156400
2023-04-10,74.4 ( -0.4 %),1051,1648300,1568.32,1379,1816900,1318,-168600
2023-04-07,74.7 ( 0.54 %),1152,1455900,1263.8,1523,1835500,1205,-379600
2023-04-06,74.3 ( -0.27 %),1838,1708800,929.71,1726,1859400,1077,-150600
2023-04-05,74.5 ( 0.4 %),1938,2109600,1088.54,1864,1828500,981,281100
2023-04-04,74.2 ( -0.27 %),2509,2712900,1081.27,3265,3027400,927,-314500
2023-04-03,74.4 ( 0 %),1954,1495600,765.4,3896,1825700,469,-330100
2023-03-31,74.4 ( -0.8 %),1859,1543400,830.23,3717,2677400,720,-1134000
2023-03-30,75 ( 0.13 %),1508,1435800,952.12,2300,2493100,1084,-1057300
2023-03-29,74.9 ( 0.67 %),1361,1579500,1160.54,2633,2016200,766,-436700
2023-03-28,74.4 ( -0.27 %),2246,2411700,1073.78,2191,2722700,1243,-311000
2023-03-27,74.6 ( -0.53 %),2195,2261800,1030.43,1775,2444900,1377,-183100
2023-03-24,75 ( -0.4 %),1328,1552600,1169.13,2627,2091900,796,-539300
2023-03-23,75.3 ( 1.21 %),1251,2126900,1700.16,2154,2294300,1065,-167400
2023-03-22,74.4 ( 0 %),1079,1426600,1322.15,1242,1830700,1474,-404100
2023-03-21,74.4 ( 0.13 %),1146,2439300,2128.53,2134,2293800,1075,145500
2023-03-20,74.3 ( -0.27 %),2659,3022500,1136.71,1832,2376700,1297,645800
2023-03-17,74.5 ( -2.49 %),3857,4781600,1239.72,3703,4512200,1219,269400
2023-03-16,76.4 ( -0.91 %),1632,2264200,1387.38,3074,3317400,1079,-1053200
2023-03-15,77.1 ( 0.65 %),1212,2691300,2220.54,4208,2908100,691,-216800
2023-03-14,76.6 ( -0.39 %),1887,2616900,1386.8,3681,3382600,919,-765700
2023-03-13,76.9 ( 0 %),1470,2593100,1764.01,2348,3365000,1433,-771900
2023-03-10,76.9 ( 0.52 %),1665,2502000,1502.7,2503,3272300,1307,-770300
2023-03-09,76.5 ( 0 %),1621,2173600,1340.9,2715,2795400,1030,-621800
2023-03-08,76.5 ( 0.92 %),1564,2234200,1428.52,1653,3013300,1823,-779100
2023-03-07,75.8 ( 1.07 %),1395,1720900,1233.62,1989,2535900,1275,-815000
2023-03-06,75 ( -1.32 %),1169,1396700,1194.78,1533,2403000,1568,-1006300
2023-03-03,76 ( -0.65 %),1222,1401600,1146.97,1590,2434500,1531,-1032900
2023-03-02,76.5 ( -0.52 %),1014,2018500,1990.63,1687,2462800,1460,-444300
2023-03-01,76.9 ( 1.85 %),1293,2866400,2216.86,2556,2927800,1145,-61400
2023-02-28,75.5 ( 0.4 %),1395,1554400,1114.27,1693,2389700,1412,-835300
2023-02-27,75.2 ( 0.67 %),1507,1940000,1287.33,1665,2194200,1318,-254200
2023-02-24,74.7 ( -1.32 %),2368,3027000,1278.29,2621,3230400,1233,-203400
2023-02-23,75.7 ( 0.26 %),2834,3549100,1252.33,3309,3447300,1042,101800
2023-02-22,75.5 ( -2.2 %),2155,1955500,907.42,1722,2407100,1398,-451600
2023-02-21,77.2 ( -0.39 %),1331,1474700,1107.96,1926,2424700,1259,-950000
2023-02-20,77.5 ( 1.97 %),1470,3525900,2398.57,2205,2807600,1273,718300
2023-02-17,76 ( -0.65 %),1719,1549500,901.4,1374,1928600,1404,-379100
2023-02-16,76.5 ( 0.66 %),1799,1469100,816.62,1480,1694000,1145,-224900
2023-02-15,76 ( 1.74 %),1890,2357500,1247.35,2308,2695400,1168,-337900
2023-02-14,74.7 ( -0.8 %),1465,1862500,1271.33,1533,2000100,1305,-137600
2023-02-13,75.3 ( -0.79 %),2378,2704200,1137.17,3837,2966000,773,-261800
2023-02-10,75.9 ( 1.2 %),1971,2023200,1026.48,2355,2667000,1132,-643800
2023-02-09,75 ( -1.06 %),3711,2943100,793.07,3001,3865000,1288,-921900
2023-02-08,75.8 ( -0.39 %),2858,2238200,783.14,1683,3148300,1871,-910100
2023-02-07,76.1 ( -1.68 %),2000,1788600,894.3,1772,3045100,1718,-1256500
2023-02-06,77.4 ( 1.84 %),3154,2992100,948.67,2045,3566300,1744,-574200
2023-02-03,76 ( -0.91 %),3589,2812200,783.56,1747,3368100,1928,-555900
2023-02-02,76.7 ( -0.65 %),2393,2130900,890.47,1548,2623200,1695,-492300
2023-02-01,77.2 ( 0.13 %),3636,3047100,838.04,1401,2939700,2098,107400
2023-01-31,77.1 ( -2.9 %),7300,7005100,959.6,2688,7465400,2777,-460300
2023-01-30,79.4 ( -0.75 %),2153,2223000,1032.51,1396,2449400,1755,-226400
2023-01-27,80 ( -1.6 %),2850,2963200,1039.72,3580,3788300,1058,-825100
2023-01-19,81.3 ( 0 %),1794,3466500,1932.27,4622,4616600,999,-1150100
2023-01-18,81.3 ( 0.49 %),857,1676200,1955.89,2859,3362300,1176,-1686100
2023-01-17,80.9 ( 1.89 %),1204,2238000,1858.8,2819,2997700,1063,-759700
2023-01-16,79.4 ( -1.49 %),1104,986200,893.3,1582,2189900,1384,-1203700
2023-01-13,80.6 ( 0.75 %),1508,2459600,1631.03,2565,3634600,1417,-1175000
2023-01-12,80 ( 0.76 %),1094,1925600,1760.15,1906,1633400,857,292200
2023-01-11,79.4 ( -1.98 %),1595,2038800,1278.24,1971,3433700,1742,-1394900
2023-01-10,81 ( 0.37 %),744,1824700,2452.55,2398,2946600,1229,-1121900
2023-01-09,80.7 ( 1.13 %),1508,1716300,1138.13,1720,2114900,1230,-398600
2023-01-06,79.8 ( -1.72 %),1788,2018900,1129.14,2666,3201600,1201,-1182700
2023-01-05,81.2 ( 2.4 %),1688,5259600,3115.88,4233,4840700,1144,418900
2023-01-04,79.3 ( 1.02 %),951,1920100,2019.03,2250,2535400,1127,-615300
2023-01-03,78.5 ( 3.15 %),1470,2813500,1913.95,2065,2633700,1275,179800
2022-12-30,76.1 ( -1.17 %),1437,2249400,1565.34,1668,2899800,1738,-650400
2022-12-29,77 ( 0 %),1316,2614200,1986.47,1769,2934300,1659,-320100
2022-12-28,77 ( 0.52 %),1782,2230600,1251.74,1711,2432100,1421,-201500
2022-12-27,76.6 ( 0.79 %),1708,2833500,1658.96,1795,2870900,1599,-37400
2022-12-26,76 ( -0.26 %),2393,3474100,1451.78,2192,3014700,1375,459400
2022-12-23,76.2 ( -1.04 %),2964,2510700,847.06,1707,2955800,1732,-445100
2022-12-22,77 ( -1.66 %),2613,2810800,1075.7,2186,3723100,1703,-912300
2022-12-21,79.7 ( 1.27 %),2661,4331500,1627.77,3785,4786500,1265,-455000
2022-12-20,78.7 ( 2.21 %),3613,4869800,1347.85,3470,4510000,1300,359800
2022-12-19,77 ( -1.28 %),4475,3567900,797.3,2680,4425100,1651,-857200
2022-12-16,78 ( 0.52 %),3762,4936700,1312.25,2249,4584600,2039,352100
2022-12-15,77.6 ( 0.13 %),4243,4982300,1174.24,2194,4102200,1870,880100
2022-12-14,77.5 ( -0.64 %),4386,5329200,1215.05,2667,5020600,1882,308600
2022-12-13,78 ( -0.64 %),6322,5442800,860.93,4627,5185000,1121,257800
2022-12-12,78.5 ( -1.88 %),4477,4650800,1038.82,3861,4998300,1295,-347500
2022-12-09,80 ( -1.23 %),2986,3732600,1250.03,2165,3866100,1786,-133500
2022-12-08,81 ( -1.82 %),1787,2266100,1268.1,2129,3972500,1866,-1706400
2022-12-07,82.5 ( 0 %),2157,2774800,1286.42,2655,3460800,1304,-686000
2022-12-06,82.5 ( -2.94 %),1489,1922500,1291.13,2377,4090000,1721,-2167500
2022-12-05,85 ( 1.19 %),2900,4015100,1384.52,3578,4231800,1183,-216700
2022-12-02,84 ( 1.94 %),2306,3584700,1554.51,3413,4177700,1224,-593000
2022-12-01,82.4 ( -0.48 %),3396,3515700,1035.25,2965,4223800,1425,-708100
2022-11-30,82.8 ( -0.24 %),1648,3410800,2069.66,2669,4135100,1549,-724300
2022-11-29,83 ( 1.59 %),2576,4836000,1877.33,3183,4422000,1389,414000
2022-11-28,81.7 ( -0.61 %),2074,3274000,1578.59,4099,5245500,1280,-1971500
2022-11-25,82.2 ( 1.23 %),3237,4549000,1405.31,4472,5788400,1294,-1239400
2022-11-24,81.2 ( 2.27 %),2268,4945500,2180.56,4214,5200100,1234,-254600
2022-11-23,79.4 ( -0.13 %),1237,1401900,1133.31,2032,2722900,1340,-1321000
2022-11-22,79.5 ( 2.05 %),2298,3222700,1402.39,4308,5217600,1211,-1994900
2022-11-21,77.9 ( 1.17 %),2075,2758900,1329.59,2316,3314200,1431,-555300
2022-11-18,77 ( 1.32 %),2537,3405500,1342.33,2197,3887300,1769,-481800
2022-11-17,76 ( 2.01 %),2943,3984600,1353.92,2481,3979300,1604,5300
2022-11-16,74.5 ( -3.25 %),3927,4800100,1222.33,3465,5929700,1711,-1129600
2022-11-15,77 ( -2.53 %),2126,3623200,1704.23,2575,4373000,1698,-749800
2022-11-14,79 ( 0.77 %),3735,4630300,1239.71,3077,4210000,1368,420300
2022-11-11,78.4 ( 0 %),1584,2504000,1580.81,1916,3212400,1677,-708400
2022-11-10,78.4 ( -3.09 %),3144,3862300,1228.47,2807,5462100,1946,-1599800
2022-11-09,80.9 ( -1.82 %),5135,3810300,742.03,2825,5579400,1975,-1769100
2022-11-08,82.4 ( 0.24 %),2251,3440600,1528.48,3572,4235000,1186,-794400
2022-11-07,82.2 ( 2.75 %),2396,4294700,1792.45,4026,4532800,1126,-238100
2022-11-04,80 ( 0 %),3624,5755900,1588.27,4056,5059400,1247,696500
2022-11-03,80 ( 2.17 %),1562,2583600,1654.03,2637,2946600,1117,-363000
2022-11-02,78.3 ( -2.37 %),2905,2922700,1006.09,1973,3310600,1678,-387900
2022-11-01,80.2 ( 2.17 %),3412,5201400,1524.44,4987,6162300,1236,-960900
2022-10-31,78.5 ( 0.64 %),1519,2153500,1417.71,2047,2782800,1359,-629300
2022-10-28,78 ( -0.64 %),1364,2393100,1754.47,2567,3252400,1267,-859300
2022-10-27,78.5 ( 3.29 %),1404,3608200,2569.94,3568,3733500,1046,-125300
2022-10-26,76 ( 0 %),1130,1420700,1257.26,1763,1693000,960,-272300
2022-10-25,76 ( 2.7 %),1411,2795200,1981.01,2600,2750800,1058,44400
2022-10-24,74 ( -3.9 %),1208,2209600,1829.14,2326,2757700,1186,-548100
2022-10-21,77 ( -0.65 %),2516,3247700,1290.82,4230,4755400,1124,-1507700
2022-10-20,77.5 ( 1.17 %),2107,3420500,1623.4,3236,4046900,1251,-626400
2022-10-19,76.6 ( 0.13 %),907,1960800,2161.85,2117,2675900,1264,-715100
2022-10-18,76.5 ( 3.24 %),3806,4553400,1196.37,3935,5620700,1428,-1067300
2022-10-17,74.1 ( 0.14 %),2397,2883200,1202.84,2630,3258500,1239,-375300
2022-10-14,74 ( 0.27 %),2437,2239300,918.88,2333,3044100,1305,-804800
2022-10-13,73.8 ( 3.07 %),3445,5107100,1482.47,3222,4768300,1480,338800
2022-10-12,71.6 ( 1.99 %),2077,1823100,877.76,1854,2478400,1337,-655300
2022-10-11,70.2 ( -0.43 %),1389,2819800,2030.09,2271,3288800,1448,-469000
2022-10-10,70.5 ( 1 %),1886,3428400,1817.82,1855,2490200,1342,938200
2022-10-07,69.8 ( -0.29 %),3228,4129600,1279.31,2141,4158000,1942,-28400
2022-10-06,70 ( -2.23 %),1267,1971100,1555.72,1293,2585600,2000,-614500
2022-10-05,71.6 ( 0.99 %),1059,2072800,1957.32,1075,2286200,2127,-213400
2022-10-04,70.9 ( -0.14 %),2305,2551700,1107.03,1850,2796100,1511,-244400
2022-10-03,71 ( -1.8 %),1624,2803200,1726.11,1839,3447600,1875,-644400
2022-09-30,72.3 ( -0.55 %),1816,3570700,1966.24,2648,3681000,1390,-110300
2022-09-29,72.7 ( 1.25 %),2018,3305900,1638.21,2429,3300100,1359,5800
2022-09-28,71.8 ( -0.83 %),2515,4160700,1654.35,3237,3052600,943,1108100
2022-09-27,72.4 ( -2.16 %),3293,3592000,1090.8,2896,4148100,1432,-556100
2022-09-26,74 ( -3.52 %),2590,4372400,1688.19,2139,5817700,2720,-1445300
2022-09-23,76.7 ( -0.26 %),1269,2380800,1876.12,2483,3473800,1399,-1093000
2022-09-22,76.9 ( 0 %),1314,1860100,1415.6,2402,2508900,1045,-648800
2022-09-21,76.9 ( 1.45 %),1937,5103700,2634.85,3342,4488600,1343,615100
2022-09-20,75.8 ( 0.8 %),1251,1894800,1514.63,2725,2624000,963,-729200
2022-09-19,75.2 ( -1.05 %),1419,2062500,1453.49,2286,2577500,1128,-515000
2022-09-16,76 ( 2.01 %),771,2813100,3648.64,2117,4883200,2307,-2070100
2022-09-15,74.5 ( 0.68 %),1245,2230600,1791.65,1814,1979200,1091,251400
2022-09-14,74 ( -2.25 %),2795,3138600,1122.93,1408,3148400,2236,-9800
2022-09-13,75.7 ( 0.53 %),1642,2479800,1510.23,1513,2848900,1883,-369100
2022-09-12,75.3 ( -0.79 %),1877,2009300,1070.48,1603,2643500,1649,-634200
2022-09-09,75.9 ( 0.26 %),1541,1971700,1279.49,1787,2430200,1360,-458500
2022-09-08,75.7 ( 0 %),1655,2334900,1410.82,1458,2526400,1733,-191500
2022-09-07,75.7 ( -2.7 %),1587,3627700,2285.89,2277,4913700,2158,-1286000
2022-09-06,77.8 ( 0.39 %),1746,5763700,3301.09,4259,5486200,1288,277500
2022-09-05,77.5 ( 2.65 %),2430,5235700,2154.61,2780,4653000,1674,582700
2022-08-31,75.5 ( -0.66 %),1497,2653400,1772.48,1480,2860400,1933,-207000
2022-08-30,76 ( 0.66 %),1578,3782200,2396.83,1864,3981900,2136,-199700
2022-08-29,75.5 ( -1.82 %),3269,5798100,1773.66,3097,4850800,1566,947300
2022-08-26,76.9 ( -1.28 %),2567,3700900,1441.72,3146,4989100,1586,-1288200
2022-08-25,77.9 ( 0.26 %),2229,5096500,2286.45,4381,5138100,1173,-41600
2022-08-24,77.7 ( 2.51 %),3322,12361600,3721.13,7343,9410900,1282,2950700
2022-08-23,75.8 ( 2.85 %),2909,10510300,3613.03,4342,6754700,1556,3755600
2022-08-22,73.7 ( -0.54 %),2032,3791900,1866.09,3004,4917400,1637,-1125500
2022-08-19,74.1 ( 0.95 %),2992,8017400,2679.61,4741,8847300,1866,-829900
2022-08-18,73.4 ( 1.1 %),3200,6156500,1923.91,5218,7778300,1491,-1621800
2022-08-17,72.6 ( 1.11 %),1723,2986200,1733.14,2398,2805000,1170,181200
2022-08-16,71.8 ( 0.42 %),1712,2803500,1637.56,1962,3672700,1872,-869200
2022-08-15,71.5 ( -0.56 %),2078,3707700,1784.26,1701,4389500,2581,-681800
2022-08-12,71.9 ( 1.13 %),1515,3039400,2006.2,2419,3193700,1320,-154300
2022-08-11,71.1 ( -1.93 %),3251,5128200,1577.42,4534,7125900,1572,-1997700
2022-08-10,72.5 ( 0.69 %),1647,3124600,1897.15,2382,2945300,1236,179300
2022-08-09,72 ( -0.28 %),2513,3739100,1487.9,1770,3102600,1753,636500
2022-08-08,72.2 ( -0.55 %),2905,4223000,1453.7,2400,4164700,1735,58300
2022-08-05,72.6 ( -0.95 %),3250,3173600,976.49,2140,3965100,1853,-791500
2022-08-04,73.3 ( -0.14 %),2303,4020000,1745.55,2494,3854700,1546,165300
2022-08-03,73.4 ( 0 %),2434,5822200,2392.03,2227,5270000,2366,552200
2022-08-02,73.4 ( -0.14 %),3928,4617600,1175.56,3205,5117100,1597,-499500
2022-08-01,73.5 ( 0.96 %),3485,3994000,1146.05,2064,3592500,1741,401500
2022-07-29,72.8 ( 0.28 %),4173,3925000,940.57,3431,5087200,1483,-1162200
2022-07-28,72.6 ( 0.55 %),1854,2279200,1229.34,1838,2699900,1469,-420700
2022-07-27,72.2 ( 0.28 %),2213,1755600,793.31,1594,2500800,1569,-745200
2022-07-26,72 ( -1.23 %),1894,1774800,937.06,4141,3054400,738,-1279600
2022-07-25,72.9 ( 1.25 %),1363,2559500,1877.84,1767,2650200,1500,-90700
2022-07-22,72 ( -1.64 %),1426,1194000,837.31,1494,2246800,1504,-1052800
2022-07-21,73.2 ( 0.27 %),1923,2530400,1315.86,2668,4029200,1510,-1498800
2022-07-20,73 ( 0.27 %),1125,1737900,1544.8,2785,3692900,1326,-1955000
2022-07-19,72.8 ( 1.53 %),1975,2285100,1157.01,2320,3270300,1410,-985200
2022-07-18,71.7 ( 0.14 %),1575,1747600,1109.59,1616,2440200,1510,-692600
2022-07-15,71.6 ( -1.1 %),1849,2234700,1208.6,1962,3486000,1777,-1251300
2022-07-14,72.4 ( -0.14 %),1350,1858100,1376.37,1918,2880000,1502,-1021900
2022-07-13,72.5 ( -1.09 %),1738,2039700,1173.59,2129,3422100,1607,-1382400
2022-07-12,73.3 ( 0.41 %),1642,1716200,1045.19,2471,3058500,1238,-1342300
2022-07-11,73 ( 0 %),2517,4029200,1600.79,4094,5300600,1295,-1271400
2022-07-08,73 ( 0 %),1870,2701400,1444.6,2638,3989200,1512,-1287800
2022-07-07,73 ( 3.25 %),4225,4564000,1080.24,3347,4774200,1426,-210200
2022-07-06,70.7 ( 0 %),3158,3390600,1073.65,1972,4180900,2120,-790300
2022-07-05,73.1 ( -2.66 %),3080,3716300,1206.59,3787,6134300,1620,-2418000
2022-07-04,75.1 ( 1.9 %),2860,5535100,1935.35,4866,6195000,1273,-659900
2022-07-01,73.7 ( 2.08 %),2911,4939700,1696.91,3537,5350000,1513,-410300
2022-06-30,72.2 ( -0.14 %),4434,5964500,1345.17,5807,7704100,1327,-1739600
2022-06-29,72.3 ( 2.12 %),2739,3151700,1150.68,2591,4012100,1548,-860400
2022-06-28,70.8 ( -0.42 %),3673,4894200,1332.48,3173,5376100,1694,-481900
2022-06-27,71.1 ( -0.56 %),2438,3373000,1383.51,2288,3553300,1553,-180300
2022-06-24,71.5 ( 1.13 %),2624,2882700,1098.59,2802,4062300,1450,-1179600
2022-06-23,70.7 ( 0.14 %),2176,2177800,1000.83,1891,2501100,1323,-323300
2022-06-22,70.6 ( -4.21 %),2559,3373100,1318.13,2955,4812700,1629,-1439600
2022-06-21,73.7 ( 6.81 %),4261,7915900,1857.76,6686,6298900,942,1617000
2022-06-20,69 ( 3.45 %),2720,4763000,1751.1,4116,4194700,1019,568300
2022-06-17,66.7 ( -1.91 %),3560,4792600,1346.24,3130,4082900,1304,709700
2022-06-16,68 ( 5.43 %),2777,3776900,1360.06,3379,3237300,958,539600
2022-06-15,64.5 ( -2.42 %),3179,3593800,1130.48,3263,3747600,1149,-153800
2022-06-14,66.1 ( -0.45 %),3203,2701800,843.52,1764,2097700,1189,604100
2022-06-13,66.4 ( -4.46 %),4456,3745900,840.64,1854,3644300,1966,101600
2022-06-10,69.5 ( -1 %),2275,2353600,1034.55,1702,2449900,1439,-96300
2022-06-09,70.2 ( -1.13 %),1623,1972700,1215.47,1864,2234100,1199,-261400
2022-06-08,71 ( 0.57 %),1347,3275700,2431.85,2142,3210900,1499,64800
2022-06-07,70.6 ( -0.28 %),1399,2550600,1823.16,2124,2325500,1095,225100
2022-06-06,70.8 ( 0.71 %),1754,2787400,1589.17,2106,2662700,1264,124700
2022-06-03,70.3 ( -1.13 %),1860,2064900,1110.16,1399,2384800,1705,-319900
2022-06-02,71.1 ( -1.11 %),1699,2328000,1370.22,1694,3138500,1853,-810500
2022-06-01,71.9 ( 0.28 %),1765,2121000,1201.7,1787,2890500,1618,-769500
2022-05-31,71.7 ( -1.1 %),1745,2974200,1704.41,1944,3470500,1785,-496300
2022-05-30,72.5 ( -0.68 %),2236,3109600,1390.7,2074,3911100,1886,-801500
2022-05-27,73 ( 2.38 %),2440,4895100,2006.19,4327,6457100,1492,-1562000
2022-05-26,71.3 ( -0.83 %),1793,2551800,1423.2,2502,3644800,1457,-1093000
2022-05-25,71.9 ( 4.35 %),2514,4773800,1898.89,4513,4250500,942,523300
2022-05-24,68.9 ( 3.92 %),2082,4670700,2243.37,3043,3268500,1074,1402200
2022-05-23,66.3 ( -2.64 %),3121,3037500,973.25,1798,3664900,2038,-627400
2022-05-20,68.1 ( -1.3 %),2278,2296600,1008.17,1898,2943400,1551,-646800
2022-05-19,69 ( -1.85 %),1722,2254600,1309.29,2071,3075500,1485,-820900
2022-05-18,70.3 ( 0.43 %),2688,3235400,1203.65,2992,3925800,1312,-690400
2022-05-17,70 ( 6.38 %),3442,3872400,1125.04,2629,3791100,1442,81300
2022-05-16,65.8 ( -0.45 %),0,0,0,0,0,0,0
2022-05-13,66.1 ( -0.6 %),4599,6407300,1393.19,3364,6519600,1938,-112300
2022-05-12,66.5 ( -4.32 %),5202,4680500,899.75,2432,4761700,1958,-81200
2022-05-11,69.5 ( -1.56 %),4056,3020300,744.65,2159,3212300,1488,-192000
2022-05-10,70.6 ( 0.86 %),3601,4383900,1217.41,3740,5171900,1383,-788000
2022-05-09,70 ( -0.28 %),3747,3824900,1020.79,3238,4116500,1271,-291600
2022-05-06,70.2 ( -2.64 %),5034,3927600,780.21,1731,3572000,2064,355600
2022-05-05,72.1 ( -0.55 %),3402,2857200,839.86,1776,2870400,1616,-13200
2022-05-04,72.5 ( -2.29 %),3109,2521300,810.97,1617,2887300,1786,-366000
2022-04-29,74.2 ( -0.13 %),2540,2644500,1041.14,2130,3236200,1519,-591700
2022-04-28,74.3 ( -0.93 %),3567,3150500,883.24,1838,3194600,1738,-44100
2022-04-27,75 ( -1.19 %),3236,3081700,952.32,2407,3781600,1571,-699900
2022-04-26,75.9 ( 3.27 %),0,0,0,0,0,0,0
2022-04-25,73.5 ( -3.16 %),4071,3958000,972.24,2470,4319200,1749,-361200
2022-04-22,75.9 ( 1.2 %),3277,4723400,1441.38,2435,4853500,1993,-130100
2022-04-21,75 ( -0.79 %),5181,6168600,1190.62,2874,7523600,2618,-1355000
2022-04-20,75.6 ( -0.53 %),2280,3036100,1331.62,2136,3586800,1679,-550700
2022-04-18,77 ( 0.65 %),3041,4389300,1443.37,3231,5114100,1583,-724800
2022-04-15,76.5 ( 0.26 %),2409,3505500,1455.17,1967,2955500,1503,550000
2022-04-14,76.3 ( -1.17 %),3832,3209800,837.63,1647,3516500,2135,-306700
2022-04-13,77.2 ( 0.52 %),3024,3947200,1305.29,2413,3746200,1553,201000
2022-04-12,76.8 ( -0.65 %),3176,3258700,1026.04,2101,3354600,1597,-95900
2022-04-08,0 ( 0 %),3390,4714900,1390.83,1983,4950800,2497,-235900
2022-04-07,78.5 ( -1.01 %),2811,3281700,1167.45,2141,3668700,1714,-387000
2022-04-06,79.3 ( -1.37 %),4315,6824400,1581.55,3964,7183300,1812,-358900
2022-04-05,80.4 ( -2.19 %),3311,3551500,1072.64,4076,4852900,1191,-1301400
2022-04-04,82.2 ( 0.61 %),3481,5561700,1597.73,6321,8042900,1272,-2481200
2022-04-01,81.7 ( 0.99 %),9538,9108700,954.99,9893,13136500,1328,-4027800
2022-03-31,80.9 ( 6.17 %),10521,14263100,1355.68,11294,15143400,1341,-880300
2022-03-30,76.2 ( 0.93 %),3550,5507400,1551.38,4603,6107500,1327,-600100
2022-03-29,75.5 ( 2.86 %),3857,3970200,1029.35,3172,3619000,1141,351200
2022-03-28,73.4 ( -2.39 %),6950,6213900,894.09,4399,6563700,1492,-349800
2022-03-25,75.2 ( -0.53 %),5646,5531000,979.63,2517,4289800,1704,1241200
2022-03-24,75.6 ( -0.66 %),7265,6394000,880.11,2628,5305500,2019,1088500
2022-03-23,76.1 ( -1.04 %),5548,5335100,961.63,3022,5891600,1950,-556500
2022-03-22,76.9 ( -0.9 %),3522,3633700,1031.71,4626,4321900,934,-688200
2022-03-21,77.6 ( 2.11 %),2527,3792000,1500.59,3331,3321600,997,470400
2022-03-18,76 ( -0.52 %),4988,10361700,2077.33,2320,5499400,2370,4862300
2022-03-17,76.4 ( -1.16 %),2917,2072800,710.59,1990,3224000,1620,-1151200
2022-03-16,77.3 ( 0.13 %),4425,3355800,758.37,3838,3770100,982,-414300
2022-03-15,77.2 ( 0 %),3730,3285000,880.7,2011,2742200,1364,542800
2022-03-14,77.2 ( -1.03 %),0,0,0,0,0,0,0
2022-03-11,78 ( 1.17 %),3557,3826700,1075.82,3559,4785800,1345,-959100
2022-03-10,77.1 ( 2.66 %),3957,6610100,1670.48,3541,5340900,1508,1269200
2022-03-09,75.1 ( -1.31 %),6139,4685100,763.17,4164,5506900,1323,-821800
2022-03-08,76.1 ( -0.91 %),5213,4002800,767.85,2728,3823500,1402,179300
2022-03-07,76.8 ( -1.41 %),6613,5235900,791.76,2916,5965900,2046,-730000
2022-03-04,77.9 ( -0.64 %),5250,4191700,798.42,3189,4282500,1343,-90800
2022-03-03,78.4 ( -0.13 %),4542,2872900,632.52,2119,3087500,1457,-214600
2022-03-02,78.5 ( -0.88 %),3644,3089300,847.78,2873,3680300,1281,-591000
2022-03-01,79.2 ( 1.02 %),2664,2568900,964.3,2138,2498400,1169,70500
2022-02-28,78.4 ( -0.63 %),5199,3702500,712.16,2572,4113200,1599,-410700
2022-02-25,78.9 ( 0.38 %),3187,2629700,825.13,2014,3285300,1631,-655600
2022-02-24,78.6 ( -1.75 %),6002,4015100,668.96,2782,5094700,1831,-1079600
2022-02-23,80 ( 0 %),3726,3443500,924.18,2972,3877100,1305,-433600
2022-02-22,80 ( -1.23 %),4902,4682000,955.12,2142,5236400,2445,-554400
2022-02-21,81 ( 0.5 %),2135,3017100,1413.16,2294,3000900,1308,16200
2022-02-18,80.6 ( -0.25 %),3505,3460100,987.19,1556,2989500,1921,470600
2022-02-17,80.8 ( 0.5 %),3031,3204600,1057.27,1565,3002900,1919,201700
2022-02-16,80.4 ( -0.99 %),5544,4458900,804.27,1995,4534100,2273,-75200
2022-02-15,81.2 ( 0.12 %),2868,2956600,1030.89,1305,2491900,1910,464700
2022-02-14,81.1 ( -1.1 %),4373,4504400,1030.05,3156,4541100,1439,-36700
2022-02-11,82 ( -0.85 %),2670,2690800,1007.79,1882,2913800,1548,-223000
2022-02-10,82.7 ( -0.12 %),4223,2869200,679.42,2503,3310300,1323,-441100
2022-02-09,82.8 ( 0.98 %),3013,3138000,1041.49,2295,3702400,1613,-564400
2022-02-08,82 ( -1.8 %),3766,3713200,985.98,2532,4837800,1911,-1124600
2022-02-07,83.5 ( 0.48 %),2685,2765200,1029.87,2408,2907200,1207,-142000
2022-01-28,83.1 ( 0 %),2546,4293500,1686.37,3243,4985100,1537,-691600
2022-01-27,83.1 ( 4.27 %),3301,8249200,2499,3176,3455400,1088,4793800
2022-01-26,79.7 ( 0.63 %),2793,2541300,909.88,1499,2517100,1679,24200
2022-01-25,79.2 ( -2.22 %),0,0,0,0,0,0,0
2022-01-24,81 ( -1.94 %),3534,3099300,876.99,2549,4242800,1664,-1143500
2022-01-21,82.6 ( -0.48 %),2936,2282300,777.35,1711,3083800,1802,-801500
2022-01-20,83.1 ( -0.36 %),2395,2683100,1120.29,1564,2950200,1886,-267100
2022-01-19,82.8 ( -0.72 %),2291,2705500,1180.93,1843,3347700,1816,-642200
2022-01-18,83.4 ( 0.6 %),2981,3299700,1106.91,2248,3982700,1772,-683000
2022-01-17,82.9 ( -2.13 %),3516,3065700,871.93,2530,5095700,2014,-2030000
2022-01-14,84.7 ( 1.93 %),3601,4151000,1152.74,3800,4451800,1172,-300800
2022-01-13,83.1 ( 0 %),3075,2829200,920.07,2191,2982200,1361,-153000
2022-01-12,83.1 ( -0.72 %),3564,3303600,926.94,1972,3704600,1879,-401000
2022-01-11,83.7 ( 0 %),3152,3305800,1048.79,1809,3366500,1861,-60700
2022-01-10,83.7 ( -0.12 %),3695,3091300,836.62,2415,4445600,1841,-1354300
2022-01-07,85.2 ( -0.23 %),4999,4476100,895.4,4016,4235100,1055,241000
2022-01-06,85.4 ( -0.93 %),4338,4816100,1110.21,2628,4786800,1821,29300
2022-01-05,86.2 ( -0.58 %),3149,4586300,1456.43,3658,5876500,1606,-1290200
2022-01-04,86.7 ( 0.35 %),1855,3135000,1690.03,3468,4237400,1222,-1102400
2021-12-31,86.4 ( 1.29 %),2363,4343900,1838.3,4042,5144800,1273,-800900
2021-12-30,85.3 ( 0.12 %),1920,2181200,1136.04,1397,2165500,1550,15700
2021-12-29,85.2 ( -0.35 %),2591,2317000,894.25,1438,2135800,1485,181200
2021-12-28,85.5 ( -0.7 %),3000,2853500,951.17,2226,3658900,1644,-805400
2021-12-27,86.1 ( 0.12 %),2328,2030200,872.08,1956,2778700,1421,-748500
2021-12-24,86 ( 1.53 %),2358,2155100,913.95,1976,2140600,1083,14500
2021-12-23,84.7 ( -0.82 %),4608,3649200,791.93,2261,3261000,1442,388200
2021-12-22,85.4 ( -0.12 %),3258,3100200,951.57,2173,3618200,1665,-518000
2021-12-21,85.5 ( -0.23 %),3205,2562500,799.53,1932,2511100,1300,51400
2021-12-20,85.7 ( 0 %),3594,3642900,1013.61,2659,3679900,1384,-37000
2021-12-17,85.7 ( -1.04 %),3876,5894100,1520.67,2239,4679500,2090,1214600
2021-12-16,86.6 ( 0.35 %),2210,2827100,1279.23,2305,4227300,1834,-1400200
2021-12-15,86.3 ( 0 %),2301,2515900,1093.39,2211,3361000,1520,-845100
2021-12-14,86.3 ( -0.12 %),2350,3093900,1316.55,2525,4342800,1720,-1248900
2021-12-13,86.4 ( 0.12 %),2544,2579300,1013.88,2262,3253900,1439,-674600
2021-12-10,86.3 ( -0.8 %),3160,3281800,1038.54,2459,3552600,1445,-270800
2021-12-09,87 ( 1.16 %),3138,3020200,962.46,2283,3095600,1356,-75400
2021-12-08,86 ( -0.58 %),2855,2454100,859.58,1939,3540100,1826,-1086000
2021-12-07,86.5 ( 1.41 %),3158,3019100,956.02,1814,2857600,1575,161500
2021-12-06,85.3 ( -0.58 %),4621,4915300,1063.69,2465,5496700,2230,-581400
2021-12-03,85.8 ( -1.83 %),3827,4164300,1088.14,2713,6556100,2417,-2391800
2021-12-02,87.4 ( -0.11 %),2198,2797200,1272.61,2242,3413000,1522,-615800
2021-12-01,87.5 ( -0.11 %),2509,3190100,1271.46,3425,4678600,1366,-1488500
2021-11-30,87.6 ( 0.11 %),3027,5752400,1900.36,3822,6296200,1647,-543800
2021-11-29,87.5 ( -0.91 %),3728,5253800,1409.28,2804,4720800,1684,533000
2021-11-26,88.3 ( 0.91 %),3536,6198100,1752.86,4102,6086000,1484,112100
2021-11-25,87.5 ( 0 %),3401,4627700,1360.69,2744,4173200,1521,454500
2021-11-24,87.5 ( 1.39 %),3337,5195400,1556.91,3989,4149300,1040,1046100
2021-11-23,86.3 ( 0.12 %),3636,4449600,1223.76,1924,3109700,1616,1339900
2021-11-22,86.2 ( 0.12 %),5280,6151000,1164.96,2933,5025700,1714,1125300
2021-11-19,86.1 ( -2.16 %),8133,7271700,894.1,3554,8706200,2450,-1434500
2021-11-18,88 ( -0.9 %),5883,5901500,1003.14,3184,6992600,2196,-1091100
2021-11-17,88.8 ( 0.23 %),3953,4773800,1207.64,3155,5225700,1656,-451900
2021-11-16,88.6 ( -0.45 %),5482,6036300,1101.11,3700,5842400,1579,193900
2021-11-15,89 ( -0.34 %),4165,6268400,1505.02,3277,6211700,1896,56700
2021-11-12,89.3 ( -0.33 %),3057,4544600,1486.62,3443,4916900,1428,-372300
2021-11-11,89.6 ( -0.11 %),3669,5327100,1451.92,4767,6115600,1283,-788500
2021-11-10,89.7 ( -0.11 %),0,0,0,0,0,0,0
2021-11-09,89.8 ( -1.1 %),4060,5393800,1328.52,5442,8379200,1540,-2985400
2021-11-08,90.8 ( 1.79 %),4752,9061200,1906.82,7363,11376300,1545,-2315100
2021-11-05,89.2 ( 0.9 %),3226,5335000,1653.75,3010,5976500,1986,-641500
2021-11-04,88.4 ( 0.23 %),4861,11183200,2300.6,2428,3997500,1646,7185700
2021-11-03,88.2 ( -1.12 %),6832,12430300,1819.42,5285,7698700,1457,4731600
2021-11-02,89.2 ( -0.89 %),6832,7720900,1130.11,2814,7569200,2690,151700
2021-11-01,90 ( -0.77 %),4578,10583500,2311.82,4311,8435400,1957,2148100
2021-10-29,90.7 ( 0.11 %),3083,8251300,2676.39,3926,7248400,1846,1002900
2021-10-28,90.6 ( 0.22 %),3323,8624900,2595.52,6138,7899300,1287,725600
2021-10-27,90.4 ( 0.89 %),3089,6499500,2104.08,4256,6556700,1541,-57200
2021-10-26,89.6 ( -0.55 %),2562,5727800,2235.68,2288,3394900,1484,2332900
2021-10-25,90.1 ( -0.44 %),2846,4659600,1637.25,3013,4892600,1624,-233000
2021-10-22,90.5 ( 1.57 %),2425,7206000,2971.55,3717,6664500,1793,541500
2021-10-21,89.1 ( -1 %),2037,5890500,2891.75,2645,5380700,2034,509800
2021-10-20,90 ( -0.33 %),2404,5776400,2402.83,3511,6459200,1840,-682800
2021-10-19,90.3 ( 0.56 %),2773,10203500,3679.59,5867,9189100,1566,1014400
2021-10-18,89.8 ( -0.22 %),3447,6909800,2004.58,3044,4814500,1582,2095300
2021-10-15,90 ( 0 %),2986,6210700,2079.94,4108,6786200,1652,-575500
2021-10-14,90 ( -0.11 %),3260,3688100,1131.32,2352,4006000,1703,-317900
2021-10-13,90.1 ( -0.33 %),3981,5754800,1445.57,5511,8076600,1466,-2321800
2021-10-12,90.4 ( 0.44 %),4069,7588100,1864.86,5682,8002500,1408,-414400
2021-10-11,90 ( 0.45 %),3215,4553800,1416.42,2985,4827700,1617,-273900
2021-10-08,89.6 ( 0.9 %),3975,6427700,1617.03,2444,4751500,1944,1676200
2021-10-07,88.8 ( -0.56 %),4025,6633900,1648.17,2203,4583700,2081,2050200
2021-10-06,89.3 ( -0.33 %),3155,6523700,2067.73,2939,5055000,1720,1468700
2021-10-05,89.6 ( -0.67 %),2708,4032600,1489.14,2498,4878100,1953,-845500
2021-10-04,90.2 ( 0.45 %),2749,6996900,2545.25,4987,6697800,1343,299100
2021-10-01,89.8 ( 0.22 %),4197,7198400,1715.13,4123,6291700,1526,906700
2021-09-30,89.6 ( 0 %),3098,4936600,1593.48,3686,6232100,1691,-1295500
2021-09-29,89.6 ( 0.34 %),2909,8509000,2925.06,2587,5114400,1977,3394600
2021-09-28,89.3 ( 0.56 %),4469,6279900,1405.21,2453,6024600,2456,255300
2021-09-27,88.8 ( -2.09 %),4962,7808200,1573.6,4709,9125100,1938,-1316900
2021-09-24,90.7 ( -0.11 %),2708,7083400,2615.73,4462,6345700,1422,737700
2021-09-23,90.8 ( -0.77 %),3583,8231400,2297.35,6388,7907000,1238,324400
2021-09-22,91.5 ( 3.04 %),5322,19948100,3748.23,11039,15741500,1426,4206600
2021-09-21,88.8 ( 0.11 %),2854,6388400,2238.4,3797,6398200,1685,-9800
2021-09-20,88.7 ( 2.54 %),3377,13406600,3969.97,6916,9896100,1431,3510500
2021-09-17,86.5 ( 0.12 %),4065,10593300,2605.98,5471,9533700,1743,1059600
2021-09-16,86.4 ( 0.35 %),2940,4191900,1425.82,2370,3888700,1641,303200
2021-09-15,86.1 ( -1.03 %),2832,4222900,1491.14,3608,3997500,1108,225400
2021-09-14,87 ( -0.23 %),2138,4133500,1933.35,4091,5124000,1253,-990500
2021-09-13,87.2 ( 0.81 %),2618,5888600,2249.27,4459,5523500,1239,365100
2021-09-10,86.5 ( 1.53 %),5835,10128900,1735.89,4023,6672300,1659,3456600
2021-09-09,85.2 ( -0.23 %),4977,4862200,976.93,2246,4042600,1800,819600
2021-09-08,85.4 ( -1.04 %),6535,6188300,946.95,2790,5809400,2082,378900
2021-09-07,86.3 ( -2.27 %),4159,3981900,957.42,3533,5054300,1431,-1072400
2021-09-06,88.3 ( 0.23 %),3332,4653600,1396.64,3842,5468900,1423,-815300
2021-09-01,88.1 ( 0.8 %),3851,5916400,1536.33,4466,6365700,1425,-449300
2021-08-31,87.4 ( 0 %),2977,5228700,1756.37,2920,4600200,1575,628500
2021-08-30,87.4 ( 0.46 %),2695,7520600,2790.58,3368,5886200,1748,1634400
2021-08-27,87 ( 0 %),3483,5105200,1465.75,3204,3840100,1199,1265100
2021-08-26,87 ( 0.12 %),2540,3565600,1403.78,3070,3463300,1128,102300
2021-08-25,86.9 ( 0.7 %),3196,3404400,1065.21,2370,2612000,1102,792400
2021-08-24,86.3 ( 0.35 %),4750,5198400,1094.4,2542,3788700,1490,1409700
2021-08-23,86 ( -2.05 %),6113,6833700,1117.9,3339,6494100,1945,339600
2021-08-20,87.8 ( -2.77 %),5290,6420700,1213.74,3550,7602200,2141,-1181500
2021-08-19,90.3 ( 0.33 %),2725,4970000,1823.85,3701,6118200,1653,-1148200
2021-08-18,90 ( 0.78 %),3781,8171500,2161.2,6211,8459000,1362,-287500
2021-08-17,89.3 ( -0.22 %),2766,4679000,1691.61,2693,4581300,1701,97700
2021-08-16,89.5 ( -0.44 %),3836,6178500,1610.66,3748,5685400,1517,493100
2021-08-13,89.9 ( -0.66 %),3289,7276600,2212.4,4412,7193600,1630,83000
2021-08-12,90.5 ( -0.44 %),3482,8729000,2506.89,6065,7511500,1238,1217500
2021-08-11,90.9 ( 1.68 %),5170,8001000,1547.58,9064,9963400,1099,-1962400
2021-08-10,89.4 ( 1.94 %),5197,10571800,2034.21,9746,10889800,1117,-318000
2021-08-09,87.7 ( 0.57 %),3218,6783200,2107.89,3310,4788600,1447,1994600
2021-08-06,87.2 ( 0.69 %),3818,5927100,1552.41,5795,7223800,1247,-1296700
2021-08-05,86.6 ( -0.57 %),3251,4347900,1337.4,2946,5016500,1703,-668600
2021-08-04,87.1 ( 0 %),2391,4003400,1674.36,3746,5356500,1430,-1353100
2021-08-03,87.1 ( 0.69 %),2340,4241800,1812.74,4912,5538300,1128,-1296500
2021-08-02,86.5 ( 0.46 %),3949,4437200,1123.63,3058,4688000,1533,-250800
2021-07-30,86.1 ( -0.81 %),7285,8801400,1208.15,2968,6518600,2196,2282800
2021-07-29,86.8 ( -0.12 %),5621,4335700,771.34,3082,4400700,1428,-65000
2021-07-28,86.9 ( -0.69 %),3553,2900700,816.41,1901,3486100,1834,-585400
2021-07-27,87.5 ( -1.57 %),3769,3333100,884.35,3783,5754400,1521,-2421300
2021-07-26,88.9 ( 1.48 %),3142,6208700,1976.03,6542,6167200,943,41500
2021-07-23,87.6 ( 0.92 %),4736,6042400,1275.84,6465,7239300,1120,-1196900
2021-07-22,86.8 ( 1.76 %),3429,4191000,1222.22,3978,3947500,992,243500
2021-07-21,85.3 ( -0.7 %),3523,3312700,940.31,2750,2806600,1021,506100
2021-07-20,85.9 ( 1.06 %),2925,5079300,1736.51,3336,4533900,1359,545400
2021-07-19,85 ( -1.05 %),3901,5860900,1502.41,3683,6006800,1631,-145900
2021-07-16,85.9 ( 0.82 %),2157,2693600,1248.77,2982,3558000,1193,-864400
2021-07-15,85.2 ( 0.24 %),3210,5616900,1749.81,3468,4927000,1421,689900
2021-07-14,85 ( 0.83 %),4835,7029800,1453.94,3738,6597100,1765,432700
2021-07-13,84.3 ( -2.32 %),5577,4785200,858.02,2499,4724800,1891,60400
2021-07-12,86.3 ( -0.8 %),5951,7706500,1294.99,5658,8051100,1423,-344600
2021-07-09,87 ( -1.58 %),5877,4657300,792.46,3580,5300600,1481,-643300
2021-07-08,88.4 ( -1.56 %),0,0,0,0,0,0,0
2021-07-07,89.8 ( 3.22 %),4820,6276300,1302.14,5135,7338900,1429,-1062600
2021-07-06,87 ( -2.47 %),0,0,0,0,0,0,0
2021-07-02,90.1 ( -0.88 %),0,0,0,0,0,0,0
2021-07-01,90.9 ( 0.55 %),4269,5313000,1244.55,5945,7913300,1331,-2600300
2021-06-30,90.4 ( -0.66 %),3725,3388800,909.74,4043,4833300,1195,-1444500
2021-06-29,91 ( 2.02 %),6047,7349400,1215.38,8454,8901400,1053,-1552000
2021-06-28,89.2 ( -0.56 %),0,0,0,0,0,0,0
2021-06-25,89.7 ( 1.13 %),4601,4439500,964.9,2856,3942800,1381,496700
2021-06-24,88.7 ( -1.44 %),8523,6368300,747.19,3449,7603000,2204,-1234700
2021-06-23,90 ( -0.66 %),5399,5126800,949.58,3092,5085200,1645,41600
2021-06-22,90.6 ( 0 %),3366,4002900,1189.22,3212,4671800,1454,-668900
2021-06-21,0 ( 0 %),5259,5541000,1053.62,3307,6943300,2100,-1402300
2021-06-18,92.1 ( 1.21 %),3736,4693700,1256.34,4906,7024300,1432,-2330600
2021-06-17,91 ( -0.87 %),4409,3879800,879.97,2868,4734200,1651,-854400
2021-06-16,91.8 ( -1.18 %),3773,4376100,1159.85,3519,5877900,1670,-1501800
2021-06-15,92.9 ( 0.43 %),5125,6021400,1174.91,6237,8087500,1297,-2066100
2021-06-14,92.5 ( 0.54 %),6580,6669800,1013.65,8543,9025400,1056,-2355600
2021-06-11,92 ( -0.22 %),3676,4398500,1196.55,5698,6770600,1188,-2372100
2021-06-10,92.2 ( 3.48 %),10617,11402500,1073.99,10137,11055900,1091,346600
2021-06-09,89.1 ( -0.67 %),8745,4088300,467.5,3577,5596200,1564,-1507900
2021-06-08,89.7 ( 0.34 %),12263,7538500,614.74,7183,8909500,1240,-1371000
2021-06-07,89.4 ( -0.11 %),6088,5206900,855.27,2798,5391700,1927,-184800
2021-06-04,89.5 ( -0.78 %),5278,8014300,1518.44,4113,7894600,1919,119700
2021-06-03,90.2 ( 0.89 %),0,0,0,0,0,0,0
2021-06-02,89.4 ( -0.56 %),4782,5719500,1196.05,3012,5627800,1868,91700
2021-06-01,89.9 ( -0.66 %),2613,5601100,2143.55,3579,5194900,1451,406200
2021-05-31,90.5 ( -0.66 %),3448,5086800,1475.29,4790,6930200,1447,-1843400
2021-05-28,91.1 ( 0.66 %),3344,5876200,1757.24,5680,6590600,1160,-714400
2021-05-27,90.5 ( -0.55 %),3178,4790700,1507.46,6674,7783500,1166,-2992800
2021-05-26,91 ( 0.55 %),5393,8631000,1600.41,6637,10047000,1514,-1416000
2021-05-25,90.5 ( -0.77 %),4142,4822800,1164.37,4984,5769700,1158,-946900
2021-05-24,91.2 ( 2.24 %),5952,10226500,1718.16,9120,10889400,1194,-662900
2021-05-21,89.2 ( 1.36 %),6530,8669000,1327.57,6945,7637800,1100,1031200
2021-05-20,88 ( 0.57 %),5064,7138200,1409.6,3985,5144100,1291,1994100
2021-05-19,87.5 ( 0.57 %),5986,6832900,1141.48,5249,5938400,1131,894500
2021-05-18,87 ( -0.23 %),8043,7959400,989.61,4612,5220000,1132,2739400
2021-05-17,87.2 ( -2.57 %),10111,9588200,948.29,4850,8535100,1760,1053100
2021-05-14,89.5 ( -1.1 %),6823,6806200,997.54,5524,7788500,1410,-982300
2021-05-13,90.5 ( -1.42 %),5470,6929000,1266.73,4582,7128600,1556,-199600
2021-05-12,91.8 ( 0.66 %),6486,6437500,992.52,5061,6446700,1274,-9200
2021-05-11,91.2 ( -1.94 %),8154,6725300,824.79,11856,10933100,922,-4207800
2021-05-10,93 ( 6.9 %),15017,15143100,1008.4,9601,11646500,1213,3496600
2021-05-07,87 ( -2.9 %),15296,14241300,931.05,9872,10803300,1094,3438000
2021-05-06,89.6 ( -2.61 %),13930,11637000,835.39,7178,11652700,1623,-15700
2021-05-05,92 ( 0.44 %),6980,6656900,953.71,4466,6644600,1488,12300
2021-05-04,91.6 ( -2.03 %),7491,6258400,835.46,4549,7533400,1656,-1275000
2021-04-29,93.5 ( -0.21 %),13018,12376000,950.68,8317,10646000,1280,1730000
2021-04-28,93.7 ( -2.09 %),9541,8635900,905.14,4663,9342600,2004,-706700
2021-04-27,95.7 ( -0.31 %),7965,5354300,672.23,3703,6154700,1662,-800400
2021-04-23,99.5 ( 1.53 %),5368,7413200,1381,6332,8282900,1308,-869700
2021-04-22,98 ( -1.31 %),4463,5032200,1127.54,5279,6939900,1315,-1907700
2021-04-20,0 ( 0 %),8822,14318800,1623.08,10027,12745000,1271,1573800
2021-04-19,96.1 ( -0.83 %),11579,11004400,950.38,4386,9115500,2078,1888900
2021-04-16,96.9 ( -2.22 %),9996,7852300,785.54,5133,10057800,1959,-2205500
2021-04-15,99.1 ( -0.2 %),3995,5497700,1376.15,4662,8048700,1726,-2551000
2021-04-14,99.3 ( -0.7 %),6205,6168400,994.1,3768,7224400,1917,-1056000
2021-04-13,100 ( 0 %),3985,5488700,1377.34,6007,7873100,1311,-2384400
2021-04-12,100 ( 0.2 %),5031,6846200,1360.8,4370,6492500,1486,353700
2021-04-09,99.8 ( -0.1 %),5048,4877600,966.24,3114,5571600,1789,-694000
2021-04-08,99.9 ( -0.2 %),6216,5698500,916.75,3148,6089400,1934,-390900
2021-04-07,100.1 ( -1.38 %),5832,5602100,960.58,3516,6126100,1742,-524000
2021-04-06,101.5 ( -1.07 %),5370,5100800,949.87,4418,7274300,1647,-2173500
2021-04-05,102.6 ( -0.1 %),3259,4239600,1300.89,6123,8120100,1326,-3880500
2021-04-02,102.7 ( 1.68 %),3771,6572600,1742.93,7139,7819700,1095,-1247100
2021-04-01,101 ( 2.64 %),5130,8715100,1698.85,7433,7894500,1062,820600
2021-03-31,98.4 ( -0.81 %),4824,4304200,892.25,4684,4869200,1040,-565000
2021-03-30,99.2 ( 0.2 %),3912,4325300,1105.65,3737,5097900,1364,-772600
2021-03-29,99 ( 1.64 %),4649,4999300,1075.35,4011,4639400,1157,359900
2021-03-26,97.4 ( -1.12 %),7622,6389100,838.24,3473,6550100,1886,-161000
2021-03-25,98.5 ( -0.2 %),6831,5435700,795.74,3260,5734500,1759,-298800
2021-03-24,98.7 ( -1.5 %),7161,5323100,743.35,2618,5562600,2125,-239500
2021-03-23,100.2 ( -0.6 %),8547,8102700,948.02,3187,6865300,2154,1237400
2021-03-22,100.8 ( -0.88 %),5910,5757800,974.25,3136,7186700,2292,-1428900
2021-03-19,101.7 ( -0.78 %),3914,4674300,1194.25,3406,6484700,1904,-1810400
2021-03-18,102.5 ( 1.99 %),4097,4960800,1210.84,3830,4833600,1262,127200
2021-03-17,100.5 ( -0.5 %),8609,743860,86.4,2519,599650,238,144210
2021-03-16,101 ( -1.17 %),8507,6764200,795.13,2711,6808000,2511,-43800
2021-03-15,102.2 ( 0 %),3353,358130,106.81,3425,446220,130,-88090
2021-03-12,102.2 ( -0.58 %),3663,4125300,1126.21,4129,5650600,1369,-1525300
2021-03-11,102.8 ( 1.68 %),3888,4472700,1150.39,3949,4743200,1201,-270500
2021-03-10,101.1 ( 0.6 %),8674,7453200,859.26,3841,5245000,1366,2208200
2021-03-09,100.5 ( -1.66 %),0,0,0,0,0,0,0
2021-03-08,102.2 ( -0.78 %),5892,501830,85.17,3247,544330,168,-42500
2021-03-05,103 ( -0.39 %),8667,7227900,833.96,3259,6100300,1872,1127600
2021-03-04,103.4 ( -1.05 %),4739,4180000,882.04,3128,5153200,1647,-973200
2021-03-03,104.5 ( -0.38 %),6225,5098500,819.04,2266,4060900,1792,1037600
2021-03-02,104.9 ( -0.66 %),4862,449730,92.5,2969,575070,194,-125340
2021-03-01,105.6 ( 0.76 %),3669,4217700,1149.55,2356,3702300,1571,515400
2021-02-26,104.8 ( 0.19 %),8646,7205600,833.4,3172,5548500,1749,1657100
2021-02-25,104.6 ( -1.13 %),8654,7838400,905.75,4017,7354600,1831,483800
2021-02-24,105.8 ( -1.12 %),4879,4773600,978.4,2932,5337600,1820,-564000
2021-02-23,107 ( -0.47 %),6155,5317900,864,3006,5053100,1681,264800
2021-02-22,107.5 ( -0.46 %),4672,4800700,1027.55,2719,4875700,1793,-75000
2021-02-19,108 ( -0.92 %),4935,4809200,974.51,3499,4741800,1355,67400
2021-02-18,109 ( 0.28 %),3046,3937400,1292.65,3542,4970400,1403,-1033000
2021-02-17,108.7 ( 0.65 %),4489,4549500,1013.48,3538,4260100,1204,289400
2021-02-09,108 ( 2.56 %),2964,401060,135.31,3273,382760,117,18300
2021-02-08,105.3 ( -3.92 %),7042,734050,104.24,2901,739990,255,-5940
2021-02-05,109.6 ( 0.74 %),1514,3169600,2093.53,3809,4611000,1211,-1441400
2021-02-04,108.8 ( -0.82 %),2588,3100600,1198.07,3271,4297000,1314,-1196400
2021-02-03,109.7 ( 3.1 %),2114,4138000,1957.43,4706,5264900,1119,-1126900
2021-02-02,106.4 ( 3.6 %),2865,5715000,1994.76,4897,5201700,1062,513300
2021-02-01,102.7 ( -0.1 %),3463,5085000,1468.38,3405,5513000,1619,-428000
2021-01-29,102.8 ( 6.97 %),6669,10070000,1509.97,3475,4972900,1431,5097100
2021-01-28,96.1 ( -6.97 %),6443,5847800,907.62,4008,7925500,1977,-2077700
2021-01-27,103.3 ( -3.19 %),5716,4571400,799.76,2800,5443300,1944,-871900
2021-01-26,106.7 ( -1.39 %),5270,387770,73.58,2447,413150,169,-25380
2021-01-25,108.2 ( -0.46 %),4145,378800,91.39,1989,382410,192,-3610
2021-01-22,108.7 ( -1.45 %),4062,390560,96.15,2830,432990,153,-42430
2021-01-21,110.3 ( 1.19 %),3125,4415100,1412.83,2333,4071500,1745,343600
2021-01-20,109 ( 1.21 %),5583,6116300,1095.52,3132,6330800,2021,-214500
2021-01-19,107.7 ( -4.94 %),4892,5193500,1061.63,3250,6488800,1997,-1295300
2021-01-18,113.3 ( -0.53 %),2498,3983300,1594.6,3085,4795800,1555,-812500
2021-01-15,113.9 ( 0.71 %),2836,4166600,1469.18,2971,3905700,1315,260900
2021-01-14,113.1 ( -1.22 %),4880,5867900,1202.44,3044,6041600,1985,-173700
2021-01-13,114.5 ( -1.55 %),2571,3535500,1375.15,3675,5858100,1594,-2322600
2021-01-12,116.3 ( 0.35 %),2055,3492200,1699.37,3873,4820200,1245,-1328000
2021-01-11,115.9 ( 3.48 %),4047,8449000,2087.72,6216,7479300,1203,969700
2021-01-08,112 ( 1.45 %),2841,5374400,1891.73,6393,6848500,1071,-1474100
2021-01-07,110.4 ( 0.55 %),2215,3649600,1647.67,3375,4524600,1341,-875000
2021-01-06,109.8 ( -0.9 %),2305,3615800,1568.68,3602,5130700,1424,-1514900
2021-01-05,110.8 ( 1.37 %),3722,5877600,1579.15,5592,6502600,1163,-625000
2021-01-04,109.3 ( 0.46 %),0,0,0,0,0,0,0
2020-12-31,108.8 ( 0 %),0,0,0,0,0,0,0
2020-12-30,108.8 ( -0.37 %),3175,3219370,1013.97,4210,3555010,844,-335640
2020-12-29,109.2 ( 0.46 %),2738,2579660,942.17,3002,2701300,900,-121640
2020-12-28,108.7 ( -0.28 %),4744,4016260,846.6,2694,4196080,1558,-179820
2020-12-25,109 ( 0.28 %),5184,3333790,643.09,2752,3446180,1252,-112390
2020-12-24,108.7 ( -1.36 %),5630,3847160,683.33,3341,5476710,1639,-1629550
2020-12-23,110.2 ( 0.27 %),3517,4011370,1140.57,3373,4432280,1314,-420910
2020-12-22,109.9 ( -0.99 %),0,0,0,0,0,0,0
2020-12-21,111 ( 0.54 %),4195,3684000,878.19,4011,4520210,1127,-836210
2020-12-18,110.4 ( 0 %),5132,5274840,1027.83,3449,5450950,1580,-176110
2020-12-17,110.4 ( -1.08 %),6219,5069530,815.17,2581,4139850,1604,929680
2020-12-16,111.6 ( 0.36 %),4462,3857290,864.48,2921,3813960,1306,43330
2020-12-15,111.2 ( -1.94 %),9542,6798250,712.46,4944,7161990,1449,-363740
2020-12-14,113.4 ( 0.71 %),3182,4626900,1454.09,4544,4405620,970,221280
2020-12-11,112.6 ( 0.54 %),2828,3433380,1214.07,4100,4155980,1014,-722600
2020-12-10,112 ( 2.1 %),7096,9810680,1382.56,9708,10456560,1077,-645880
2020-12-09,109.7 ( 0.46 %),4377,2638920,602.91,3337,3636700,1090,-997780
2020-12-08,109.2 ( -0.73 %),0,0,0,0,0,0,0
2020-12-07,110 ( 0.92 %),3263,3293360,1009.3,4258,4030560,947,-737200
2020-12-04,109 ( -0.46 %),3371,2764510,820.09,2870,3087430,1076,-322920
2020-12-03,109.5 ( 0.46 %),3240,2255790,696.23,3378,3216350,952,-960560
2020-12-02,109 ( -0.64 %),2633,2031480,771.55,2727,3052450,1119,-1020970
2020-12-01,109.7 ( 1.39 %),4805,4555720,948.12,4101,4219880,1029,335840
2020-11-30,108.2 ( -1.46 %),6068,4234940,697.91,2466,4439650,1800,-204710
2020-11-27,109.8 ( -0.09 %),5721,4432510,774.78,2544,4478870,1761,-46360
2020-11-26,109.9 ( -0.54 %),3297,2382060,722.49,2519,3683920,1462,-1301860
2020-11-25,110.5 ( 0.82 %),3961,3570040,901.3,4146,4479720,1080,-909680
2020-11-23,110.6 ( -0.27 %),3732,3019270,809.02,3836,4492590,1171,-1473320
2020-11-20,0 ( 0 %),3433,4470370,1302.18,5806,5867470,1011,-1397100
2020-11-19,109.7 ( 0.27 %),4523,5498350,1215.64,4422,5195490,1175,302860
2020-11-18,109.4 ( 1.67 %),3496,5236080,1497.73,7256,5667730,781,-431650
2020-11-17,107.6 ( 0.47 %),3692,2904820,786.79,2249,3056680,1359,-151860
2020-11-16,107.1 ( -0.28 %),3812,3610320,947.09,4426,4648460,1050,-1038140
2020-11-13,107.4 ( 0.37 %),2972,2981400,1003.16,2066,2125640,1029,855760
2020-11-12,107 ( -0.47 %),4458,2627720,589.44,1882,2047110,1088,580610
2020-11-11,107.5 ( 0 %),7120,4468240,627.56,2418,3992290,1651,475950
2020-11-10,107.5 ( -1.19 %),4826,3223940,668.04,3951,4478420,1133,-1254480
2020-11-09,108.8 ( 0 %),2364,1634080,691.24,2565,2534790,988,-900710
2020-11-06,108.8 ( 0 %),1797,1539940,856.95,3201,2928650,915,-1388710
2020-11-05,108.8 ( 0.74 %),2815,3070340,1090.71,5079,4668050,919,-1597710
2020-11-04,108 ( 0.28 %),2166,2230800,1029.92,3706,3452740,932,-1221940
2020-11-03,107.7 ( 0.09 %),2279,1577210,692.06,2500,2012360,805,-435150
2020-11-02,107.6 ( -0.37 %),1877,1655360,881.92,2442,2052210,840,-396850
2020-10-30,108 ( 1.03 %),7184,4846310,674.6,6422,4657590,725,188720
2020-10-29,106.9 ( -0.47 %),4933,3383770,685.95,2927,2852800,975,530970
2020-10-28,107.4 ( -2.01 %),0,0,0,0,0,0,0
2020-10-27,109.6 ( -0.81 %),0,0,0,0,0,0,0
2020-10-26,110.5 ( 0.45 %),4119,3471030,842.69,6441,5449910,846,-1978880
2020-10-23,110 ( 3.09 %),4111,4929370,1199.07,5999,5186720,865,-257350
2020-10-22,106.7 ( 0.28 %),5741,3997390,696.29,2290,3766530,1645,230860
2020-10-21,106.4 ( 0.19 %),2536,1512660,596.47,1817,1941290,1068,-428630
2020-10-20,106.2 ( -1.39 %),6060,3388460,559.15,1842,3120880,1694,267580
2020-10-19,107.7 ( 0.28 %),3545,2190320,617.86,3286,3404080,1036,-1213760
2020-10-16,107.4 ( -0.09 %),3835,3097680,807.74,2522,3032120,1202,65560
2020-10-15,107.5 ( 0.09 %),2905,2747420,945.76,2460,3662700,1489,-915280
2020-10-14,107.4 ( 0.28 %),3315,4299220,1296.9,2241,2417960,1079,1881260
2020-10-13,107.1 ( 0.09 %),2075,1716620,827.29,2444,2125290,870,-408670
2020-10-12,107 ( 0.28 %),3025,1976130,653.27,2566,2478150,966,-502020
2020-10-09,106.7 ( -0.19 %),4325,2160760,499.6,1585,2133540,1346,27220
2020-10-08,106.9 ( -1.02 %),4859,2148220,442.11,2693,2515810,934,-367590
2020-10-07,108 ( 0.93 %),4530,6139770,1355.36,2953,3070620,1040,3069150
2020-10-06,107 ( -0.28 %),6727,4696920,698.22,2549,3590020,1408,1106900
2020-10-05,107.3 ( -0.65 %),6930,2634880,380.21,2997,2554620,852,80260
2020-10-02,108 ( -1.19 %),7483,4540310,606.75,3873,4795110,1238,-254800
2020-10-01,109.3 ( 0.37 %),5748,2998500,521.66,2445,2861940,1171,136560
2020-09-30,108.9 ( -0.27 %),5759,2509290,435.72,2501,2752230,1100,-242940
2020-09-29,109.2 ( -14.89 %),17506,9944830,568.08,5600,8434500,1506,1510330
2020-09-28,128.3 ( 0.47 %),3912,3521070,900.07,2813,3430130,1219,90940
2020-09-25,127.7 ( 0.31 %),2459,1663530,676.51,1998,1731700,867,-68170
2020-09-24,127.3 ( -1.47 %),3868,2264940,585.56,2498,2602590,1042,-337650
2020-09-23,129.2 ( -0.31 %),2236,1784470,798.06,2147,2367110,1103,-582640
2020-09-22,129.6 ( -0.38 %),0,0,0,0,0,0,0
2020-09-21,130.1 ( 2.93 %),3178,4062590,1278.35,4325,3854260,891,208330
2020-09-18,126.4 ( 1.53 %),2210,2787710,1261.41,2539,2055770,810,731940
2020-09-17,124.5 ( 0.24 %),2517,3815040,1515.71,2221,2596950,1169,1218090
2020-09-16,124.2 ( -0.48 %),2266,1310000,578.11,1328,1415280,1066,-105280
2020-09-15,124.8 ( 0.48 %),1948,1514710,777.57,1860,1638850,881,-124140
2020-09-14,124.2 ( 0.32 %),2294,2002250,872.82,2266,2168670,957,-166420
2020-09-11,123.8 ( -0.72 %),2925,1798410,614.84,1597,1743340,1092,55070
2020-09-10,124.7 ( 0.73 %),1808,1651400,913.38,1625,1697570,1045,-46170
2020-09-09,123.8 ( -0.32 %),5747,3342050,581.53,1922,2744300,1428,597750
2020-09-08,124.2 ( -1.43 %),4919,3092360,628.66,2601,3256480,1252,-164120
2020-09-07,126 ( 0.8 %),3410,4037650,1184.06,3572,3580800,1002,456850
2020-09-04,125 ( 0.24 %),4030,3137350,778.5,2828,3065700,1084,71650
2020-09-03,124.7 ( 1.22 %),3357,3304470,984.35,3298,3353600,1017,-49130
2020-09-01,123.2 ( 1.82 %),3359,2678180,797.31,3110,2368000,761,310180
2020-08-31,121 ( 1.42 %),2964,2396720,808.61,2860,2439760,853,-43040
2020-08-28,119.3 ( 1.79 %),3181,2703990,850.04,3065,2421320,790,282670
2020-08-27,117.2 ( 0.09 %),1935,1529630,790.51,1363,1740640,1277,-211010
2020-08-26,117.1 ( -0.17 %),3091,2963090,958.62,3293,3175480,964,-212390
2020-08-25,117.3 ( 0.69 %),2798,2534330,905.76,3392,2843440,838,-309110
2020-08-24,116.5 ( 0.78 %),1908,2486200,1303.04,2833,3145970,1110,-659770
2020-08-21,115.6 ( 0.35 %),1828,2353080,1287.24,1765,1394280,790,958800
2020-08-20,115.2 ( -0.09 %),3189,2051570,643.33,1702,2368510,1392,-316940
2020-08-19,115.3 ( -0.26 %),3093,1660230,536.77,1410,1462040,1037,198190
2020-08-18,115.6 ( -1.2 %),2751,1045520,380.05,2506,1474270,588,-428750
2020-08-17,117 ( 0.26 %),2878,1778630,618.01,2220,1896750,854,-118120
2020-08-14,116.7 ( 0.26 %),2187,2411250,1102.54,3579,2877080,804,-465830
2020-08-13,116.4 ( 0.69 %),1793,1799130,1003.42,2188,2582290,1180,-783160
2020-08-12,115.6 ( 0.96 %),1779,2245750,1262.37,2243,3163890,1411,-918140
2020-08-11,114.5 ( 0 %),2504,1490140,595.1,2422,1748470,722,-258330
2020-08-10,114.5 ( -0.87 %),3085,1943910,630.12,3440,2653000,771,-709090
2020-08-07,115.5 ( 0.61 %),2603,1875090,720.36,2790,2519790,903,-644700
2020-08-06,114.8 ( 2.41 %),2911,2610630,896.82,3825,3307220,865,-696590
2020-08-05,112.1 ( 0.72 %),2558,1662360,649.87,2201,1827620,830,-165260
2020-08-04,111.3 ( 1.92 %),2210,1554240,703.28,2353,1268110,539,286130
2020-08-03,109.2 ( 2.06 %),2701,1598100,591.67,1984,1445050,728,153050
2020-07-31,107 ( -1.83 %),2984,1894220,634.79,1715,1496820,873,397400
2020-07-30,109 ( 2.83 %),2858,1960940,686.12,2589,1872510,723,88430
2020-07-29,106 ( -3.55 %),6082,2574380,423.28,2161,2369260,1096,205120
2020-07-28,109.9 ( 6.29 %),4582,3518880,767.98,2094,1888640,902,1630240
2020-07-27,103.4 ( -6.93 %),5732,3261790,569.05,4053,4308310,1063,-1046520
2020-07-24,111.1 ( -2.71 %),6330,3487670,550.97,3333,3524740,1058,-37070
2020-07-23,114.2 ( 0.09 %),2777,1398540,503.62,2037,1163420,571,235120
2020-07-22,114.1 ( -1.64 %),2549,1453010,570.03,2285,1519550,665,-66540
2020-07-21,116 ( 0.26 %),2676,2666310,996.38,1772,2075930,1172,590380
2020-07-20,115.7 ( -0.94 %),1713,813100,474.66,1606,836090,521,-22990
2020-07-17,116.8 ( -0.6 %),1809,1098310,607.14,2085,1288970,618,-190660
2020-07-16,117.5 ( 1.29 %),1585,2171940,1370.31,2083,1603290,770,568650
2020-07-15,116 ( 0.69 %),1651,1423190,862.02,2689,1994100,742,-570910
2020-07-14,115.2 ( 0.35 %),3078,1582060,513.99,1151,1091570,948,490490
2020-07-13,114.8 ( -0.43 %),1824,1250000,685.31,1252,1521500,1215,-271500
2020-07-10,115.3 ( -0.52 %),1824,900190,493.53,1545,1278070,827,-377880
2020-07-09,115.9 ( 0.35 %),0,0,0,0,0,0,0
2020-07-08,115.5 ( -0.43 %),1350,1199630,888.61,1402,1077290,768,122340
2020-07-07,116 ( -0.43 %),1661,1260970,759.16,2305,1844910,800,-583940
2020-07-06,116.5 ( 2.1 %),1572,2082170,1324.54,2283,1798200,788,283970
2020-07-03,114.1 ( 0.97 %),1336,1328740,994.57,1622,1243340,767,85400
2020-07-02,113 ( -1.48 %),2443,1071150,438.46,2262,1286470,569,-215320
2020-07-01,114.7 ( 1.77 %),1648,923460,560.35,1533,779040,508,144420
2020-06-30,112.7 ( 0.71 %),2010,1237680,615.76,1414,1303470,922,-65790
2020-06-29,111.9 ( -3.45 %),6451,2516590,390.11,1968,2309400,1173,207190
2020-06-26,115.9 ( -0.43 %),2012,825120,410.1,1371,1045700,763,-220580
2020-06-25,116.4 ( -0.6 %),2323,1297190,558.41,1232,1023910,831,273280
2020-06-24,117.1 ( 0.95 %),2042,1257970,616.05,2198,1593470,725,-335500
2020-06-23,116 ( 0.52 %),2295,1679920,731.99,1436,1725530,1202,-45610
2020-06-22,115.4 ( 0.35 %),2674,1647830,616.24,1182,1447360,1225,200470
2020-06-19,115 ( -0.17 %),3296,2965700,899.79,1101,1678950,1525,1286750
2020-06-18,115.2 ( -0.35 %),2801,1205660,430.44,1232,1120110,909,85550
2020-06-17,115.6 ( -1.2 %),2143,885190,413.06,1691,1073570,635,-188380
2020-06-16,117 ( 4.46 %),2914,1764260,605.44,3446,1395770,405,368490
2020-06-15,112 ( -5.08 %),6134,2850050,464.63,2315,3887540,1679,-1037490
2020-06-12,118 ( -3.52 %),5945,4096910,689.14,3388,4311750,1273,-214840
2020-06-11,122.3 ( -0.57 %),2207,1611210,730.05,2232,2589780,1160,-978570
2020-06-10,123 ( -1.6 %),2682,1976280,736.87,3190,2550960,800,-574680
2020-06-09,125 ( 1.79 %),1970,3125790,1586.7,3608,2940330,815,185460
2020-06-08,122.8 ( 3.02 %),0,0,0,0,0,0,0
2020-06-05,119.2 ( 1.19 %),2913,3982880,1367.28,4922,3180880,646,802000
2020-06-04,117.8 ( 1.03 %),1143,1179490,1031.92,2424,1695590,700,-516100
2020-06-03,116.6 ( 0.52 %),1813,2257590,1245.22,2422,2480800,1024,-223210
2020-06-02,116 ( -0.09 %),1597,1223030,765.83,2708,2131060,787,-908030
2020-06-01,116.1 ( 0.96 %),1510,1701490,1126.81,2102,2032610,967,-331120
2020-05-29,115 ( 0.17 %),2935,2455880,836.76,1758,1869700,1064,586180
2020-05-28,114.8 ( -0.17 %),1993,1659580,832.7,1719,2046050,1190,-386470
2020-05-27,115 ( -2.21 %),3090,1725360,558.37,1780,2100140,1180,-374780
2020-05-26,117.6 ( 0 %),2244,1775100,791.04,2386,2324670,974,-549570
2020-05-25,117.6 ( 2.8 %),2770,3659350,1321.06,3474,2737680,788,921670
2020-05-22,114.4 ( -0.52 %),1551,1630340,1051.15,2137,2145540,1004,-515200
2020-05-21,115 ( 0.88 %),1600,2208380,1380.24,2703,3152330,1166,-943950
2020-05-20,114 ( 1.24 %),1557,3439280,2208.91,3279,3077010,938,362270
2020-05-19,112.6 ( 1.35 %),1994,3564430,1787.58,3647,3688440,1011,-124010
2020-05-18,111.1 ( 0.27 %),2531,2069020,817.47,2575,2030380,788,38640
2020-05-15,110.8 ( -1.95 %),5821,3495760,600.54,3344,4169920,1247,-674160
2020-05-14,113 ( -0.62 %),2645,2306250,871.93,2707,2351860,869,-45610
2020-05-13,113.7 ( -0.18 %),4906,4436710,904.34,3963,4815390,1215,-378680
2020-05-12,113.9 ( 4.98 %),6296,5198940,825.75,6245,5300900,849,-101960
2020-05-11,108.5 ( 3.33 %),0,0,0,0,0,0,0
2020-05-08,105 ( 1.55 %),3000,4499780,1499.93,7074,5628720,796,-1128940
2020-05-07,103.4 ( 1.87 %),3145,3264950,1038.14,3704,2698120,728,566830
2020-05-06,101.5 ( 1 %),2347,2114340,900.87,2549,1954290,767,160050
2020-05-05,100.5 ( 2.97 %),2832,2323810,820.55,2564,1728950,674,594860
2020-05-04,97.6 ( -1.41 %),5148,2415670,469.24,1438,1716200,1193,699470
2020-04-29,99 ( -1.49 %),5584,3842210,688.07,2061,2953510,1433,888700
2020-04-28,100.5 ( -2.24 %),4200,2496200,594.33,3105,3927030,1265,-1430830
2020-04-27,102.8 ( 0 %),3783,2790420,737.62,3862,5069160,1313,-2278740
2020-04-24,102.8 ( 6.97 %),5765,6645350,1152.71,6409,5081410,793,1563940
2020-04-23,96.1 ( -1.44 %),5334,2351930,440.93,2408,2496480,1037,-144550
2020-04-22,97.5 ( 0.72 %),3536,2051970,580.31,1548,1485840,960,566130
2020-04-21,96.8 ( -3.2 %),6739,3371940,500.36,2748,3391610,1234,-19670
2020-04-20,100 ( 0.7 %),2982,2732780,916.43,2579,2428530,942,304250
2020-04-17,99.3 ( 0 %),3989,3076390,771.22,2651,2600390,981,476000
2020-04-16,99.3 ( 0.1 %),2820,2100640,744.91,2049,1737370,848,363270
2020-04-15,99.2 ( 0.2 %),2170,1535230,707.48,2036,1530370,752,4860
2020-04-14,99 ( -0.1 %),2663,1510760,567.32,2239,1775330,793,-264570
2020-04-13,99.1 ( -0.5 %),3510,2274540,648.02,2435,1697520,697,577020
2020-04-10,99.6 ( -0.5 %),2957,2037040,688.89,2393,2184700,913,-147660
2020-04-09,100.1 ( 1.11 %),3167,2162820,682.92,2986,2240830,750,-78010
2020-04-08,99 ( 0.51 %),2898,2227920,768.78,2031,1313050,647,914870
2020-04-07,98.5 ( 2.39 %),3914,3996460,1021.07,3862,3256780,843,739680
2020-04-06,96.2 ( 1.26 %),3714,3134040,843.84,2523,2744590,1088,389450
2020-04-03,95 ( 1.06 %),3910,2981950,762.65,3305,3865400,1170,-883450
2020-04-01,94 ( 3.3 %),2162,2488170,1150.86,2194,1747080,796,741090
2020-03-31,91 ( -0.22 %),2796,2486900,889.45,2392,2048470,856,438430
2020-03-30,91.2 ( -3.08 %),3574,2997950,838.82,2023,2373450,1173,624500
2020-03-27,94.1 ( 0.11 %),6316,4144960,656.26,7228,4236830,586,-91870
2020-03-26,94 ( 2.17 %),5496,4124880,750.52,5594,3807660,681,317220
2020-03-25,92 ( 6.85 %),6020,4192190,696.38,3706,3941030,1063,251160
2020-03-24,86.1 ( 2.87 %),3160,3846570,1217.27,4488,2706110,603,1140460
2020-03-23,83.7 ( -7 %),4363,2586350,592.79,2921,3862750,1322,-1276400
2020-03-20,90 ( 1.12 %),4234,3661610,864.81,2926,3380050,1155,281560
2020-03-19,89 ( -6.32 %),6871,3952820,575.29,2955,4736780,1603,-783960
2020-03-18,95 ( -1.04 %),4158,2333680,561.25,3688,2348340,637,-14660
2020-03-17,96 ( -1.03 %),3754,3057710,814.52,2098,2924520,1394,133190
2020-03-16,97 ( -2.12 %),3462,1808630,522.42,2011,2067110,1028,-258480
2020-03-13,99.1 ( -1.78 %),5509,3772180,684.73,3030,3221990,1063,550190
2020-03-12,100.9 ( -0.69 %),5331,4102880,769.63,5103,3191540,625,911340
2020-03-11,101.6 ( -0.1 %),5817,3588880,616.96,3404,3402230,999,186650
2020-03-10,101.7 ( 4.85 %),4654,3594800,772.41,3115,2412830,775,1181970
2020-03-09,97 ( -6.91 %),5466,3200740,585.57,3264,3602950,1104,-402210
2020-03-06,104.2 ( -0.29 %),2612,1159490,443.91,1289,1145280,889,14210
2020-03-05,104.5 ( -0.29 %),1808,765030,423.14,1089,914870,840,-149840
2020-03-04,104.8 ( -0.47 %),1813,1080420,595.93,1488,1165650,783,-85230
2020-03-03,105.3 ( 0.77 %),1990,1416890,712.01,1834,1336680,729,80210
2020-03-02,104.5 ( 0 %),0,0,0,0,0,0,0
2020-02-28,104.5 ( -2.7 %),4737,2423780,511.67,1800,2484690,1380,-60910
2020-02-27,107.4 ( 2.29 %),3198,1705460,533.29,2339,1291930,552,413530
2020-02-26,105 ( -2.78 %),3436,2061220,599.89,4594,1883620,410,177600
2020-02-25,108 ( 1.5 %),2117,1923870,908.77,2195,1696900,773,226970
2020-02-24,106.4 ( -1.94 %),0,0,0,0,0,0,0
2020-02-21,108.5 ( 1.97 %),0,0,0,0,0,0,0
2020-02-20,106.4 ( 0 %),1865,1038070,556.61,1285,1023210,796,14860
2020-02-19,106.4 ( 0.85 %),3761,1461790,388.67,1982,1181530,596,280260
2020-02-18,105.5 ( -1.86 %),3376,1670690,494.87,1424,1903260,1337,-232570
2020-02-17,107.5 ( 0.84 %),1681,1120390,666.5,1154,974170,844,146220
2020-02-14,106.6 ( -0.28 %),1828,1080180,590.91,1216,1181640,972,-101460
2020-02-13,106.9 ( -0.28 %),2673,1293330,483.85,1019,1040010,1021,253320
2020-02-12,107.2 ( 0 %),2198,1297780,590.44,1250,1247300,998,50480
2020-02-11,107.2 ( -1.65 %),2653,1489360,561.39,1245,1439490,1156,49870
2020-02-10,109 ( -1.09 %),2661,1645930,618.54,2399,1413180,589,232750
2020-02-07,110.2 ( 2.51 %),2976,2688010,903.23,2406,2210120,919,477890
2020-02-06,107.5 ( 0.84 %),3260,3477740,1066.79,2209,2844400,1288,633340
2020-02-05,106.6 ( 1.52 %),4335,3170010,731.26,3044,2195970,721,974040
2020-02-04,105 ( -3.05 %),4756,2882400,606.06,2093,2936460,1403,-54060
2020-02-03,108.3 ( -0.18 %),4504,3773840,837.89,2803,3168390,1130,605450
2020-01-31,108.5 ( -6.95 %),5287,2300210,435.07,2508,3380680,1348,-1080470
2020-01-30,116.6 ( -3.87 %),3485,1969090,565.02,1481,2246950,1517,-277860
2020-01-22,121.3 ( 0.25 %),2567,1102410,429.45,1590,1466440,922,-364030
2020-01-21,121 ( 1.68 %),1726,1242270,719.74,1808,1337160,740,-94890
2020-01-20,119 ( 0.34 %),937,760080,811.18,1166,875900,751,-115820
2020-01-17,118.6 ( 0.34 %),755,627960,831.74,926,688290,743,-60330
2020-01-16,118.2 ( 0.34 %),1059,817800,772.24,1386,961150,693,-143350
2020-01-15,117.8 ( 0 %),2117,1046510,494.34,1001,1023700,1023,22810
2020-01-14,117.8 ( 0.34 %),1464,621030,424.2,1011,608740,602,12290
2020-01-13,117.4 ( -1.26 %),1340,531510,396.65,951,859610,904,-328100
2020-01-10,118.9 ( 0.25 %),962,863980,898.11,1210,1036550,857,-172570
2020-01-09,118.6 ( -0.17 %),1188,960840,808.79,1401,1459530,1042,-498690
2020-01-08,118.8 ( 0.25 %),1531,1215350,793.83,1482,1389240,937,-173890
2020-01-07,118.5 ( 0.94 %),1408,874910,621.38,1395,909060,652,-34150
2020-01-06,117.4 ( -0.76 %),1643,816350,496.87,991,795850,803,20500
2020-01-03,118.3 ( 0.34 %),1663,979290,588.87,1758,1208020,687,-228730
2020-01-02,117.9 ( 1.2 %),1482,689490,465.24,1276,966890,758,-277400
2019-12-31,116.5 ( 0 %),1524,694030,455.4,880,853340,970,-159310
2019-12-30,116.5 ( -1.44 %),2140,1035550,483.9,806,1074590,1333,-39040
2019-12-27,118.2 ( 1.03 %),2345,821260,350.22,869,714030,822,107230
2019-12-26,117 ( -0.85 %),1542,467400,303.11,589,704350,1196,-236950
2019-12-25,118 ( -0.51 %),1556,873350,561.28,825,1124340,1363,-250990
2019-12-24,118.6 ( 0.51 %),1306,1069550,818.95,736,943030,1281,126520
2019-12-23,118 ( -1.67 %),0,0,0,0,0,0,0
2019-12-20,120 ( 0.25 %),1252,2293590,1831.94,2307,2820000,1222,-526410
2019-12-19,119.7 ( 0.93 %),2958,2258880,763.65,2214,2694080,1217,-435200
2019-12-18,118.6 ( 1.28 %),1862,2337660,1255.46,1978,2318520,1172,19140
2019-12-17,117.1 ( -1.35 %),2045,1168760,571.52,2047,1493700,730,-324940
2019-12-16,118.7 ( 0.59 %),1609,1180310,733.57,1069,1148770,1075,31540
2019-12-13,118 ( -1.01 %),1343,828280,616.74,1250,1237610,990,-409330
2019-12-12,119.2 ( 0.51 %),1613,1144100,709.3,1245,1253510,1007,-109410
2019-12-11,118.6 ( 0.34 %),1697,1364880,804.29,1001,1031850,1031,333030
2019-12-10,118.2 ( 0.08 %),1677,1510010,900.42,1906,1329620,698,180390
2019-12-09,118.1 ( 1.55 %),1893,1325070,699.98,1527,1170560,767,154510
2019-12-06,116.3 ( -1.27 %),2982,1589960,533.19,1332,1920120,1442,-330160
2019-12-05,117.8 ( -0.84 %),1668,1033330,619.5,1265,1445070,1142,-411740
2019-12-04,118.8 ( 2.06 %),0,0,0,0,0,0,0
2019-12-03,116.4 ( -1.61 %),4417,2254300,510.37,1785,2099650,1176,154650
2019-12-02,118.3 ( -2.63 %),3803,1900540,499.75,1864,2560320,1374,-659780
2019-11-29,121.5 ( -0.49 %),1516,954180,629.41,1176,967770,823,-13590
2019-11-28,122.1 ( 0 %),3007,1933940,643.15,1356,1629140,1201,304800
2019-11-27,122.1 ( -0.73 %),1386,759710,548.13,1040,1005100,966,-245390
2019-11-26,123 ( 0.08 %),2155,1675810,777.64,1683,1738910,1033,-63100
2019-11-25,122.9 ( 1.15 %),1721,1326500,770.77,1505,1166430,775,160070
2019-11-22,121.5 ( -0.41 %),2191,1531920,699.19,1459,1320890,905,211030
2019-11-21,122 ( -1.61 %),3133,3243590,1035.3,1315,2305920,1754,937670
2019-11-20,124 ( -0.32 %),1973,1818030,921.45,1891,2149430,1137,-331400
2019-11-19,124.4 ( 2.98 %),3572,2535690,709.88,2010,1570610,781,965080
2019-11-18,120.8 ( -1.79 %),5572,2948470,529.16,1835,2470770,1346,477700
2019-11-15,123 ( -2.3 %),7759,4531350,584.01,3926,3759090,957,772260
2019-11-14,125.9 ( 0.32 %),2190,1062130,484.99,1307,1232740,943,-170610
2019-11-13,125.5 ( -1.57 %),5576,2972500,533.09,2141,3289600,1536,-317100
2019-11-12,127.5 ( -1.39 %),5048,3055200,605.23,3304,2662710,806,392490
2019-11-11,129.3 ( 0.08 %),1566,1141440,728.89,1108,1124700,1015,16740
2019-11-08,129.2 ( 0.08 %),2495,2027620,812.67,1761,1942330,1103,85290
2019-11-07,129.1 ( -0.77 %),2958,1815370,613.72,1283,1211100,944,604270
2019-11-06,130.1 ( 0.7 %),3418,2222890,650.35,1517,1698830,1120,524060
2019-11-05,129.2 ( -1.6 %),4842,2870550,592.84,1488,3114890,2093,-244340
2019-11-04,131.3 ( -0.83 %),3142,2167150,689.74,1196,2143180,1792,23970
2019-11-01,132.4 ( 1.85 %),1849,1593550,861.84,1430,1422690,995,170860
2019-10-31,130 ( -1.52 %),5201,3705870,712.53,1835,4139690,2256,-433820
2019-10-30,132 ( -1.57 %),2563,2277530,888.62,1557,2262250,1453,15280
2019-10-29,134.1 ( 0.22 %),1249,1067320,854.54,1459,1087520,745,-20200
2019-10-28,133.8 ( -0.52 %),1278,929500,727.31,1883,1397360,742,-467860
2019-10-25,134.5 ( 1.43 %),1365,1305550,956.45,1934,1528500,790,-222950
2019-10-24,132.6 ( 0.23 %),1233,909230,737.41,1125,1004380,893,-95150
2019-10-23,132.3 ( -0.15 %),1723,1380210,801.05,1375,1400040,1018,-19830
2019-10-22,132.5 ( -0.82 %),1367,1706030,1248.01,2291,2567920,1121,-861890
2019-10-21,133.6 ( 0.83 %),1945,2752910,1415.38,3436,3468020,1009,-715110
2019-10-18,132.5 ( 1.15 %),1375,1879170,1366.67,2272,2095440,922,-216270
2019-10-17,131 ( 0.46 %),1892,2139990,1131.07,2848,2535490,890,-395500
2019-10-16,130.4 ( 1.64 %),2033,2249780,1106.63,3390,2348060,693,-98280
2019-10-15,128.3 ( -0.23 %),1441,1597790,1108.81,1669,1778270,1065,-180480
2019-10-14,128.6 ( 0.47 %),1563,1002360,641.31,1218,1134040,931,-131680
2019-10-11,128 ( 0.79 %),1106,932140,842.8,959,1001680,1045,-69540
2019-10-10,127 ( 0 %),1172,903290,770.73,1019,769800,755,133490
2019-10-09,127 ( -1.55 %),1584,1014620,640.54,1110,1099580,991,-84960
2019-10-08,129 ( -0.08 %),630,800990,1271.41,1260,1008560,800,-207570
2019-10-07,129.1 ( 0.39 %),1414,1189430,841.18,1871,1543180,825,-353750
2019-10-04,128.6 ( -0.31 %),1031,1019450,988.8,2297,1464110,637,-444660
2019-10-03,129 ( 1.57 %),2101,1704140,811.11,1166,1171150,1004,532990
2019-10-02,127 ( -0.78 %),3509,3068740,874.53,2151,2785420,1295,283320
2019-10-01,128 ( -1.31 %),2351,1802730,766.79,1917,2062380,1076,-259650
2019-09-30,129.7 ( -0.31 %),1938,1298800,670.18,1941,1670410,861,-371610
2019-09-27,130.1 ( 0.08 %),2312,1758720,760.69,2889,2273580,787,-514860
2019-09-26,130 ( 2.85 %),2520,2636490,1046.23,3505,2315980,661,320510
2019-09-25,126.4 ( -0.39 %),1664,1391710,836.36,1500,1194510,796,197200
2019-09-24,126.9 ( 1.93 %),3360,2285920,680.33,3551,2223370,626,62550
2019-09-23,124.5 ( 1.97 %),2485,2106960,847.87,3359,2587420,770,-480460
2019-09-20,122.1 ( -1.21 %),2395,3377310,1410.15,1293,2445910,1892,931400
2019-09-19,123.6 ( -0.08 %),1362,1108440,813.83,1516,1538700,1015,-430260
2019-09-18,123.7 ( 0.98 %),1741,1674800,961.98,2116,1988350,940,-313550
2019-09-17,122.5 ( 0.82 %),1191,877220,736.54,1201,1105790,921,-228570
2019-09-16,121.5 ( -0.49 %),2301,1106480,480.87,1293,1032980,799,73500
2019-09-13,122.1 ( 0.08 %),1473,1031890,700.54,846,972350,1149,59540
2019-09-12,122 ( -0.08 %),2086,1554050,744.99,1173,1124920,959,429130
2019-09-11,122.1 ( -1.29 %),791,627730,793.59,1286,908900,707,-281170
2019-09-10,123.7 ( -0.64 %),1775,915990,516.05,1386,1235160,891,-319170
2019-09-09,124.5 ( 1.38 %),1550,727590,469.41,1278,888540,695,-160950
2019-09-06,122.8 ( 0.66 %),779,934700,1199.87,916,750900,820,183800
2019-09-05,122 ( -1.45 %),1478,1498010,1013.54,1096,1045000,953,453010
2019-09-04,123.8 ( -0.16 %),1102,1324070,1201.52,1222,1037570,849,286500
2019-09-03,124 ( 0.81 %),907,1515710,1671.12,1902,1395450,734,120260
2019-08-30,123 ( 0 %),1319,1647910,1249.36,2438,2387120,979,-739210
2019-08-29,123 ( 3.02 %),1580,1890400,1196.46,1455,1405520,966,484880
2019-08-28,119.4 ( 0.34 %),2080,960480,461.77,793,877840,1107,82640
2019-08-27,119 ( -1.24 %),2875,1532690,533.11,1061,1440880,1358,91810
2019-08-26,120.5 ( -2.03 %),3352,1433170,427.56,858,1530740,1784,-97570
2019-08-23,123 ( -0.81 %),1814,1456230,802.77,1618,1279840,791,176390
2019-08-22,124 ( 0.08 %),1191,896480,752.71,1493,1087900,729,-191420
2019-08-21,123.9 ( -0.4 %),1572,1101190,700.5,1706,1013380,594,87810
2019-08-20,124.4 ( -0.4 %),1594,1126410,706.66,2090,1635670,783,-509260
2019-08-19,124.9 ( 0.64 %),1855,1181340,636.84,2809,1475960,525,-294620
2019-08-16,124.1 ( 1.72 %),3373,2232550,661.89,3246,2274860,701,-42310
2019-08-15,122 ( 2.78 %),2457,1713930,697.57,1155,915850,793,798080
2019-08-14,118.7 ( 0.59 %),2041,1060740,519.72,1079,1037900,962,22840
2019-08-13,118 ( -2.16 %),4744,1636150,344.89,1391,1803010,1296,-166860
2019-08-12,120.6 ( -0.33 %),1620,675690,417.09,900,1014210,1127,-338520
2019-08-09,121 ( 0.08 %),1631,1134900,695.83,1179,1435090,1217,-300190
2019-08-08,120.9 ( -0.08 %),1872,1169590,624.78,936,1118080,1195,51510
2019-08-07,121 ( 0.67 %),1775,1497050,843.41,1451,1365720,941,131330
2019-08-06,120.2 ( -1.48 %),3351,1732310,516.95,1439,1662110,1155,70200
2019-08-05,122 ( -1.61 %),2151,1191170,553.77,1213,1529930,1261,-338760
2019-08-02,124 ( -0.16 %),1237,848400,685.85,1081,966850,894,-118450
2019-08-01,124.2 ( 0.81 %),1374,1163700,846.94,1104,1094900,992,68800
2019-07-31,123.2 ( -0.24 %),1906,1355520,711.19,1040,1248960,1201,106560
2019-07-30,123.5 ( 0 %),1985,1405260,707.94,1719,1820930,1059,-415670
2019-07-29,123.5 ( -0.8 %),3107,2164050,696.51,1317,1656040,1257,508010
2019-07-26,124.5 ( -0.48 %),1347,791760,587.8,1222,1039760,851,-248000
2019-07-25,125.1 ( -0.4 %),1474,1177900,799.12,1334,1102250,826,75650
2019-07-24,125.6 ( 0.16 %),1057,1176380,1112.94,1342,1243200,926,-66820
2019-07-23,125.4 ( -0.08 %),1744,1244620,713.66,1037,1211110,1168,33510
2019-07-22,125.5 ( -1.1 %),1613,1064980,660.25,1153,1217720,1056,-152740
2019-07-19,126.9 ( 1.85 %),1932,2344230,1213.37,2604,2196720,844,147510
2019-07-18,124.6 ( -0.64 %),1042,1098240,1053.97,961,1354490,1409,-256250
2019-07-17,125.4 ( 1.13 %),1411,1475490,1045.71,1880,1509090,803,-33600
2019-07-16,124 ( 0.65 %),1136,913010,803.71,913,957070,1048,-44060
2019-07-15,123.2 ( -0.65 %),1990,1271790,639.09,922,1255870,1362,15920
2019-07-12,124 ( -0.96 %),1231,557140,452.59,1505,1161850,772,-604710
2019-07-11,125.2 ( 0.16 %),762,431840,566.72,1386,1068930,771,-637090
2019-07-10,125 ( 0 %),1043,542940,520.56,1437,1067290,743,-524350
2019-07-09,125 ( 0.64 %),2143,1464490,683.38,1043,1930980,1851,-466490
2019-07-08,124.2 ( -1.58 %),2320,1736930,748.68,1314,1793130,1365,-56200
2019-07-05,126.2 ( 0 %),968,1042330,1076.79,1059,1850670,1748,-808340
2019-07-04,126.2 ( 0.16 %),0,0,0,0,0,0,0
2019-07-03,126 ( 0.72 %),1792,1606340,896.4,896,1463410,1633,142930
2019-07-02,125.1 ( 0.08 %),1792,1606340,896.4,896,1463410,1633,142930
2019-07-01,125 ( 1.63 %),1584,1592650,1005.46,2008,1352950,674,239700
2019-06-28,123 ( -0.08 %),0,0,0,0,0,0,0
2019-06-27,123.1 ( -0.32 %),1751,1252770,715.46,1230,1204390,979,48380
2019-06-26,123.5 ( 0.08 %),1973,1052180,533.29,983,925960,942,126220
2019-06-25,123.4 ( 0.24 %),1592,1443890,906.97,944,1156360,1225,287530
2019-06-24,123.1 ( -1.91 %),1605,970780,604.85,1015,1351050,1331,-380270
2019-06-21,125.5 ( 1.78 %),1624,3159830,1945.71,1678,4249170,2532,-1089340
2019-06-20,123.3 ( -0.08 %),1792,1606340,896.4,896,1463410,1633,142930
2019-06-19,123.4 ( 0.33 %),2206,1344720,609.57,808,1251410,1549,93310
2019-06-18,123 ( -0.57 %),2235,1412800,632.13,802,1850980,2308,-438180
2019-06-17,123.7 ( 0 %),1393,1174760,843.33,829,1692430,2042,-517670
2019-06-14,123.7 ( 0.41 %),2011,1530210,760.92,959,929740,969,600470
2019-06-13,123.2 ( -1.6 %),2820,1992620,706.6,2506,1746730,697,245890
2019-06-12,125.2 ( -0.24 %),1796,1143710,636.81,1229,934740,761,208970
2019-06-11,125.5 ( -1.1 %),1969,941500,478.16,1693,983630,581,-42130
2019-06-10,126.9 ( 0.24 %),1698,925410,545,1111,1267740,1141,-342330
2019-06-07,126.6 ( 0.08 %),1365,613590,449.52,682,589550,864,24040
2019-06-06,126.5 ( -0.78 %),1753,918660,524.05,767,1041950,1358,-123290
2019-06-05,127.5 ( -0.86 %),1625,707000,435.08,848,648170,764,58830
2019-06-04,128.6 ( 0.47 %),1643,1013510,616.87,659,991720,1505,21790
2019-06-03,128 ( -1.16 %),0,0,0,0,0,0,0
2019-05-31,129.5 ( -1.52 %),2065,1035620,501.51,726,1200090,1653,-164470
2019-05-30,131.5 ( -1.05 %),1190,967840,813.31,1114,949750,853,18090
2019-05-29,132.9 ( 0.68 %),920,546220,593.72,908,863270,951,-317050
2019-05-28,132 ( -1.49 %),1611,1964250,1219.27,1102,1134150,1029,830100
2019-05-27,134 ( 2.68 %),1170,768720,657.03,1194,843230,706,-74510
2019-05-24,130.5 ( -1.21 %),2667,1352560,507.15,917,1243820,1356,108740
2019-05-23,132.1 ( 0 %),1553,881510,567.62,721,671690,932,209820
2019-05-22,132.1 ( -1.05 %),2181,1140840,523.08,1164,1045080,898,95760
2019-05-21,133.5 ( -2.91 %),2133,1483490,695.49,2246,1423130,634,60360
2019-05-20,137.5 ( 1.4 %),682,941110,1379.93,1365,887850,650,53260
2019-05-17,135.6 ( -0.59 %),664,612740,922.8,1155,908890,787,-296150
2019-05-16,136.4 ( 0.59 %),1148,1084880,945.02,1530,1402000,916,-317120
2019-05-15,135.6 ( 0.07 %),1352,539930,399.36,1530,934410,611,-394480
2019-05-14,135.5 ( 1.19 %),2050,1709810,834.05,2348,1748900,745,-39090
2019-05-13,133.9 ( 2.92 %),2211,1640440,741.94,1826,1317900,722,322540
2019-05-10,130.1 ( 1.48 %),645,653650,1013.41,663,522530,788,131120
2019-05-09,128.2 ( 0.16 %),798,579480,726.17,756,488100,646,91380
2019-05-08,128 ( -1.16 %),1150,800750,696.3,1230,984480,800,-183730
2019-05-07,129.5 ( 0.31 %),1115,976220,875.53,949,977710,1030,-1490
2019-05-06,129.1 ( -1.45 %),1217,666410,547.58,708,721340,1019,-54930
2019-05-03,131 ( 0.77 %),797,692410,868.77,895,991090,1107,-298680
2019-05-02,130 ( 0.15 %),1259,1003770,797.28,1449,1059350,731,-55580
2019-04-26,129.8 ( 0.23 %),1198,941400,785.81,1133,858560,758,82840
2019-04-25,129.5 ( 0 %),1477,822700,557.01,1033,763990,740,58710
2019-04-24,129.5 ( 1.97 %),1824,903460,495.32,1033,709350,687,194110
2019-04-23,127 ( -2.01 %),2663,1413630,530.84,1552,1708330,1101,-294700
2019-04-22,129.6 ( -2.56 %),4147,2159680,520.78,2039,2076090,1018,83590
2019-04-19,133 ( -1.63 %),1361,855820,628.82,1181,990590,839,-134770
2019-04-18,135.2 ( 0.15 %),997,920010,922.78,1044,1010700,968,-90690
2019-04-17,135 ( -0.74 %),1653,1169590,707.56,1890,1727860,914,-558270
2019-04-16,136 ( 0.22 %),0,0,0,0,0,0,0
2019-04-12,135.7 ( 0.07 %),1918,1080570,563.38,993,1032690,1040,47880
2019-04-11,135.6 ( 0.22 %),1256,735450,585.55,1042,712130,683,23320
2019-04-10,135.3 ( -0.07 %),1823,1451970,796.47,979,1577530,1611,-125560
2019-04-09,135.4 ( -1.31 %),2993,1861350,621.9,1837,1913560,1042,-52210
2019-04-08,137.2 ( 0.66 %),1065,1013810,951.93,997,989310,992,24500
2019-04-05,136.3 ( -1.23 %),2319,1535730,662.24,1401,1766110,1261,-230380
2019-04-04,138 ( -0.36 %),1200,869020,724.18,1323,1125650,851,-256630
2019-04-03,138.5 ( -0.36 %),1376,1333430,969.06,1528,1341150,878,-7720
2019-04-02,139 ( 0.29 %),1880,1965730,1045.6,2290,2238270,977,-272540
2019-04-01,138.6 ( 2.82 %),1748,1625380,929.85,1661,1461000,880,164380
2019-03-29,134.8 ( -0.3 %),2387,2408140,1008.86,1179,2223930,1886,184210
2019-03-28,135.2 ( -0.95 %),1619,1404760,867.67,883,1315070,1489,89690
2019-03-27,136.5 ( 0 %),1147,1097980,957.26,1350,1065850,790,32130
2019-03-26,136.5 ( 0 %),969,1248640,1288.59,1010,1340680,1327,-92040
2019-03-25,136.5 ( 0 %),1947,1046520,537.5,986,875250,888,171270
2019-03-22,136.5 ( 0.37 %),1559,963440,617.99,878,983940,1121,-20500
2019-03-21,136 ( -1.81 %),2285,1223150,535.3,1891,1857540,982,-634390
2019-03-20,138.5 ( 1.17 %),2809,1951290,694.66,1589,1884040,1186,67250
2019-03-19,136.9 ( -0.8 %),2093,1380880,659.76,1120,1739580,1553,-358700
2019-03-18,138 ( 0.73 %),1797,1282300,713.58,1952,1279140,655,3160
2019-03-15,137 ( -0.15 %),2354,2094080,889.58,1105,1689730,1529,404350
2019-03-14,137.2 ( -0.8 %),2466,1776980,720.59,1740,1328330,763,448650
2019-03-13,138.3 ( -0.5 %),1935,915780,473.27,1987,1261040,635,-345260
2019-03-12,139 ( 1.02 %),1578,1072350,679.56,1792,899860,502,172490
2019-03-11,137.6 ( 0.44 %),1608,787100,489.49,928,721080,777,66020
2019-03-08,137 ( -1.93 %),3307,1751840,529.74,1356,1939410,1430,-187570
2019-03-07,139.7 ( -0.92 %),1777,1098010,617.9,1178,1403920,1192,-305910
2019-03-06,141 ( -0.7 %),2693,1180240,438.26,1553,1370470,882,-190230
2019-03-05,142 ( -0.63 %),1138,873510,767.58,1125,976650,868,-103140
2019-03-04,142.9 ( 1.06 %),1296,1491670,1150.98,1262,1461400,1158,30270
2019-03-01,141.4 ( 0.21 %),1586,1370160,863.91,1183,1329420,1124,40740
2019-02-28,141.1 ( -4.47 %),1529,2038570,1333.27,1371,1726080,1259,312490
2019-02-27,147.7 ( 1.1 %),1216,921810,758.07,1288,1338190,1039,-416380
2019-02-26,146.1 ( -3.63 %),2446,1343950,549.45,2150,1855040,863,-511090
2019-02-25,151.6 ( 1.81 %),1649,1707410,1035.42,1771,2265420,1279,-558010
2019-02-22,148.9 ( 0.27 %),1204,1042910,866.2,1622,1642940,1013,-600030
2019-02-21,148.5 ( 3.85 %),1924,2820430,1465.92,2381,3048640,1280,-228210
2019-02-20,143 ( 0.28 %),1325,1190910,898.8,1217,1492160,1226,-301250
2019-02-19,142.6 ( 0.42 %),1828,2568080,1404.86,1606,2855320,1778,-287240
2019-02-18,142 ( 1.28 %),1708,1529930,895.74,1401,1586680,1133,-56750
2019-02-15,140.2 ( 0.57 %),1515,1431960,945.19,1387,1454580,1049,-22620
2019-02-14,139.4 ( 0.8 %),1059,1886720,1781.61,1695,2614690,1543,-727970
2019-02-13,138.3 ( 0.22 %),1463,1169050,799.08,1712,1390270,812,-221220
2019-02-12,138 ( 0.73 %),1924,1232080,640.37,1317,1525420,1158,-293340
2019-02-11,137 ( 1.48 %),1968,1741230,884.77,1703,1881960,1105,-140730
2019-02-01,135 ( 0 %),1349,1202300,891.25,723,1193740,1651,8560
2019-01-31,135 ( -0.37 %),1332,1461750,1097.41,948,1346940,1421,114810
2019-01-30,135.5 ( -0.73 %),645,494240,766.26,812,794540,978,-300300
2019-01-29,136.5 ( 0 %),853,492750,577.67,1030,838980,815,-346230
2019-01-28,136.5 ( 0.44 %),847,800900,945.57,1450,983540,678,-182640
2019-01-25,135.9 ( 0.3 %),1058,1073990,1015.11,2173,1509830,695,-435840
2019-01-24,135.5 ( 0.74 %),1246,1618990,1299.35,2146,1682660,784,-63670
2019-01-23,134.5 ( 0.37 %),1160,1515770,1306.7,1512,1703480,1127,-187710
2019-01-22,134 ( 0.15 %),682,708390,1038.7,1466,836810,571,-128420
2019-01-21,133.8 ( -0.15 %),713,537340,753.63,829,660010,796,-122670
2019-01-18,134 ( 1.36 %),985,997430,1012.62,1630,1196740,734,-199310
2019-01-17,132.2 ( -0.6 %),1352,799450,591.31,1562,1033640,662,-234190
2019-01-16,133 ( -1.41 %),997,843470,846.01,1664,1163550,699,-320080
2019-01-15,134.9 ( -0.07 %),909,979570,1077.63,1593,1273300,799,-293730
2019-01-14,135 ( 0.75 %),821,955350,1163.64,1672,1193350,714,-238000
2019-01-11,134 ( 1.75 %),1218,1375610,1129.4,2698,2152820,798,-777210
2019-01-10,131.7 ( -0.15 %),738,511600,693.22,1296,865380,668,-353780
2019-01-09,131.9 ( 1.46 %),1191,1088300,913.77,1807,1389500,769,-301200
2019-01-08,130 ( -0.76 %),1147,682930,595.41,1313,981220,747,-298290
2019-01-07,131 ( 4.8 %),1475,1890670,1281.81,2124,1485420,699,405250
2019-01-04,125 ( 1.71 %),1251,960170,767.52,831,786020,946,174150
2019-01-03,122.9 ( -0.89 %),984,722530,734.28,712,960720,1349,-238190
2019-01-02,124 ( 3.33 %),1130,720200,637.35,811,684770,844,35430
2018-12-28,120 ( -2.6 %),823,1192320,1448.75,820,2168680,2645,-976360
2018-12-27,123.2 ( 0.17 %),959,1029460,1073.47,765,1101480,1440,-72020
2018-12-26,124 ( -0.48 %),939,1083820,1154.23,735,927470,1262,156350
2018-12-25,124.6 ( -0.8 %),853,617370,723.76,705,595980,845,21390
2018-12-24,125.6 ( 2.53 %),1455,1079800,742.13,1068,683640,640,396160
2018-12-21,122.5 ( -2.93 %),2617,3150580,1203.89,1091,2764410,2534,386170
2018-12-20,126.2 ( -2.25 %),1233,817370,662.91,994,833020,838,-15650
2018-12-19,129.1 ( -1.97 %),1194,663380,555.59,1081,1063590,984,-400210
2018-12-18,131.7 ( -1.64 %),1349,1186550,879.58,1096,1317000,1202,-130450
2018-12-17,133.9 ( -0.81 %),994,1298390,1306.23,1279,1503560,1176,-205170
2018-12-14,135 ( 0 %),489,423970,867.01,1059,613390,579,-189420
2018-12-13,135 ( 0.75 %),708,920650,1300.35,1443,1373730,952,-453080
2018-12-12,134 ( -0.59 %),1112,1154780,1038.47,1210,1294530,1070,-139750
2018-12-11,134.8 ( -0.15 %),911,693110,760.82,1579,1055870,669,-362760
2018-12-10,135 ( 0.82 %),1095,1927260,1760.05,2502,1923060,769,4200
2018-12-07,133.9 ( 1.67 %),1217,885810,727.86,1603,1109710,692,-223900
2018-12-06,131.7 ( -0.98 %),2247,2004730,892.18,1818,1876520,1032,128210
2018-12-05,133 ( -2.56 %),1974,1578140,799.46,2108,2327350,1104,-749210
2018-12-04,136.5 ( 2.17 %),2329,1907340,818.95,2769,1648980,596,258360
2018-12-03,133.6 ( 4.37 %),1660,2482750,1495.63,2750,1917430,697,565320
2018-11-30,128 ( 1.35 %),1690,2627390,1554.67,2274,2416730,1063,210660
2018-11-29,126.3 ( -1.33 %),1621,1629160,1005.03,2349,2025030,862,-395870
2018-11-28,128 ( 1.19 %),2821,2337690,828.67,3001,2393940,798,-56250
2018-11-27,126.5 ( 2.76 %),2654,3187260,1200.93,3750,2874260,766,313000
2018-11-26,123.1 ( 4.32 %),2271,2908320,1280.63,3217,2441280,759,467040
2018-11-23,118 ( -1.75 %),958,752880,785.89,1089,882830,811,-129950
2018-11-22,120.1 ( 0.76 %),1142,1468820,1286.18,2197,1587740,723,-118920
2018-11-21,119.2 ( 2.32 %),1664,1733280,1041.63,1738,1544680,889,188600
2018-11-20,116.5 ( 0.95 %),1304,1043220,800.02,933,1034330,1109,8890
2018-11-19,115.4 ( 0.35 %),1732,1186960,685.31,1000,1080780,1081,106180
2018-11-16,115 ( -1.71 %),1110,897480,808.54,1014,950860,938,-53380
2018-11-15,117 ( -0.43 %),1279,816250,638.19,1290,1099800,853,-283550
2018-11-14,117.5 ( 1.29 %),1171,988040,843.76,1725,1195690,693,-207650
2018-11-13,116 ( -0.85 %),1506,831880,552.38,988,879580,890,-47700
2018-11-12,117 ( 0 %),1719,955770,556,990,1077290,1088,-121520
2018-11-09,117 ( -2.5 %),1714,1076450,628.03,1226,1411070,1151,-334620
2018-11-08,120 ( 0.42 %),1244,1211680,974.02,1594,1519010,953,-307330
2018-11-07,119.5 ( 1.53 %),1867,1981140,1061.14,2527,2290830,907,-309690
2018-11-06,117.7 ( 1.03 %),1984,2605320,1313.17,2189,2398860,1096,206460
2018-11-05,116.5 ( -1.69 %),2280,1664030,729.84,1505,1351680,898,312350
2018-11-02,118.5 ( 3.67 %),2567,2947210,1148.11,2361,2041050,864,906160
2018-11-01,114.3 ( -1.55 %),3394,2216140,652.96,1760,2661880,1512,-445740
2018-10-31,116.1 ( -1.02 %),3503,1902000,542.96,1344,1848680,1376,53320
2018-10-30,117.3 ( -2.25 %),936,537710,574.48,736,553300,752,-15590
2018-10-29,120 ( -1.23 %),1146,753630,657.62,776,744050,959,9580
2018-10-26,121.5 ( 1.25 %),1095,1111380,1014.96,1195,906410,759,204970
2018-10-25,120 ( -2.12 %),2327,1870220,803.7,1343,1608830,1198,261390
2018-10-24,122.6 ( -0.73 %),1146,1017640,887.99,1135,1303710,1149,-286070
2018-10-23,123.5 ( -1.83 %),2426,1683200,693.82,1262,1889010,1497,-205810
2018-10-22,125.8 ( -0.79 %),789,514060,651.53,974,640230,657,-126170
2018-10-19,126.8 ( 0.63 %),1556,1759460,1130.76,1311,1718450,1311,41010
2018-10-18,126 ( -0.71 %),996,564330,566.6,1018,644190,633,-79860
2018-10-17,126.9 ( 0.71 %),1060,739980,698.09,999,755130,756,-15150
2018-10-16,126 ( 0.24 %),1516,1735810,1144.99,818,1271520,1554,464290
2018-10-15,125.7 ( -2.18 %),1707,1125290,659.22,914,1255890,1374,-130600
2018-10-12,128.5 ( 1.18 %),2804,1759350,627.44,1631,1547640,949,211710
2018-10-11,127 ( -2.31 %),3665,2353520,642.16,1672,1814100,1085,539420
2018-10-10,130 ( -0.69 %),1768,1040920,588.76,1006,907410,902,133510
2018-10-09,130.9 ( -1.58 %),2136,992240,464.53,1222,1059470,867,-67230
2018-10-08,133 ( -1.63 %),1897,867360,457.23,1423,1061880,746,-194520
2018-10-05,135.2 ( -1.24 %),1707,823020,482.14,1555,1022810,658,-199790
2018-10-04,136.9 ( 0 %),1081,535990,495.83,850,748660,881,-212670
2018-10-03,136.9 ( -0.07 %),887,999950,1127.34,1814,1100050,606,-100100
2018-10-02,137 ( 0.51 %),1537,1218720,792.92,1203,1220230,1014,-1510
2018-10-01,136.3 ( -0.73 %),1522,935410,614.59,785,796160,1014,139250
2018-09-28,137.3 ( -0.87 %),1220,708110,580.42,1013,1017390,1004,-309280
2018-09-27,138.5 ( 1.47 %),1338,1500690,1121.59,2471,1893100,766,-392410
2018-09-26,136.5 ( -0.29 %),1242,686140,552.45,1083,784730,725,-98590
2018-09-25,136.9 ( -0.07 %),1118,823910,736.95,994,940740,946,-116830
2018-09-24,137 ( -0.58 %),1264,1154570,913.43,1310,1050850,802,103720
2018-09-20,136 ( -1.31 %),1637,1111770,679.15,1562,1290730,826,-178960
2018-09-19,137.8 ( -0.14 %),1476,1283530,869.6,1887,1770900,938,-487370
2018-09-18,138 ( 1.47 %),1815,2013740,1109.5,2790,2425100,869,-411360
2018-09-17,136 ( 2.26 %),1706,1791590,1050.17,2962,1855640,626,-64050
2018-09-14,133 ( 0.68 %),1462,1759460,1203.46,1977,1752850,887,6610
2018-09-13,132.1 ( -0.23 %),1407,1085650,771.61,1577,1158660,735,-73010
2018-09-12,132.4 ( 0.3 %),2048,1766930,862.76,3212,2316970,721,-550040
2018-09-11,132 ( 3.45 %),2359,2409870,1021.56,2978,2216050,744,193820
2018-09-10,127.6 ( 0.39 %),1805,941100,521.39,1195,1101530,922,-160430
2018-09-07,127.1 ( 4.1 %),2590,1817750,701.83,1755,1246890,710,570860
2018-09-06,122.1 ( -2.71 %),3242,1884200,581.18,1301,2046220,1573,-162020
2018-09-05,125.5 ( -2.65 %),4175,1770930,424.17,1385,2193400,1584,-422470
2018-09-04,156.7 ( 0 %),1900,1109380,583.88,1101,1306560,1187,-197180
2018-08-31,156.7 ( 0.13 %),2395,1440730,601.56,1019,1104910,1084,335820
2018-08-30,156.5 ( -0.7 %),3247,1955830,602.35,979,1243560,1270,712270
2018-08-29,157.6 ( -1.07 %),2900,1650490,569.13,1120,1700770,1519,-50280
2018-08-28,159.3 ( -0.62 %),2171,1731230,797.43,1077,1534900,1425,196330
2018-08-27,0 ( 0 %),2203,1658630,752.9,1461,1875360,1284,-216730
2018-08-24,162.2 ( -0.67 %),1023,699430,683.7,1052,829010,788,-129580
2018-08-23,163.3 ( 0.18 %),988,690410,698.8,1202,831610,692,-141200
2018-08-22,163 ( 0 %),1735,1029690,593.48,1392,1199990,862,-170300
2018-08-21,163 ( 1.81 %),1747,1347160,771.13,1623,1124120,693,223040
2018-08-20,160.1 ( 1.01 %),2086,2064710,989.79,2275,1842120,810,222590
2018-08-17,158.5 ( -0.06 %),1282,642750,501.37,1149,789900,687,-147150
2018-08-16,158.6 ( 0.06 %),2670,1626240,609.08,1100,1507800,1371,118440
2018-08-15,158.5 ( 0.25 %),2177,1634960,751.02,2050,1670540,815,-35580
2018-08-14,158.1 ( 1.28 %),2779,1627320,585.58,1838,1711750,931,-84430
2018-08-13,156.1 ( -0.7 %),2820,2055050,728.74,1580,1776260,1124,278790
2018-08-10,157.2 ( 0.13 %),1397,1519870,1087.95,1511,1208100,800,311770
2018-08-09,157 ( 0.96 %),2147,1481260,689.92,1385,1409810,1018,71450
2018-08-08,155.5 ( 1.63 %),3673,2367700,644.62,1667,1903800,1142,463900
2018-08-07,153 ( -4.32 %),7070,3249820,459.66,2125,3761100,1770,-511280
2018-08-06,159.9 ( -1.05 %),2713,1643810,605.9,1421,1954870,1376,-311060
2018-08-03,161.6 ( -2.06 %),3999,2198120,549.67,1350,2146180,1590,51940
2018-08-02,165 ( -1.14 %),4542,2704600,595.46,2173,2406230,1107,298370
2018-08-01,166.9 ( -0.77 %),1700,1049230,617.19,665,1019560,1533,29670
2018-07-31,168.2 ( -0.18 %),1820,1095720,602.04,742,1172200,1580,-76480
2018-07-30,168.5 ( -0.18 %),1085,736020,678.36,642,880660,1372,-144640
2018-07-27,168.8 ( -1.57 %),956,435570,455.62,671,800000,1192,-364430
2018-07-26,171.5 ( 0.94 %),936,723120,772.56,985,807210,820,-84090
2018-07-25,169.9 ( 0 %),651,520250,799.16,1013,755390,746,-235140
2018-07-24,169.9 ( -0.06 %),888,943940,1063,1224,950120,776,-6180
2018-07-23,170 ( 0.29 %),1206,1156780,959.19,1503,1183580,787,-26800
2018-07-20,169.5 ( -0.59 %),902,1378740,1528.54,743,1010190,1360,368550
2018-07-19,170.5 ( 0.89 %),1366,1452470,1063.3,1351,1627480,1205,-175010
2018-07-18,169 ( 0.66 %),1025,758340,739.84,719,738440,1027,19900
2018-07-17,167.9 ( -0.06 %),916,936050,1021.89,515,801980,1557,134070
2018-07-16,168 ( 1.02 %),950,909390,957.25,764,875360,1146,34030
2018-07-13,166.3 ( -1.19 %),1159,707650,610.57,601,703470,1170,4180
2018-07-12,168.3 ( 0.78 %),422,351610,833.2,745,395910,531,-44300
2018-07-11,167 ( 0 %),796,1180070,1482.5,839,1131770,1349,48300
2018-07-10,167 ( 0 %),712,1278260,1795.31,766,920780,1202,357480
2018-07-09,167 ( 0.6 %),697,549970,789.05,479,567900,1186,-17930
2018-07-06,166 ( 0.61 %),840,858220,1021.69,697,632390,907,225830
2018-07-05,165 ( -1.2 %),1386,1506350,1086.83,897,1207720,1346,298630
2018-07-04,167 ( -1.76 %),1121,1154430,1029.82,618,1356140,2194,-201710
2018-07-03,170 ( -0.58 %),920,1342880,1459.65,968,1325350,1369,17530
2018-07-02,171 ( 0.59 %),1086,1526210,1405.35,1186,1268580,1070,257630
2018-06-29,170 ( 0 %),1203,1845610,1534.17,929,1540460,1658,305150
2018-06-28,170 ( -2.86 %),1868,1035270,554.21,905,1156660,1278,-121390
2018-06-27,175 ( -0.51 %),692,616530,890.94,456,487970,1070,128560
2018-06-26,175.9 ( -1.84 %),904,564660,624.62,820,620850,757,-56190
2018-06-25,179.2 ( 0.67 %),1069,821460,768.44,1501,1549300,1032,-727840
2018-06-22,178 ( 4.71 %),1321,1888700,1429.75,1982,1678500,847,210200
2018-06-21,170 ( 0.71 %),1101,827030,751.16,675,583970,865,243060
2018-06-20,168.8 ( 1.5 %),1661,1296200,780.37,686,769500,1122,526700
2018-06-19,166.3 ( -3.71 %),1856,1665720,897.48,1023,1696990,1659,-31270
2018-06-18,172.7 ( -4.06 %),962,550930,572.69,718,690160,961,-139230
2018-06-14,180 ( -0.55 %),1019,1092750,1072.37,852,1170010,1373,-77260
2018-06-13,181 ( 0 %),622,717460,1153.47,817,891670,1091,-174210
2018-06-12,181 ( 0.5 %),1066,1418010,1330.22,1873,1435690,767,-17680
2018-06-11,180.1 ( 1.75 %),1372,1239620,903.51,1719,1305270,759,-65650
2018-06-08,177 ( -0.17 %),1231,787980,640.11,841,825050,981,-37070
2018-06-07,177.3 ( 1.31 %),1058,743820,703.04,1189,790200,665,-46380
2018-06-06,175 ( -1.13 %),1541,728140,472.51,1027,877430,854,-149290
2018-06-05,177 ( 2.02 %),1688,1544480,914.98,2025,2020470,998,-475990
2018-06-04,175 ( 4.04 %),1633,1560500,955.6,1527,1406140,921,154360
2018-06-01,0 ( 0 %),1648,1668400,1012.38,1524,1652440,1084,15960
2018-05-31,164.2 ( -0.79 %),1953,3325760,1702.9,919,2755480,2998,570280
2018-05-30,165.5 ( -1.84 %),1089,835810,767.5,1060,911760,860,-75950
2018-05-29,168.6 ( 2.18 %),1644,1223140,744,1048,1322840,1262,-99700
2018-05-28,165 ( -0.6 %),1035,878450,848.74,1183,789680,668,88770
2018-05-25,166 ( -1.19 %),1015,791700,780,944,924070,979,-132370
2018-05-24,168 ( 0.42 %),1212,1174430,969,1162,1386520,1193,-212090
2018-05-23,167.3 ( 3.27 %),1692,2094300,1237.77,1792,1439970,804,654330
2018-05-22,162 ( -2.41 %),2084,1785510,856.77,1617,1683990,1041,101520
2018-05-21,166 ( -2.98 %),2487,1461490,587.65,1644,1634230,994,-172740
2018-05-18,171.1 ( 3.7 %),2229,1832030,821.91,1755,1423270,811,408760
2018-05-17,165 ( -2.42 %),2499,1365340,546.35,1424,1472220,1034,-106880
2018-05-15,176 ( -1.12 %),3183,1592060,500.18,1877,1911090,1018,-319030
2018-05-11,178 ( -1.11 %),1896,1343100,708.39,1049,1478160,1409,-135060
2018-05-10,180 ( -2.7 %),1212,590640,487.33,615,998450,1623,-407810
2018-05-09,185 ( -0.05 %),1263,757630,599.87,689,1915070,2779,-1157440
2018-05-08,185.1 ( -2.58 %),1061,839420,791.16,904,1118430,1237,-279010
2018-05-07,190 ( 3.26 %),1116,1293710,1159.24,1080,1108630,1027,185080
2018-05-04,184 ( -0.54 %),1088,937220,861.42,675,932900,1382,4320
2018-05-03,0 ( 0 %),1217,1060240,871.19,1189,1359680,1144,-299440
2018-05-02,0 ( 0 %),846,1018400,1203.78,850,1000360,1177,18040
2018-04-27,185 ( 2.21 %),1224,2161340,1765.8,1045,1256160,1202,905180
2018-04-26,181 ( 0.56 %),1131,1668340,1475.1,1374,1298320,945,370020
2018-04-24,180 ( -1.32 %),2107,2094190,993.92,1735,1973680,1138,120510
2018-04-23,182.4 ( -1.94 %),1336,974430,729.36,994,1061480,1068,-87050
2018-04-20,186 ( -0.8 %),1140,1071780,940.16,1061,1047620,987,24160
2018-04-19,187.5 ( 0 %),1016,1142910,1124.91,1251,1073950,858,68960
2018-04-18,187.5 ( 1.63 %),1892,1350110,713.59,1459,955650,655,394460
2018-04-17,184.5 ( -2.89 %),4285,2308090,538.64,2172,2060600,949,247490
2018-04-16,190 ( -2.91 %),2255,982830,435.84,1557,1098000,705,-115170
2018-04-13,195.7 ( -0.31 %),977,885100,905.94,1038,1237240,1192,-352140
2018-04-12,196.3 ( 0.15 %),1312,1083770,826.04,1233,1068890,867,14880
2018-04-11,196 ( -0.51 %),1519,1292330,850.78,1345,1286520,957,5810
2018-04-10,197 ( -0.4 %),2296,1642780,715.5,1700,1617050,951,25730
2018-04-09,197.8 ( -0.2 %),1313,1045710,796.43,1727,1312400,760,-266690
2018-04-06,198.2 ( 0.46 %),1438,1016020,706.55,1829,1291620,706,-275600
2018-04-05,197.3 ( -1.35 %),2201,868980,394.81,1339,1137300,849,-268320
2018-04-04,200 ( 3.25 %),3238,1870380,577.63,1519,1515360,998,355020
2018-04-03,193.7 ( -3 %),6074,2982220,490.98,1781,3147520,1767,-165300
2018-04-02,199.7 ( -1.63 %),5272,3323490,630.4,1702,2390280,1404,933210
2018-03-30,203 ( -1.93 %),5720,2455580,429.3,1454,2358600,1622,96980
2018-03-29,207 ( -1.9 %),1976,1004760,508.48,780,1437040,1842,-432280
2018-03-28,211 ( -0.94 %),1338,821260,613.8,1143,1159800,1015,-338540
2018-03-27,213 ( 2.16 %),2282,2388240,1046.56,1939,2717480,1401,-329240
2018-03-26,208.5 ( 0.72 %),1161,1020280,878.79,841,1068610,1271,-48330
2018-03-23,207 ( -0.96 %),2227,1110030,498.44,851,991020,1165,119010
2018-03-22,209 ( 0 %),1366,691200,506,837,1080500,1291,-389300
2018-03-21,209 ( 0 %),1453,1273280,876.31,1173,1454610,1240,-181330
2018-03-20,209 ( -1.42 %),1506,1011110,671.39,848,1732710,2043,-721600
2018-03-19,212 ( -0.93 %),1637,1151340,703.32,1022,1416970,1386,-265630
2018-03-16,214 ( 1.81 %),983,2080970,2116.96,1317,3281290,2491,-1200320
2018-03-15,210.2 ( -1.31 %),1324,928950,701.62,1236,1239830,1003,-310880
2018-03-14,213 ( 1.43 %),1336,1615030,1208.85,1649,1824390,1106,-209360
2018-03-13,210 ( 1.94 %),1185,1635190,1379.91,1496,1883360,1259,-248170
2018-03-12,206 ( -0.96 %),1152,1209260,1049.7,1141,1772940,1554,-563680
2018-03-09,208 ( -0.48 %),1149,1352830,1177.4,1704,2023220,1187,-670390
2018-03-08,209 ( 1.41 %),854,836870,979.94,1432,1275520,891,-438650
2018-03-07,206.1 ( 2.03 %),1812,2685420,1482.02,3294,3369520,1023,-684100
2018-03-06,202 ( -0.2 %),1307,1060450,811.36,1231,1517590,1233,-457140
2018-03-05,202.4 ( 1.56 %),1064,1057300,993.7,1531,1609890,1052,-552590
2018-03-02,199.3 ( 1.68 %),795,863230,1085.82,814,1145360,1407,-282130
2018-03-01,196 ( 0 %),1269,1035990,816.38,849,1310930,1544,-274940
2018-02-28,196 ( -2 %),1807,1184620,655.57,800,1463710,1830,-279090
2018-02-27,200 ( 0 %),1147,720630,628.27,830,913770,1101,-193140
2018-02-26,200 ( -0.99 %),1099,1262860,1149.1,1263,1414820,1120,-151960
2018-02-23,202 ( 0.5 %),666,657970,987.94,1084,1034060,954,-376090
2018-02-22,201 ( -1.08 %),876,677490,773.39,1033,903770,875,-226280
2018-02-21,203.2 ( 5.01 %),1332,1073600,806.01,952,1155530,1214,-81930
2018-02-13,193.5 ( 0.78 %),1071,847990,791.77,472,707850,1500,140140
2018-02-12,192 ( 0.52 %),1520,1510560,993.79,485,1156930,2385,353630
2018-02-09,191 ( -3.09 %),2331,1350510,579.37,1102,1212290,1100,138220
2018-02-08,197.1 ( -1.6 %),1022,348730,341.22,587,679890,1158,-331160
2018-02-07,200.3 ( 1.21 %),1033,812720,786.76,947,1150620,1215,-337900
2018-02-06,197.9 ( -2.56 %),2183,2785250,1275.88,1314,2217750,1688,567500
2018-02-05,203.1 ( -1.88 %),1022,939090,918.87,920,840930,914,98160
2018-02-02,207 ( 1.97 %),1062,1212280,1141.51,840,1213730,1445,-1450
2018-02-01,203 ( -0.25 %),1083,697250,643.81,701,730390,1042,-33140
2018-01-31,203.5 ( -0.49 %),2232,1760680,788.84,1096,1771790,1617,-11110
2018-01-30,204.5 ( -0.97 %),1897,1189730,627.16,703,1251090,1780,-61360
2018-01-29,206.5 ( -2.5 %),1408,782060,555.44,995,1421030,1428,-638970
2018-01-26,211.8 ( 2.32 %),882,1040590,1179.81,1531,1342520,877,-301930
2018-01-25,207 ( -2.17 %),1907,1595200,836.5,1145,1817100,1587,-221900
2018-01-22,211.6 ( 2.92 %),1171,1619950,1383.39,1460,1510600,1035,109350
2018-01-19,205.6 ( 0 %),1346,1688390,1254.38,2076,1615180,778,73210
2018-01-18,205.6 ( 2.24 %),1696,1553750,916.13,1657,1199380,724,354370
2018-01-17,201.1 ( -3.46 %),2151,1188090,552.34,1583,1463130,924,-275040
2018-01-16,208.3 ( -0.1 %),1369,1017310,743.1,1170,981390,839,35920
2018-01-15,208.5 ( -0.67 %),1074,675520,628.98,1054,755840,717,-80320
2018-01-12,209.9 ( -0.05 %),844,717220,849.79,1496,970210,649,-252990
2018-01-11,210 ( -0.47 %),793,1041700,1313.62,1274,1181870,928,-140170
2018-01-10,211 ( 1.93 %),1473,1253600,851.05,952,1144140,1202,109460
2018-01-09,207 ( -1.43 %),2175,1172270,538.97,952,1197240,1258,-24970
2018-01-08,210 ( -1.64 %),1890,1124550,595,972,1082420,1114,42130
2018-01-05,213.5 ( -0.61 %),1208,869730,719.98,760,977220,1286,-107490
2018-01-04,214.8 ( 0.42 %),1052,1032240,981.22,948,1050570,1108,-18330
2018-01-03,213.9 ( 1.13 %),820,803060,979.34,742,1005470,1355,-202410
2018-01-02,211.5 ( 1.39 %),694,680240,980.17,660,959790,1454,-279550
2017-12-29,208.6 ( 1.66 %),1187,1493150,1257.92,1697,1963350,1157,-470200
2017-12-28,205.2 ( 0.83 %),814,821010,1008.61,955,967780,1013,-146770
2017-12-27,205 ( 1.03 %),872,934910,1072.14,1054,1543950,1465,-609040
2017-12-26,202.9 ( 1.45 %),807,766600,949.94,584,913460,1564,-146860
2017-12-25,200 ( -1.43 %),1167,618600,530.08,595,767770,1290,-149170
2017-12-22,202.9 ( -0.49 %),812,618980,762.29,759,789330,1040,-170350
2017-12-21,203.9 ( 0.94 %),841,867940,1032.03,847,985830,1164,-117890
2017-12-20,202 ( -0.49 %),1189,952580,801.16,1158,1572620,1358,-620040
2017-12-19,203 ( -0.98 %),1176,1303170,1108.14,1879,1765160,939,-461990
2017-12-18,205 ( 4.06 %),1328,1616180,1217,1959,2148780,1097,-532600
2017-12-15,197 ( -1.99 %),1778,2985680,1679.24,1737,2771210,1595,214470
2017-12-14,201 ( 3.18 %),1090,1250360,1147.12,1829,1107600,606,142760
2017-12-13,194.8 ( 0.15 %),1022,1180170,1154.77,1427,1046650,733,133520
2017-12-12,194.5 ( 1.83 %),1005,1105570,1100.07,1494,1288640,863,-183070
2017-12-11,191 ( 1.54 %),1067,1754980,1644.78,1238,1142820,923,612160
2017-12-08,188.1 ( 1.13 %),1773,1660230,936.4,1159,1421860,1227,238370
2017-12-07,186 ( -4.62 %),2853,2098470,735.53,1368,2212860,1618,-114390
2017-12-06,195 ( -2.01 %),2734,1824940,667.5,1681,1837130,1093,-12190
2017-12-05,199 ( -1.97 %),1523,1144960,751.78,1272,1517920,1193,-372960
2017-12-04,203 ( 3.57 %),1870,2302690,1231.39,1864,2698670,1448,-395980
2017-12-01,196 ( 4.98 %),1259,2016370,1601.56,2423,1992770,822,23600
2017-11-30,186.7 ( 0.92 %),1013,1522600,1503.06,1324,1571860,1187,-49260
2017-11-29,185 ( 0 %),671,801290,1194.17,821,767760,935,33530
2017-11-28,185 ( 0 %),806,809820,1004.74,831,759250,914,50570
2017-11-27,185 ( 0 %),835,1251150,1498.38,1079,1203860,1116,47290
2017-11-24,185 ( 0.05 %),1087,1557780,1433.1,910,1044290,1148,513490
2017-11-23,184.9 ( 0 %),1269,1359710,1071.48,1362,1173920,862,185790
2017-11-22,184.9 ( -2.17 %),3188,2816810,883.57,2050,2891420,1410,-74610
2017-11-21,189 ( 1.07 %),1470,1539480,1047.27,2122,2407470,1135,-867990
2017-11-20,187 ( 2.07 %),1190,1725530,1450.03,1776,1767870,995,-42340
2017-11-17,183.2 ( 0 %),567,1090160,1922.68,1346,1880070,1397,-789910
2017-11-16,183.2 ( 0.77 %),802,1200670,1497.09,1609,1751650,1089,-550980
2017-11-15,181.8 ( 1 %),1258,2334110,1855.41,2642,2242970,849,91140
2017-11-14,180 ( -2.44 %),1406,2167510,1541.61,3246,2652150,817,-484640
2017-11-13,184.5 ( 6.16 %),2215,6012770,2714.57,4397,6818740,1551,-805970
2017-11-10,173.8 ( 6.95 %),2129,12132520,5698.69,6335,10576250,1669,1556270
2017-11-09,162.5 ( 1.44 %),1675,2909280,1736.88,2559,3556670,1390,-647390
2017-11-08,160.2 ( 1.52 %),1064,3696380,3474.04,2648,3444700,1301,251680
2017-11-06,158 ( 1.8 %),1038,1602180,1543.53,1583,1681170,1062,-78990
2017-11-03,155.2 ( -0.45 %),952,723210,759.67,1206,1252170,1038,-528960
2017-11-02,155.9 ( 0.58 %),1517,1509450,995.02,2443,2542790,1041,-1033340
2017-11-01,155 ( 2.65 %),1360,2102680,1546.09,1862,2167560,1164,-64880
2017-10-31,151 ( -0.59 %),777,1186810,1527.43,899,1336100,1486,-149290
2017-10-30,0 ( 0 %),761,823410,1082.01,1100,1061080,965,-237670
2017-10-27,152.4 ( 0.4 %),862,1105800,1282.83,1414,1295620,916,-189820
2017-10-26,151.8 ( 0.86 %),983,1348850,1372.18,1772,1669570,942,-320720
2017-10-25,150.5 ( 1.01 %),781,1134740,1452.93,1284,1268210,988,-133470
2017-10-24,149 ( 0.68 %),820,957270,1167.4,696,1024560,1472,-67290
2017-10-23,148 ( -0.34 %),748,2549290,3408.14,681,1154820,1696,1394470
2017-10-20,148.5 ( -0.2 %),550,427310,776.93,441,501700,1138,-74390
2017-10-19,148.8 ( -0.13 %),688,636270,924.81,448,846800,1890,-210530
2017-10-18,149 ( -0.07 %),645,604730,937.57,718,944280,1315,-339550
2017-10-17,149.1 ( 0.34 %),668,606440,907.84,621,827160,1332,-220720
2017-10-16,148.6 ( -0.54 %),706,842440,1193.26,1017,1508730,1484,-666290
2017-10-13,149.4 ( 0.95 %),615,721290,1172.83,888,1048780,1181,-327490
2017-10-12,148 ( -0.34 %),794,607040,764.53,559,833820,1492,-226780
2017-10-11,148.5 ( 0 %),805,1049480,1303.7,727,1105150,1520,-55670
2017-10-10,148.5 ( -0.27 %),703,852630,1212.84,519,854240,1646,-1610
2017-10-09,148.9 ( -0.07 %),396,291330,735.68,577,619170,1073,-327840
2017-10-06,149 ( 0 %),693,1414760,2041.5,1364,1869530,1371,-454770
2017-10-05,149 ( 0.34 %),569,694810,1221.11,784,989890,1263,-295080
2017-10-04,148.5 ( 0.41 %),605,513940,849.49,459,640480,1395,-126540
2017-10-03,147.9 ( -0.4 %),965,846630,877.34,578,1068820,1849,-222190
2017-10-02,148.5 ( -0.47 %),493,441630,895.8,672,747060,1112,-305430
2017-09-29,149.2 ( 0.13 %),996,1322420,1327.73,1437,1798960,1252,-476540
2017-09-28,149 ( 0.68 %),558,795250,1425.18,811,698490,861,96760
2017-09-27,148 ( -0.07 %),609,539490,885.86,487,663430,1362,-123940
2017-09-26,148.1 ( 0.07 %),573,561670,980.23,631,779880,1236,-218210
2017-09-25,148 ( 0.2 %),865,535120,618.64,475,493990,1040,41130
2017-09-22,147.7 ( -0.2 %),688,456450,663.44,529,718430,1358,-261980
2017-09-21,148 ( -0.6 %),961,994590,1034.95,562,1066940,1898,-72350
2017-09-20,148.9 ( 0.34 %),719,723030,1005.61,634,702510,1108,20520
2017-09-19,148.4 ( -0.4 %),668,556700,833.38,631,653290,1035,-96590
2017-09-18,149 ( 0.68 %),975,1009510,1035.39,954,871910,914,137600
2017-09-15,148 ( -0.2 %),1206,2053780,1702.97,938,2372560,2529,-318780
2017-09-14,148.3 ( 0.07 %),955,1186530,1242.44,695,1080990,1555,105540
2017-09-13,148.2 ( 0.07 %),1066,1281380,1202.05,808,1671290,2068,-389910
2017-09-12,148.1 ( -0.2 %),1089,1110500,1019.74,910,868740,955,241760
2017-09-11,148.4 ( -0.47 %),964,921350,955.76,623,909420,1460,11930
2017-09-08,149.1 ( -0.27 %),848,613060,722.95,322,515870,1602,97190
2017-09-07,149.5 ( -0.99 %),941,664400,706.06,588,754650,1283,-90250
2017-09-06,151 ( -1.05 %),818,433210,529.6,766,646130,844,-212920
2017-09-05,152.6 ( 0.73 %),688,1227850,1784.67,1151,1400990,1217,-173140
2017-09-01,151.5 ( 2.09 %),636,1024420,1610.72,1261,947250,751,77170
2017-08-31,148.4 ( 0.27 %),752,1062860,1413.38,746,1018860,1366,44000
2017-08-30,148 ( 0.34 %),562,746010,1327.42,502,759210,1512,-13200
2017-08-29,147.5 ( -0.54 %),1054,1338660,1270.08,530,962610,1816,376050
2017-08-28,148.3 ( -0.13 %),646,528100,817.49,373,501090,1343,27010
2017-08-25,148.5 ( 0.13 %),493,396580,804.42,463,374210,808,22370
2017-08-24,148.3 ( -0.13 %),522,386620,740.65,339,402380,1187,-15760
2017-08-23,148.5 ( 0 %),677,618870,914.14,560,580090,1036,38780
2017-08-22,148.5 ( -0.27 %),505,559520,1107.96,586,610350,1042,-50830
2017-08-21,148.9 ( -0.2 %),437,354140,810.39,569,483930,850,-129790
2017-08-18,149.2 ( 0.27 %),610,615670,1009.3,730,642810,881,-27140
2017-08-17,148.8 ( 0.88 %),1030,1359400,1319.81,895,1144030,1278,215370
2017-08-16,147.5 ( -0.67 %),1565,1002330,640.47,610,934690,1532,67640
2017-08-15,148.5 ( -0.8 %),837,697570,833.42,513,924760,1803,-227190
2017-08-14,149.7 ( 0.13 %),1242,1235270,994.58,802,1312120,1636,-76850
2017-08-11,151.5 ( 0 %),778,1082450,1391.32,821,1045320,1273,37130
2017-08-10,151.5 ( 1 %),729,700410,960.78,618,644200,1042,56210
2017-08-09,150 ( -1.32 %),2309,1743240,754.98,1009,1689930,1675,53310
2017-08-08,152 ( -1.11 %),1354,1539610,1137.08,1002,1556300,1553,-16690
2017-08-07,153.7 ( -0.19 %),731,683570,935.12,707,656520,929,27050
2017-08-04,154 ( 0 %),362,368960,1019.23,791,547570,692,-178610
2017-08-03,154 ( 1.05 %),708,1084430,1531.68,1144,1095110,957,-10680
2017-08-02,152.4 ( 0.86 %),940,1376270,1464.12,714,1666700,2334,-290430
2017-08-01,151.1 ( -0.98 %),809,1139310,1408.29,722,1046380,1449,92930
2017-07-31,152.6 ( -0.26 %),686,923970,1346.9,611,984820,1612,-60850
2017-07-28,153 ( 0.07 %),720,486160,675.22,582,613070,1053,-126910
2017-07-27,152.9 ( -0.07 %),542,389900,719.37,636,493460,776,-103560
2017-07-26,153 ( 0.79 %),3,30000,10000,3,30000,10000,0
2017-07-25,151.8 ( 0 %),630,363690,577.29,592,345180,583,18510
2017-07-24,151.8 ( 0.2 %),994,1174430,1181.52,1135,933130,822,241300
2017-07-21,151.5 ( -0.33 %),1047,859810,821.21,765,729890,954,129920
2017-07-20,152 ( -0.65 %),1038,1022580,985.14,1106,1060300,959,-37720
2017-07-19,153 ( 0.66 %),724,625250,863.6,567,623820,1100,1430
2017-07-18,152 ( 0.07 %),1149,1140820,992.88,644,855920,1329,284900
2017-07-17,151.9 ( -2.06 %),1645,868880,528.19,597,938020,1571,-69140
2017-07-14,155.1 ( -0.77 %),968,923440,953.97,1072,1191060,1111,-267620
2017-07-13,156.3 ( 0.58 %),420,791670,1884.93,1003,1035120,1032,-243450
2017-07-12,155.4 ( 1.57 %),720,946520,1314.61,819,895870,1094,50650
2017-07-11,153 ( 0.86 %),966,905160,937.02,526,805840,1532,99320
2017-07-10,151.7 ( -1.62 %),1932,1563390,809.21,837,1447500,1729,115890
2017-07-07,154.2 ( -2.1 %),1708,1282480,750.87,691,1565610,2266,-283130
2017-07-06,157.5 ( 0.57 %),779,866600,1112.45,788,1193380,1514,-326780
2017-07-05,156.6 ( 0.06 %),960,864840,900.88,457,619890,1356,244950
2017-07-04,156.5 ( -0.32 %),873,488340,559.38,507,659990,1302,-171650
2017-07-03,157 ( -0.38 %),832,800690,962.37,753,993310,1319,-192620
2017-06-30,157.6 ( 1.81 %),1288,2467930,1916.09,1667,2046940,1228,420990
2017-06-29,154.8 ( -0.39 %),695,468240,673.73,916,996960,1088,-528720
2017-06-28,155.4 ( 1.24 %),925,1369790,1480.85,1517,1468090,968,-98300
2017-06-27,153.5 ( 0.07 %),859,747820,870.57,646,914260,1415,-166440
2017-06-26,153.4 ( 0.26 %),795,480940,604.96,632,665030,1052,-184090
2017-06-23,153 ( 0.07 %),603,507240,841.19,515,600890,1167,-93650
2017-06-22,152.9 ( -0.59 %),619,448330,724.28,566,751840,1328,-303510
2017-06-21,153.8 ( 0.52 %),1407,1246260,885.76,691,1331000,1926,-84740
2017-06-20,153 ( -0.91 %),1184,1127610,952.37,928,1477600,1592,-349990
2017-06-19,154.4 ( 0.92 %),956,1174850,1228.92,991,1119820,1130,55030
2017-06-16,153 ( -0.52 %),1201,3070740,2556.82,917,1984150,2164,1086590
2017-06-15,153.8 ( 0.2 %),660,591510,896.23,687,836520,1218,-245010
2017-06-14,153.5 ( 0.79 %),847,854460,1008.81,711,930110,1308,-75650
2017-06-13,152.3 ( -0.26 %),1027,930660,906.19,470,947530,2016,-16870
2017-06-12,152.7 ( -0.65 %),697,725440,1040.8,646,935360,1448,-209920
2017-06-09,153.7 ( 0.07 %),646,524410,811.78,560,634170,1132,-109760
2017-06-08,153.6 ( -0.26 %),551,390950,709.53,502,545420,1086,-154470
2017-06-07,154 ( -0.13 %),1004,1078080,1073.78,756,1206960,1597,-128880
2017-06-06,154.2 ( 0.33 %),527,416280,789.91,768,874720,1139,-458440
2017-06-05,153.7 ( 1.86 %),1021,1500930,1470.06,1773,1658660,936,-157730
2017-06-02,150.9 ( -0.66 %),976,1058200,1084.22,689,816300,1185,241900
2017-06-01,151.9 ( 1.47 %),788,1004380,1274.59,940,1067880,1136,-63500
2017-05-30,149.7 ( -1.32 %),993,757990,763.33,626,848960,1356,-90970
2017-05-29,151.7 ( -0.2 %),528,573430,1086.04,733,756320,1032,-182890
2017-05-26,152 ( 1.33 %),906,881300,972.74,771,673760,874,207540
2017-05-25,150 ( -0.99 %),930,862270,927.17,892,1246610,1398,-384340
2017-05-24,151.5 ( 0 %),1009,1182140,1171.6,1221,1269580,1040,-87440
2017-05-23,151.5 ( 0.8 %),785,1179940,1503.11,1361,1429750,1051,-249810
2017-05-22,150.3 ( 1.62 %),1294,2092410,1617.01,1752,2052240,1171,40170
2017-05-19,147.9 ( 1.3 %),808,1341900,1660.77,1099,1450160,1320,-108260
2017-05-18,146 ( -0.68 %),715,1157030,1618.22,839,1064010,1268,93020
2017-05-17,147 ( 2.44 %),1073,2137870,1992.42,1528,1886060,1234,251810
2017-05-16,143.5 ( -0.28 %),862,755050,875.93,673,952910,1416,-197860
2017-05-15,143.9 ( -0.62 %),1276,1164750,912.81,880,1342770,1526,-178020
2017-05-12,144.8 ( 0.21 %),734,899050,1224.86,539,1079570,2003,-180520
2017-05-11,0 ( 0 %),689,795900,1155.15,444,973780,2193,-177880
2017-05-10,144.4 ( 0.28 %),956,1134970,1187.21,675,1207270,1789,-72300
2017-05-09,144 ( -1.3 %),1481,1322990,893.31,1037,2106260,2031,-783270
2017-05-08,145.9 ( -0.48 %),874,1078300,1233.75,1044,1348900,1292,-270600
2017-05-05,146.6 ( -1.28 %),747,761140,1018.93,921,1157970,1257,-396830
2017-05-04,148.5 ( 1.51 %),791,1416210,1790.4,1412,1781100,1261,-364890
2017-05-03,148.3 ( 0.2 %),794,1189670,1498.32,1356,1526450,1126,-336780
2017-04-28,148 ( 1.02 %),1025,2197290,2143.7,2013,2496410,1240,-299120
2017-04-27,146.5 ( 1.81 %),963,1854720,1925.98,1102,1714290,1556,140430
2017-04-26,143.9 ( 0.35 %),471,530310,1125.92,555,546540,985,-16230
2017-04-25,143.4 ( -0.42 %),595,691020,1161.38,600,937440,1562,-246420
2017-04-24,144 ( -0.48 %),744,872090,1172.16,799,1024010,1282,-151920
2017-04-21,144.7 ( -0.14 %),583,655650,1124.61,937,1173620,1253,-517970
2017-04-20,144.9 ( -0.34 %),643,659100,1025.04,1043,1169190,1121,-510090
2017-04-19,145.4 ( 0.69 %),1051,1444210,1374.13,1800,2148480,1194,-704270
2017-04-18,144.4 ( 1.69 %),1064,2625740,2467.8,1784,2830160,1586,-204420
2017-04-17,142 ( 0.21 %),1003,1383650,1379.51,848,1423310,1678,-39660
2017-04-14,141.7 ( -0.98 %),1316,924270,702.33,826,1122800,1359,-198530
2017-04-13,143.1 ( -0.63 %),627,520880,830.75,826,971420,1176,-450540
2017-04-12,144 ( 0.35 %),742,1001810,1350.15,1414,1788840,1265,-787030
2017-04-11,143.5 ( 0.63 %),706,772140,1093.68,917,929430,1014,-157290
2017-04-10,142.6 ( 0 %),873,921530,1055.59,740,1175330,1588,-253800
2017-04-07,142.6 ( -0.56 %),1313,1620570,1234.25,1052,1562000,1485,58570
2017-04-05,143.4 ( -0.42 %),801,1128200,1408.49,1084,1564890,1444,-436690
2017-04-04,144 ( -0.21 %),865,1448930,1675.06,1114,1855790,1666,-406860
2017-04-03,144.3 ( 0.7 %),937,1114160,1189.07,1291,1664330,1289,-550170
2017-03-31,143.3 ( -0.49 %),1132,1694570,1496.97,1884,3076460,1633,-1381890
2017-03-30,144 ( 1.55 %),1051,2099510,1997.63,1566,1761260,1125,338250
2017-03-29,141.8 ( 0.71 %),945,1301940,1377.71,1277,1423370,1115,-121430
2017-03-28,140.8 ( -0.85 %),1329,1572340,1183.1,1805,2191870,1214,-619530
2017-03-27,142 ( 0.21 %),1453,1567380,1078.72,1920,2061500,1074,-494120
2017-03-24,141.7 ( 1.07 %),1299,1763150,1357.31,1958,2530040,1292,-766890
2017-03-23,140.2 ( 2.64 %),1662,3173480,1909.43,2820,3491350,1238,-317870
2017-03-22,136.6 ( 0.74 %),1598,2366280,1480.78,2359,2698740,1144,-332460
2017-03-21,135.6 ( 1.27 %),1012,1387730,1371.27,1689,1466730,868,-79000
2017-03-20,133.9 ( -0.07 %),1635,1239770,758.27,1426,1403130,984,-163360
2017-03-17,134 ( 0 %),971,1289190,1327.69,1728,2030650,1175,-741460
2017-03-16,134 ( 0.75 %),1722,1503270,872.98,1852,1789900,966,-286630
2017-03-15,133 ( 1.76 %),1960,1889600,964.08,1951,1718530,881,171070
2017-03-14,130.7 ( 0.77 %),831,931390,1120.81,976,880420,902,50970
2017-03-13,129.7 ( -0.15 %),723,458380,634,698,784030,1123,-325650
2017-03-10,129.9 ( -0.46 %),827,565210,683.45,715,940340,1315,-375130
2017-03-09,130.5 ( -0.08 %),864,620580,718.26,710,882370,1243,-261790
2017-03-08,130.6 ( 0.46 %),1069,1048490,980.81,1078,1271260,1179,-222770
2017-03-07,130 ( -0.69 %),834,606230,726.89,909,929650,1023,-323420
2017-03-06,130.9 ( 0.77 %),950,1138060,1197.96,1004,1338850,1334,-200790
2017-03-03,129.9 ( 0.15 %),844,896260,1061.92,814,824350,1013,71910
2017-03-02,129.7 ( -0.84 %),1494,706230,472.71,692,934930,1351,-228700
2017-03-01,130.8 ( -0.46 %),1013,1196890,1181.53,1122,1078370,961,118520
2017-02-28,131.4 ( -0.3 %),802,960360,1197.46,1117,1480960,1326,-520600
2017-02-27,131.8 ( -0.08 %),925,1111120,1201.21,1376,1421910,1033,-310790
2017-02-24,131.9 ( 1.23 %),1370,2598480,1896.7,1668,1910270,1145,688210
2017-02-23,130.3 ( -0.08 %),1284,974690,759.1,905,1160410,1282,-185720
2017-02-22,130.4 ( 0.08 %),762,906250,1189.3,913,1041340,1141,-135090
2017-02-21,130.3 ( 0.23 %),1333,1395450,1046.85,1004,1297550,1292,97900
2017-02-20,130 ( 0 %),782,768160,982.3,779,881850,1132,-113690
2017-02-17,130 ( -1.52 %),1822,1325940,727.74,1213,1708630,1409,-382690
2017-02-16,132 ( -0.75 %),840,1042860,1241.5,1115,1604890,1439,-562030
2017-02-15,133 ( 0.08 %),835,1207320,1445.89,1346,1434380,1066,-227060
2017-02-14,132.9 ( -0.67 %),1033,861360,833.84,1189,1578680,1328,-717320
2017-02-13,133.8 ( 0 %),709,1108980,1564.15,1053,1330960,1264,-221980
2017-02-10,133.8 ( -0.22 %),1000,2542070,2542.07,1234,3148160,2551,-606090
2017-02-09,134.1 ( 0.15 %),742,1419090,1912.52,1248,1596060,1279,-176970
2017-02-08,133.9 ( 0.07 %),752,795130,1057.35,1108,1215310,1097,-420180
2017-02-07,133.8 ( 0.45 %),1111,1162480,1046.34,1262,1441000,1142,-278520
2017-02-06,133.2 ( -0.52 %),1428,1941140,1359.34,1543,2479190,1607,-538050
2017-02-03,133.9 ( 0.68 %),1988,2278020,1145.89,2613,3482220,1333,-1204200
2017-02-02,133 ( 3.1 %),1814,3340820,1841.69,2082,2432910,1169,907910
2017-01-25,129 ( 0.78 %),806,2971630,3686.89,1172,2669800,2278,301830
2017-01-24,128 ( 0 %),716,1398610,1953.37,1028,2015170,1960,-616560
2017-01-23,128 ( 0.79 %),1076,2793070,2595.79,1726,3090280,1790,-297210
2017-01-20,127 ( 0.79 %),902,2447190,2713.07,1996,2778380,1392,-331190
2017-01-19,126 ( 0 %),656,1618270,2466.88,817,1362150,1667,256120
2017-01-18,126 ( -0.08 %),913,1438910,1576.02,822,1235750,1503,203160
2017-01-17,126.1 ( -0.32 %),657,1266860,1928.25,825,1406840,1705,-139980
2017-01-16,126.5 ( -0.32 %),610,1150520,1886.1,845,1194420,1414,-43900
2017-01-13,126.9 ( -0.08 %),845,1606170,1900.79,1050,1269670,1209,336500
2017-01-12,127 ( 0 %),636,1227880,1930.63,948,1165520,1229,62360
2017-01-11,127 ( 0.71 %),755,1589300,2105.03,1478,1664540,1126,-75240
2017-01-10,126.1 ( 0.08 %),826,1795680,2173.95,963,1376960,1430,418720
2017-01-09,126 ( 0 %),764,1241750,1625.33,1206,1639630,1360,-397880
2017-01-06,126 ( -0.55 %),1288,1754510,1362.2,1305,2333490,1788,-578980
2017-01-05,126.7 ( -0.16 %),842,1281500,1521.97,1136,1498610,1319,-217110
2017-01-04,126.9 ( 0.16 %),742,1338540,1803.96,1237,1426080,1153,-87540
2017-01-03,126.7 ( 0.88 %),1023,1573280,1537.91,1068,1264510,1184,308770
2016-12-30,125.6 ( -2.33 %),1948,1713640,879.69,1528,2956350,1935,-1242710
2016-12-29,128.6 ( 2.06 %),1866,2970440,1591.88,2939,3620770,1232,-650330
2016-12-28,126 ( 0.8 %),1063,1674710,1575.46,1934,2154940,1114,-480230
2016-12-27,125 ( 2.04 %),1660,3378310,2035.13,2458,2732480,1112,645830
2016-12-26,122.5 ( -1.21 %),1618,1155120,713.92,1094,1212240,1108,-57120
2016-12-23,124 ( 0.73 %),2655,2583800,973.18,1698,2374860,1399,208940
2016-12-22,123.1 ( -2.38 %),2264,2006920,886.45,1566,3197790,2042,-1190870
2016-12-21,126.1 ( 1.2 %),4236,4929740,1163.77,2751,3681730,1338,1248010
2016-12-20,124.6 ( -3.26 %),6367,4411590,692.88,1908,4529140,2374,-117550
2016-12-19,128.8 ( -0.85 %),1635,1370620,838.3,1133,1407220,1242,-36600
2016-12-16,129.9 ( 1.8 %),1893,2961020,1564.19,2120,3252320,1534,-291300
2016-12-15,127.6 ( -2.45 %),5119,4007560,782.88,1802,4427570,2457,-420010
2016-12-14,130.8 ( -0.15 %),2555,2299170,899.87,1478,2492070,1686,-192900
2016-12-13,131 ( -2.02 %),1898,1984830,1045.75,1836,3395900,1850,-1411070
2016-12-12,133.7 ( -1.55 %),2027,2717250,1340.53,1710,3239940,1895,-522690
2016-12-09,135.8 ( 0.44 %),1575,2687140,1706.12,2041,3848670,1886,-1161530
2016-12-08,135.2 ( 2.04 %),2194,4983280,2271.32,2144,4615410,2153,367870
2016-12-07,132.5 ( -1.12 %),2585,3171500,1226.89,1652,3364000,2036,-192500
2016-12-06,134 ( -0.74 %),1300,1266600,974.31,1455,1839500,1264,-572900
2016-12-05,135 ( 0 %),1405,1609370,1145.46,1194,2294140,1921,-684770
2016-12-02,135 ( -0.15 %),2260,3068000,1357.52,1860,3230480,1737,-162480
2016-12-01,135.2 ( -2.03 %),2474,2934380,1186.09,2470,3174250,1285,-239870
2016-11-30,138 ( 2.76 %),2609,6777030,2597.56,3786,7967680,2105,-1190650
2016-11-29,134.3 ( 3.95 %),4807,5420940,1127.72,2536,4096670,1615,1324270
2016-11-28,129.2 ( -3.94 %),5780,4712620,815.33,2257,5119450,2268,-406830
2016-11-25,134.5 ( -1.61 %),5420,5126090,945.77,1746,4067380,2330,1058710
2016-11-24,136.7 ( -1.65 %),3650,3187320,873.24,1382,3649870,2641,-462550
2016-11-23,139 ( -1.21 %),1266,1363280,1076.84,1595,2221970,1393,-858690
2016-11-22,140.7 ( 1.59 %),1389,2316240,1667.56,1632,1940970,1189,375270
2016-11-21,138.5 ( 0.95 %),997,1536060,1540.68,1302,1708180,1312,-172120
2016-11-18,137.2 ( -1.29 %),2229,1829010,820.55,1182,1873320,1585,-44310
2016-11-17,139 ( 0 %),956,1191130,1245.95,1058,1448900,1369,-257770
2016-11-16,139 ( 1.24 %),1515,2744020,1811.23,1442,2232060,1548,511960
2016-11-15,137.3 ( -0.65 %),3191,2850600,893.32,1309,3012150,2301,-161550
2016-11-14,138.2 ( -1.64 %),2715,2361760,869.89,1091,2437690,2234,-75930
2016-11-11,140.5 ( -0.35 %),820,1016200,1239.27,909,1438970,1583,-422770
2016-11-10,141 ( 0.71 %),866,1642360,1896.49,1013,1395450,1378,246910
2016-11-09,140 ( -0.28 %),4571,4990370,1091.75,1974,3926550,1989,1063820
2016-11-08,140.4 ( 0.14 %),869,970790,1117.13,805,882080,1096,88710
2016-11-07,140.2 ( -0.5 %),1884,1947970,1033.95,1067,2072530,1942,-124560
2016-11-04,140.9 ( -0.35 %),921,1644150,1785.18,1130,1777210,1573,-133060
2016-11-03,141.4 ( 0.21 %),1174,2603160,2217.34,1149,1789880,1558,813280
2016-11-02,141.1 ( -0.56 %),843,1384140,1641.92,1309,1402530,1071,-18390
2016-11-01,141.9 ( -0.07 %),1041,1424270,1368.17,944,1312190,1390,112080
2016-10-31,142 ( -0.91 %),766,988400,1290.34,709,721080,1017,267320
2016-10-28,143.3 ( 0.56 %),975,1729120,1773.46,1264,1385780,1096,343340
2016-10-27,142.5 ( 0.99 %),896,1547270,1726.86,771,621130,806,926140
2016-10-26,141.1 ( 0.07 %),1048,1307320,1247.44,666,750490,1127,556830
2016-10-25,141 ( 0 %),1812,2482290,1369.92,1118,1841410,1647,640880
2016-10-24,141 ( -2.22 %),2976,2919920,981.16,2562,2634320,1028,285600
2016-10-21,144.2 ( -0.48 %),1097,1456510,1327.72,1138,1275670,1121,180840
2016-10-20,144.9 ( -0.75 %),1372,1600610,1166.63,1429,2080970,1456,-480360
2016-10-19,146 ( 1.39 %),1446,3185830,2203.2,2569,2899180,1129,286650
2016-10-18,144 ( 1.27 %),978,1654180,1691.39,1213,1461070,1205,193110
2016-10-17,142.2 ( -1.25 %),1301,1602640,1231.85,1252,1371040,1095,231600
2016-10-14,144 ( 1.41 %),1966,3873090,1970.04,2995,3564080,1190,309010
2016-10-13,142 ( 0.35 %),1180,1751210,1484.08,1455,1770680,1217,-19470
2016-10-12,141.5 ( 0.71 %),1204,2364240,1963.65,1541,2000630,1298,363610
2016-10-11,140.5 ( 0.29 %),2952,2783730,943,1652,3409710,2064,-625980
2016-10-10,140.1 ( -1.06 %),999,1019690,1020.71,929,1443070,1553,-423380
2016-10-07,141.6 ( -0.28 %),1300,1904350,1464.88,1327,2135730,1609,-231380
2016-10-06,142 ( 1.14 %),1359,2909500,2140.91,1752,2924990,1670,-15490
2016-10-05,140.4 ( -0.07 %),851,1352310,1589.08,1244,1917000,1541,-564690
2016-10-04,140.5 ( 0 %),1621,2449290,1510.97,1616,2306180,1427,143110
2016-10-03,140.5 ( 0.36 %),904,1867850,2066.21,1468,1980790,1349,-112940
2016-09-30,140 ( 0 %),1053,2058270,1954.67,1443,2025010,1403,33260
2016-09-29,140 ( 0 %),1941,3433370,1768.87,1710,3552220,2077,-118850
2016-09-28,140 ( 0 %),1598,2410170,1508.24,1650,3000980,1819,-590810
2016-09-27,140 ( -0.71 %),1833,1972840,1076.29,1623,2201870,1357,-229030
2016-09-26,141 ( 0.71 %),1825,2562560,1404.14,1584,2694380,1701,-131820
2016-09-23,140 ( 2.04 %),1935,2790400,1442.07,2279,2780520,1220,9880
2016-09-22,137.2 ( -0.44 %),1960,1640150,836.81,1534,2199130,1434,-558980
2016-09-21,137.8 ( 1.32 %),2765,2761600,998.77,1923,2774010,1443,-12410
2016-09-20,136 ( 0 %),4132,4636510,1122.1,2488,4634160,1863,2350
2016-09-19,136 ( -1.45 %),4074,4499160,1104.36,2421,5820140,2404,-1320980
2016-09-16,138 ( -3.5 %),2665,7503660,2815.63,2777,22850300,8228,-15346640
2016-09-15,143 ( -0.69 %),1730,2604500,1505.49,1339,2977060,2223,-372560
2016-09-14,144 ( -0.62 %),1841,1675410,910.05,1099,2311930,2104,-636520
2016-09-13,144.9 ( 2.62 %),3697,4800100,1298.38,2024,3931550,1942,868550
2016-09-12,141.2 ( -1.26 %),3607,3719220,1031.11,2258,4801320,2126,-1082100
2016-09-09,143 ( -2.72 %),3226,2887520,895.08,1262,3798180,3010,-910660
2016-09-08,147 ( 0.68 %),3140,4616690,1470.28,1289,3899310,3025,717380
2016-09-07,146 ( -2.67 %),5486,7434190,1355.12,2250,7945550,3531,-511360
2016-09-06,150 ( -2.6 %),2137,2822970,1321,1482,4858800,3279,-2035830
2016-09-05,154 ( 0 %),2733,4675300,1710.68,1722,5148650,2990,-473350
2016-09-01,154 ( -1.28 %),2852,4278690,1500.24,1695,5591440,3299,-1312750
2016-08-31,156 ( 2.63 %),2367,5284830,2232.71,1469,3405650,2318,1879180
2016-08-30,152 ( 0.66 %),2209,4032930,1825.68,1432,3388090,2366,644840
2016-08-29,151 ( 3.42 %),3403,7404410,2175.85,3175,6031950,1900,1372460
2016-08-26,146 ( 0.69 %),1455,2634780,1810.85,1192,2274660,1908,360120
2016-08-25,145 ( 0 %),1397,1468290,1051.03,1138,2114690,1858,-646400
2016-08-24,145 ( 1.4 %),2044,3131550,1532.07,1339,4052290,3026,-920740
2016-08-23,143 ( 2.14 %),2369,3553400,1499.96,777,1859630,2393,1693770
2016-08-22,140 ( -2.1 %),2246,2060680,917.49,1100,3356910,3052,-1296230
2016-08-19,143 ( 0.94 %),5779,5907420,1022.22,1383,6684120,4833,-776700
2016-08-18,174 ( 1.75 %),1611,4180920,2595.23,1538,3735950,2429,444970
2016-08-17,171 ( 1.18 %),1591,3244180,2039.08,1233,2778130,2253,466050
2016-08-16,169 ( 0 %),1175,2341910,1993.11,1185,2401680,2027,-59770
2016-08-15,169 ( 0.6 %),1620,2351980,1451.84,1167,3057770,2620,-705790
2016-08-12,168 ( -0.59 %),2123,4959870,2336.26,2189,6325880,2890,-1366010
2016-08-11,169 ( 3.05 %),1556,3764030,2419.04,1375,2760290,2007,1003740
2016-08-10,164 ( 1.23 %),1383,2687930,1943.55,1123,2541450,2263,146480
2016-08-09,162 ( 2.53 %),1898,3700610,1949.74,1329,3184550,2396,516060
2016-08-08,158 ( 0 %),976,1560300,1598.67,851,1550740,1822,9560
2016-08-05,158 ( 1.28 %),1177,2082270,1769.13,1009,2113560,2095,-31290
2016-08-04,156 ( 1.3 %),1260,2838660,2252.9,1140,2457750,2156,380910
2016-08-03,154 ( 1.32 %),1357,1850170,1363.43,722,1563580,2166,286590
2016-08-02,152 ( -1.94 %),2076,2965560,1428.5,936,3164720,3381,-199160
2016-08-01,155 ( -1.9 %),2017,3238960,1605.83,1009,3556110,3524,-317150
2016-07-29,158 ( -1.25 %),1011,1543440,1526.65,1009,2608120,2585,-1064680
2016-07-28,160 ( 1.27 %),1254,2924250,2331.94,1197,2660910,2223,263340
2016-07-27,158 ( 0.64 %),905,1624110,1794.6,923,1651530,1789,-27420
2016-07-26,157 ( 1.95 %),1303,2369150,1818.23,978,2067800,2114,301350
2016-07-25,154 ( -1.28 %),1132,1237740,1093.41,704,1706380,2424,-468640
2016-07-22,156 ( -0.64 %),2573,4321970,1679.74,1424,4430200,3111,-108230
2016-07-21,157 ( -0.63 %),2056,2999630,1458.96,1448,3508910,2423,-509280
2016-07-20,158 ( 3.27 %),1657,3728720,2250.28,1433,2848480,1988,880240
2016-07-19,153 ( 2 %),1652,3972310,2404.55,1913,3980280,2081,-7970
2016-07-18,150 ( 2.04 %),984,2738410,2782.94,1213,2096920,1729,641490
2016-07-15,147 ( 0.68 %),758,1599950,2110.75,823,1387020,1685,212930
2016-07-14,146 ( -0.68 %),1034,2394340,2315.61,904,2563300,2836,-168960
2016-07-13,147 ( 0 %),637,1302060,2044.05,890,1263620,1420,38440
2016-07-12,147 ( 0.68 %),814,1533240,1883.59,759,1608050,2119,-74810
2016-07-11,146 ( -0.68 %),653,1368080,2095.07,1138,1783800,1567,-415720
2016-07-08,147 ( 0 %),646,1490970,2308,1279,1819400,1423,-328430
2016-07-07,147 ( 2.8 %),971,2795990,2879.5,1638,2153230,1315,642760
2016-07-06,143 ( -0.69 %),618,1068670,1729.24,999,1301310,1303,-232640
2016-07-05,144 ( -0.69 %),728,1457660,2002.28,1317,1863550,1415,-405890
2016-07-04,145 ( 1.4 %),758,2349130,3099.12,1179,1771230,1502,577900
2016-07-01,143 ( 1.42 %),718,3395470,4729.07,1438,2406320,1673,989150
2016-06-30,141 ( 1.44 %),587,1966000,3349.23,1200,1929840,1608,36160
2016-06-29,139 ( -0.71 %),931,1734190,1862.72,1130,2203130,1950,-468940
2016-06-28,140 ( 2.19 %),1409,3454240,2451.55,1415,3550830,2509,-96590
2016-06-27,137 ( 0 %),969,1421750,1467.23,613,1589340,2593,-167590
2016-06-24,137 ( -2.14 %),2241,3114310,1389.7,1110,3263780,2940,-149470
2016-06-23,140 ( 0.72 %),806,2066230,2563.56,1075,2529020,2353,-462790
2016-06-22,139 ( 0 %),433,722630,1668.89,674,1203490,1786,-480860
2016-06-21,139 ( 1.46 %),787,1826070,2320.29,961,1609510,1675,216560
2016-06-20,137 ( 0 %),608,666880,1096.84,511,922180,1805,-255300
2016-06-17,137 ( 0 %),526,687310,1306.67,568,1032070,1817,-344760
2016-06-16,137 ( 0 %),566,627900,1109.36,587,935360,1593,-307460
2016-06-15,137 ( 0 %),705,854680,1212.31,538,890880,1656,-36200
2016-06-14,137 ( 0 %),579,663230,1145.47,493,909020,1844,-245790
2016-06-13,137 ( 0 %),883,871770,987.28,558,1049140,1880,-177370
2016-06-10,137 ( -0.72 %),1140,832570,730.32,632,1219660,1930,-387090
2016-06-09,138 ( 0 %),651,525630,807.42,550,891450,1621,-365820
2016-06-08,138 ( 0.73 %),662,760420,1148.67,571,669040,1172,91380
2016-06-07,137 ( 0.74 %),1048,973310,928.73,591,852660,1443,120650
2016-06-06,136 ( -2.16 %),1202,952540,792.46,715,1536080,2148,-583540
2016-06-03,139 ( 0 %),1080,970840,898.93,615,1183540,1924,-212700
2016-06-02,141 ( 0 %),612,870410,1422.24,485,902360,1861,-31950
2016-06-01,141 ( -0.7 %),1103,1134740,1028.78,593,1442500,2433,-307760
2016-05-31,142 ( 0 %),490,611680,1248.33,443,705770,1593,-94090
2016-05-30,142 ( -0.7 %),555,647520,1166.7,459,922150,2009,-274630
2016-05-27,143 ( 1.42 %),802,903880,1127.03,411,865850,2107,38030
2016-05-26,141 ( -2.08 %),1528,1707050,1117.18,702,2212370,3152,-505320
2016-05-25,144 ( -0.69 %),519,643400,1239.69,531,1329270,2503,-685870
2016-05-24,145 ( -0.68 %),548,966550,1763.78,624,1319770,2115,-353220
2016-05-23,146 ( 0 %),647,1204810,1862.15,864,1964230,2273,-759420
2016-05-20,146 ( 0.69 %),586,1259060,2148.57,568,1192060,2099,67000
2016-05-19,145 ( 0 %),611,1006440,1647.2,515,1182170,2295,-175730
2016-05-18,145 ( -1.36 %),838,1146020,1367.57,804,2052200,2552,-906180
2016-05-17,147 ( 0.68 %),1039,1905000,1833.49,1079,2558230,2371,-653230
2016-05-16,146 ( 1.39 %),777,1574910,2026.91,794,1409030,1775,165880
2016-05-13,144 ( -0.69 %),660,802730,1216.26,681,1237680,1817,-434950
2016-05-12,145 ( -0.68 %),697,921500,1322.09,860,1538120,1789,-616620
2016-05-11,146 ( 2.1 %),709,1310930,1848.98,594,958550,1614,352380
2016-05-10,143 ( -0.69 %),926,964200,1041.25,610,1481890,2429,-517690
2016-05-09,144 ( 1.41 %),2232,3458300,1549.42,1577,3999540,2536,-541240
2016-05-06,142 ( 0 %),493,1107000,2245.44,866,1819000,2100,-712000
2016-05-05,142 ( 0 %),515,970330,1884.14,966,1670790,1730,-700460
2016-05-04,142 ( 2.16 %),695,1701220,2447.8,1185,1641070,1385,60150
2016-04-29,139 ( 0.72 %),667,1098460,1646.87,503,1192390,2371,-93930
2016-04-28,138 ( 0 %),639,1201990,1881.05,549,1360500,2478,-158510
2016-04-27,138 ( -1.43 %),764,1012640,1325.45,727,1641570,2258,-628930
2016-04-26,140 ( 0.72 %),641,1195750,1865.44,648,1393560,2151,-197810
2016-04-25,139 ( -0.71 %),709,1624350,2291.04,890,2027720,2278,-403370
2016-04-22,140 ( 2.19 %),1220,2356650,1931.68,760,2072350,2727,284300
2016-04-21,137 ( 0.74 %),1356,2059470,1518.78,594,1517020,2554,542450
2016-04-20,136 ( -2.16 %),1597,2531420,1585.11,1197,3478940,2906,-947520
2016-04-19,139 ( -2.8 %),1052,1779480,1691.52,910,2314120,2543,-534640
2016-04-15,143 ( 0.7 %),756,1985890,2626.84,998,1744530,1748,241360
2016-04-14,142 ( 0 %),732,1403830,1917.8,750,1577300,2103,-173470
2016-04-13,142 ( -0.7 %),762,1444090,1895.13,941,2073230,2203,-629140
2016-04-12,143 ( 0 %),790,1634070,2068.44,862,1515220,1758,118850
2016-04-11,143 ( 0 %),952,1478940,1553.51,958,2026150,2115,-547210
2016-04-08,143 ( 1.42 %),1029,2109250,2049.81,1286,2333480,1815,-224230
2016-04-07,141 ( 2.92 %),1600,3942230,2463.89,1748,3391750,1940,550480
2016-04-06,137 ( 0 %),567,960580,1694.14,829,1391080,1678,-430500
2016-04-05,137 ( 2.24 %),621,1490980,2400.93,877,1536590,1752,-45610
2016-04-04,134 ( 0 %),502,1019790,2031.45,490,757900,1547,261890
2016-04-01,134 ( 0 %),851,1948590,2289.76,701,1666510,2377,282080
2016-03-31,134 ( -1.47 %),410,873070,2129.44,897,1697880,1893,-824810
2016-03-30,136 ( 1.49 %),807,1883800,2334.32,961,1681210,1749,202590
2016-03-29,134 ( -0.74 %),522,953720,1827.05,703,1056490,1503,-102770
2016-03-28,135 ( 0.75 %),502,679230,1353.05,496,716420,1444,-37190
2016-03-25,134 ( -0.74 %),963,1370330,1422.98,633,1476460,2332,-106130
2016-03-24,135 ( 0.75 %),850,1389370,1634.55,688,1383840,2011,5530
2016-03-23,134 ( 0.75 %),778,1430210,1838.32,457,1149800,2516,280410
2016-03-22,133 ( -1.48 %),1202,1889010,1571.56,875,2356380,2693,-467370
2016-03-21,135 ( -2.17 %),610,1035930,1698.25,874,1934350,2213,-898420
2016-03-18,138 ( 0 %),518,795640,1535.98,808,1473670,1824,-678030
2016-03-17,138 ( 0.73 %),794,1552110,1954.8,1373,2419160,1762,-867050
2016-03-16,137 ( 0.74 %),657,1094910,1666.53,956,1675720,1753,-580810
2016-03-15,136 ( 0.74 %),1008,2170990,2153.76,1350,2384900,1767,-213910
2016-03-14,135 ( -0.74 %),596,1065130,1787.13,837,1599960,1912,-534830
2016-03-11,136 ( 3.82 %),2166,4436900,2048.43,1971,3779980,1918,656920
2016-03-10,131 ( 0 %),604,966290,1599.82,571,1257630,2203,-291340
2016-03-09,131 ( 0 %),457,667240,1460.04,525,949700,1809,-282460
2016-03-08,131 ( 0 %),387,894480,2311.32,771,1203000,1560,-308520
2016-03-07,131 ( -0.76 %),502,1226840,2443.9,986,1518700,1540,-291860
2016-03-04,132 ( 0.76 %),475,1002130,2109.75,879,1610680,1832,-608550
2016-03-03,131 ( -0.76 %),469,1004010,2140.75,1033,1639810,1587,-635800
2016-03-02,132 ( 1.54 %),878,1933930,2202.65,960,1787020,1861,146910
2016-03-01,130 ( 1.56 %),742,1570550,2116.64,787,1396400,1774,174150
2016-02-29,128 ( -1.54 %),632,1005020,1590.22,699,1592880,2279,-587860
2016-02-26,130 ( 0.78 %),734,1141920,1555.75,758,1756510,2317,-614590
2016-02-25,129 ( -1.53 %),680,1605630,2361.22,1034,2179740,2108,-574110
2016-02-24,131 ( 0.77 %),621,1561330,2514.22,911,1456200,1598,105130
2016-02-23,130 ( 0 %),757,1771700,2340.42,1223,2194190,1794,-422490
2016-02-22,130 ( 0.78 %),796,1768100,2221.23,1022,1643460,1608,124640
2016-02-19,129 ( 0 %),627,933310,1488.53,968,1457700,1506,-524390
2016-02-18,129 ( -0.77 %),923,1976690,2141.59,1222,2242280,1835,-265590
2016-02-17,130 ( 1.56 %),2073,3765960,1816.67,1829,3756290,2054,9670
2016-02-16,128 ( 1.59 %),727,1430290,1967.39,1102,1635570,1484,-205280
2016-02-15,126 ( 1.61 %),521,1104630,2120.21,592,816010,1378,288620
2016-02-05,124 ( 1.64 %),316,620160,1962.53,354,511290,1444,108870
2016-02-04,122 ( 0.83 %),401,654770,1632.84,665,975960,1468,-321190
2016-02-03,121 ( 1.68 %),423,706580,1670.4,456,640730,1405,65850
2016-02-02,119 ( 0 %),467,589830,1263.02,611,853350,1397,-263520
2016-02-01,119 ( 2.59 %),789,1612130,2043.26,1000,1584080,1584,28050
2016-01-29,116 ( 0 %),507,662780,1307.26,469,573740,1223,89040
2016-01-28,116 ( -0.85 %),416,576270,1385.26,585,921190,1575,-344920
2016-01-27,117 ( 1.74 %),483,678680,1405.13,490,901190,1839,-222510
2016-01-26,115 ( -2.54 %),781,693540,888.02,555,1011150,1822,-317610
2016-01-25,118 ( 3.51 %),819,969810,1184.14,413,681420,1650,288390
2016-01-22,114 ( -1.72 %),1119,1330870,1189.34,795,1588730,1998,-257860
2016-01-21,116 ( -0.85 %),577,701620,1215.98,553,855070,1546,-153450
2016-01-20,117 ( -1.68 %),539,770570,1429.63,483,971000,2010,-200430
2016-01-19,119 ( 1.71 %),890,1319150,1482.19,507,988950,1951,330200
2016-01-18,117 ( -2.5 %),1331,2185080,1641.68,948,2791970,2945,-606890
2016-01-15,120 ( -0.83 %),573,1014920,1771.24,569,1209980,2127,-195060
2016-01-14,121 ( 0 %),769,1238650,1610.73,451,977120,2167,261530
2016-01-13,121 ( -1.63 %),563,680840,1209.31,473,940950,1989,-260110
2016-01-12,123 ( 1.65 %),709,1126470,1588.82,443,1078310,2434,48160
2016-01-11,121 ( -0.82 %),733,804990,1098.21,446,995250,2232,-190260
2016-01-08,122 ( -1.61 %),1182,1264590,1069.87,604,1603720,2655,-339130
2016-01-07,124 ( -1.59 %),1291,1610110,1247.18,709,1854830,2616,-244720
2016-01-06,126 ( 0.8 %),627,796550,1270.41,464,855340,1843,-58790
2016-01-05,125 ( -0.79 %),562,753560,1340.85,577,1004660,1741,-251100
2016-01-04,126 ( -1.56 %),541,824860,1524.7,643,1396940,2173,-572080
2015-12-31,128 ( 0.79 %),658,2045820,3109.15,1243,2140110,1722,-94290
2015-12-30,127 ( 0 %),473,735420,1554.8,746,1238070,1660,-502650
2015-12-29,127 ( 0 %),511,878050,1718.3,581,1352200,2327,-474150
2015-12-28,127 ( 2.42 %),633,1605930,2537.01,983,1774000,1805,-168070
2015-12-25,124 ( -0.8 %),641,743020,1159.16,414,1180400,2851,-437380
2015-12-24,125 ( 0.81 %),574,909570,1584.62,381,978690,2569,-69120
2015-12-23,124 ( -0.8 %),663,806940,1217.1,475,923580,1944,-116640
2015-12-22,125 ( 0 %),594,1042970,1755.84,512,994630,1943,48340
2015-12-21,125 ( -2.34 %),682,1103560,1618.12,679,1352700,1992,-249140
2015-12-18,128 ( 0 %),445,796660,1790.25,817,1333780,1633,-537120
2015-12-17,128 ( 0 %),573,971900,1696.16,905,1226470,1355,-254570
2015-12-16,128 ( 1.59 %),937,1643540,1754.04,1078,1428340,1325,215200
2015-12-15,126 ( 1.61 %),791,2013280,2545.23,1214,1663770,1370,349510
2015-12-14,124 ( 0.81 %),551,923440,1675.93,563,840510,1493,82930
2015-12-11,123 ( 0 %),594,976750,1644.36,734,1292540,1761,-315790
2015-12-10,123 ( 0 %),512,1240550,2422.95,673,798180,1186,442370
2015-12-09,123 ( -1.6 %),645,1322580,2050.51,1170,1551400,1326,-228820
2015-12-08,125 ( 4.17 %),1189,2297480,1932.28,1126,1581380,1404,716100
2015-12-07,120 ( -2.44 %),711,804450,1131.43,695,1042100,1499,-237650
2015-12-04,123 ( 0 %),710,882370,1242.77,578,819950,1419,62420
2015-12-03,123 ( 0 %),777,1472800,1895.5,798,1352450,1695,120350
2015-12-02,123 ( 0.82 %),1004,1337910,1332.58,761,1249560,1642,88350
2015-12-01,122 ( -1.61 %),1271,2511850,1976.28,1078,2306020,2139,205830
2015-11-30,124 ( 0 %),907,1814500,2000.55,1222,1878180,1537,-63680
2015-11-27,124 ( 0.81 %),1620,2499170,1542.7,1397,2340900,1676,158270
2015-11-26,123 ( -1.6 %),752,935500,1244.02,692,1164220,1682,-228720
2015-11-25,125 ( 1.63 %),2041,3179210,1557.67,1098,1994780,1817,1184430
2015-11-24,123 ( -3.15 %),3223,4669660,1448.86,1817,4672090,2571,-2430
2015-11-23,127 ( -3.05 %),2243,2725190,1214.98,1385,3857510,2785,-1132320
2015-11-20,131 ( 0.77 %),1196,1755070,1467.45,908,1987970,2189,-232900
2015-11-19,130 ( -1.52 %),1603,2081050,1298.22,1101,2699060,2451,-618010
2015-11-18,132 ( -1.49 %),2173,3043860,1400.76,1489,3476730,2335,-432870
2015-11-17,134 ( -4.29 %),2244,3326660,1482.47,1537,4029950,2622,-703290
2015-11-16,140 ( 2.19 %),1371,1842720,1344.07,894,1533430,1715,309290
2015-11-13,137 ( 3.79 %),1429,2761080,1932.18,1370,2104730,1536,656350
2015-11-12,132 ( 1.54 %),941,1863690,1980.54,954,1296730,1359,566960
2015-11-11,130 ( 1.56 %),1090,2871530,2634.43,1248,2009700,1610,861830
2015-11-10,128 ( 0.79 %),1061,1936120,1824.81,997,1719690,1725,216430
2015-11-09,127 ( -1.55 %),1207,1859670,1540.74,1009,1686560,1672,173110
2015-11-06,129 ( 0.78 %),2354,3302180,1402.8,1513,3114940,2059,187240
2015-11-05,128 ( 4.07 %),1710,2728140,1595.4,953,1846530,1938,881610
2015-11-04,123 ( 0 %),875,1200960,1372.53,856,1139840,1332,61120
2015-11-03,123 ( 5.13 %),2259,4594470,2033.85,1797,4149410,2309,445060
2015-11-02,117 ( -0.85 %),680,1233190,1813.51,816,2146560,2631,-913370
2015-10-30,118 ( -0.84 %),732,1233730,1685.42,996,1861840,1869,-628110
2015-10-29,119 ( 4.39 %),1053,2694240,2558.63,1564,2625590,1679,68650
2015-10-28,114 ( 0 %),574,1026430,1788.21,744,993050,1335,33380
2015-10-27,114 ( 0.88 %),711,1320670,1857.48,842,1102720,1310,217950
2015-10-26,113 ( -1.74 %),825,1304050,1580.67,1005,1751730,1743,-447680
2015-10-23,115 ( 0.88 %),817,1564580,1915.03,929,1279820,1378,284760
2015-10-22,114 ( 0.88 %),701,1519370,2167.43,794,1326590,1671,192780
2015-10-21,113 ( 0.89 %),859,1790470,2084.37,964,1511810,1568,278660
2015-10-20,112 ( 0.9 %),1495,2337600,1563.61,1401,2543600,1816,-206000
2015-10-19,111 ( 4.72 %),1300,3223530,2479.64,1742,2335870,1341,887660
2015-10-16,106 ( 0.95 %),844,1941470,2300.32,1183,1881320,1590,60150
2015-10-15,105 ( -0.94 %),629,927540,1474.63,1009,1534680,1521,-607140
2015-10-14,106 ( 3.92 %),1793,3495920,1949.76,2324,4070980,1752,-575060
2015-10-13,102 ( 0.99 %),485,896510,1848.47,602,880760,1463,15750
2015-10-12,101 ( 0 %),625,798450,1277.52,555,1087560,1960,-289110
2015-10-09,101 ( 0 %),523,688590,1316.62,669,1045910,1563,-357320
2015-10-08,101 ( -0.98 %),508,751130,1478.6,684,1256120,1836,-504990
2015-10-07,102 ( -0.97 %),457,688800,1507.22,705,1083580,1537,-394780
2015-10-06,103 ( 0 %),456,679410,1489.93,950,1425280,1500,-745870
2015-10-05,103 ( 3 %),693,1699050,2451.73,1207,1848480,1531,-149430
2015-10-02,100 ( -0.99 %),350,558020,1594.34,456,810790,1778,-252770
2015-10-01,101 ( 1 %),392,413190,1054.06,569,795130,1397,-381940
2015-09-30,100 ( 0 %),377,537290,1425.17,530,821260,1550,-283970
2015-09-29,100 ( -1.96 %),640,655500,1024.22,609,923680,1517,-268180
2015-09-28,102 ( 0.99 %),437,810890,1855.58,959,1188050,1239,-377160
2015-09-25,101 ( 1 %),471,584760,1241.53,452,616250,1363,-31490
2015-09-24,100 ( -0.99 %),413,584960,1416.37,528,872600,1653,-287640
2015-09-23,101 ( -0.98 %),506,729900,1442.49,1197,1329900,1111,-600000
2015-09-22,102 ( 3.03 %),511,1214140,2376.01,850,918640,1081,295500
2015-09-21,99 ( 0.51 %),373,617500,1655.5,568,650710,1146,-33210
2015-09-18,98.5 ( 1.03 %),361,568350,1574.38,564,507160,899,61190
2015-09-17,97.5 ( 0 %),420,578920,1378.38,413,564670,1367,14250
2015-09-16,97.5 ( 0 %),368,456690,1241.01,436,427470,980,29220
2015-09-15,97.5 ( 0 %),554,807100,1456.86,495,575240,1162,231860
2015-09-14,97.5 ( -1.02 %),453,498030,1099.4,303,405750,1339,92280
2015-09-11,98.5 ( -1.01 %),321,406120,1265.17,553,657910,1190,-251790
2015-09-10,99.5 ( 2.05 %),510,825110,1617.86,646,646310,1000,178800
2015-09-09,97.5 ( 0.52 %),545,509310,934.51,384,434910,1133,74400
2015-09-08,97 ( 0 %),726,876420,1207.19,340,670270,1971,206150
2015-09-07,97 ( -1.52 %),583,474220,813.41,362,710060,1961,-235840
2015-09-04,98.5 ( -0.51 %),567,395660,697.81,281,467410,1663,-71750
2015-09-03,99 ( -0.5 %),528,526420,997.01,471,676550,1436,-150130
2015-09-01,99.5 ( -0.5 %),461,609570,1322.28,448,713670,1593,-104100
2015-08-31,100 ( -0.99 %),479,753800,1573.7,773,930670,1204,-176870
2015-08-28,101 ( 1.51 %),620,993580,1602.55,744,981720,1320,11860
2015-08-27,99.5 ( -0.5 %),607,683480,1126,737,915030,1242,-231550
2015-08-26,100 ( 4.17 %),1066,1539410,1444.1,608,1040050,1711,499360
2015-08-25,96 ( 1.59 %),1847,2111860,1143.4,704,1511430,2147,600430
2015-08-24,94.5 ( -6.44 %),1610,1663700,1033.35,886,2171750,2451,-508050
2015-08-21,101 ( -0.98 %),1085,1267710,1168.4,667,1334400,2001,-66690
2015-08-20,102 ( -1.92 %),471,573040,1216.65,481,850910,1769,-277870
2015-08-19,104 ( 0.97 %),671,1118560,1667,498,831890,1670,286670
2015-08-18,103 ( 0 %),787,1175260,1493.34,607,1417190,2335,-241930
2015-08-17,103 ( -1.9 %),599,1080090,1803.16,605,958180,1584,121910
2015-08-14,105 ( 0 %),725,1078430,1487.49,825,1132330,1373,-53900
2015-08-13,105 ( 1.94 %),944,1715850,1817.64,695,1164130,1675,551720
2015-08-12,103 ( -1.9 %),979,1451730,1482.87,825,1493250,1810,-41520
2015-08-11,105 ( -1.87 %),833,968970,1163.23,994,1364390,1373,-395420
2015-08-10,107 ( 7 %),1308,1919350,1467.39,990,1456100,1471,463250
2015-08-07,100 ( 3.09 %),1050,1485860,1415.1,462,849660,1839,636200
2015-08-06,97 ( 1.04 %),987,1262110,1278.73,455,1098790,2415,163320
2015-08-05,96 ( 2.13 %),915,994860,1087.28,484,1167350,2412,-172490
2015-08-04,117 ( -1.68 %),656,930970,1419.16,510,1513140,2967,-582170
2015-08-03,119 ( -0.83 %),532,628110,1180.66,481,1010780,2101,-382670
2015-07-31,120 ( 0.84 %),540,1122960,2079.56,513,1610680,3140,-487720
2015-07-30,119 ( -1.65 %),430,644770,1499.47,403,865730,2148,-220960
2015-07-29,121 ( 0 %),337,468000,1388.72,458,739400,1614,-271400
2015-07-28,121 ( -0.82 %),446,1113740,2497.17,549,1012110,1844,101630
2015-07-27,122 ( 0 %),518,855590,1651.72,538,772930,1437,82660
2015-07-24,122 ( 0 %),543,1436590,2645.65,579,1071280,1850,365310
2015-07-23,122 ( 2.52 %),952,2407750,2529.15,1013,2140890,2113,266860
2015-07-22,119 ( 1.71 %),597,1369620,2294.17,471,790290,1678,579330
2015-07-21,117 ( 0.86 %),368,727730,1977.53,291,572000,1966,155730
2015-07-20,116 ( -0.85 %),430,618940,1439.4,295,569100,1929,49840
2015-07-17,117 ( 0 %),445,760140,1708.18,330,715890,2169,44250
2015-07-16,117 ( -0.85 %),421,637470,1514.18,444,1173100,2642,-535630
2015-07-15,118 ( 0 %),418,1016150,2430.98,531,803300,1513,212850
2015-07-14,118 ( 0.85 %),470,848620,1805.57,539,674830,1252,173790
2015-07-13,117 ( 1.74 %),517,760950,1471.86,526,850580,1617,-89630
2015-07-10,115 ( 0 %),352,431340,1225.4,364,562690,1546,-131350
2015-07-09,115 ( 0 %),400,567730,1419.32,339,529390,1562,38340
2015-07-08,115 ( -1.71 %),478,649580,1358.95,520,801180,1541,-151600
2015-07-07,117 ( 0.86 %),464,683000,1471.98,450,660160,1467,22840
2015-07-06,116 ( 0.87 %),617,1233460,1999.12,780,1249450,1602,-15990
2015-07-03,115 ( 0.88 %),394,565810,1436.07,412,484620,1176,81190
2015-07-02,114 ( 0 %),391,642820,1644.04,417,481250,1154,161570
2015-07-01,114 ( 0.88 %),443,1248170,2817.54,553,805180,1456,442990
2015-06-30,113 ( -0.88 %),485,846630,1745.63,453,733950,1620,112680
2015-06-29,114 ( 0 %),449,811870,1808.17,607,718650,1184,93220
2015-06-26,114 ( 2.7 %),622,1829810,2941.82,1102,2030160,1842,-200350
2015-06-25,111 ( 1.83 %),464,833690,1796.75,392,533960,1362,299730
2015-06-24,109 ( -1.8 %),405,715660,1767.06,404,593760,1470,121900
2015-06-23,111 ( -0.89 %),446,705840,1582.6,563,724150,1286,-18310
2015-06-22,112 ( 4.67 %),1068,2054720,1923.9,818,1395320,1706,659400
2015-06-19,107 ( 0.94 %),360,812250,2256.25,565,1230790,2178,-418540
2015-06-18,106 ( 0.95 %),198,331840,1675.96,250,561590,2246,-229750
2015-06-17,105 ( 0 %),252,299110,1186.94,225,398220,1770,-99110
2015-06-16,105 ( -0.94 %),214,211560,988.6,231,428370,1854,-216810
2015-06-15,106 ( 0 %),168,143750,855.65,197,370560,1881,-226810
2015-06-12,106 ( 0 %),242,184840,763.8,307,505190,1646,-320350
2015-06-11,108 ( 0.93 %),151,257630,1706.16,312,367890,1179,-110260
2015-06-10,107 ( 0 %),183,199460,1089.95,249,280990,1128,-81530
2015-06-09,107 ( -0.93 %),167,179240,1073.29,275,378230,1375,-198990
2015-06-08,108 ( 0.93 %),205,304200,1483.9,288,307320,1067,-3120
2015-06-05,107 ( 0 %),160,209310,1308.19,214,250300,1170,-40990
2015-06-04,107 ( 0.94 %),178,237280,1333.03,264,255780,969,-18500
2015-06-03,106 ( 0 %),237,274690,1159.03,252,269450,1069,5240
2015-06-02,106 ( 0 %),193,163320,846.22,196,249920,1275,-86600
2015-06-01,106 ( 0.95 %),289,305170,1055.95,248,312510,1260,-7340
2015-05-29,105 ( -0.94 %),207,172860,835.07,241,312650,1297,-139790
2015-05-28,106 ( 0 %),203,167680,826.01,201,267230,1330,-99550
2015-05-27,106 ( 0 %),212,170540,804.43,228,291090,1277,-120550
2015-05-26,106 ( 0 %),214,246440,1151.59,207,347210,1677,-100770
2015-05-25,106 ( -0.93 %),229,297570,1299.43,245,440650,1799,-143080
2015-05-22,107 ( 0.94 %),144,249270,1731.04,242,303970,1256,-54700
2015-05-21,106 ( -0.93 %),153,329530,2153.79,295,394950,1339,-65420
2015-05-20,107 ( 1.9 %),192,399540,2080.94,234,293670,1255,105870
2015-05-19,105 ( 0 %),188,129910,691.01,145,167200,1153,-37290
2015-05-18,105 ( 0 %),192,197630,1029.32,185,240310,1299,-42680
2015-05-15,105 ( 0 %),157,267260,1702.29,155,226760,1463,40500
2015-05-14,105 ( 0 %),145,193920,1337.38,175,266290,1522,-72370
2015-05-13,105 ( 0 %),170,191880,1128.71,157,233720,1489,-41840
2015-05-12,105 ( -0.94 %),149,216450,1452.68,167,294620,1764,-78170
2015-05-11,106 ( 0 %),154,163740,1063.25,185,285880,1545,-122140
2015-05-08,106 ( 0 %),160,246030,1537.69,165,261670,1586,-15640
2015-05-07,106 ( 0 %),202,365580,1809.8,206,265230,1288,100350
2015-05-06,106 ( 0 %),205,283160,1381.27,211,345220,1636,-62060
2015-05-05,106 ( 0 %),282,436820,1549.01,197,386620,1963,50200
2015-05-04,106 ( -1.85 %),215,245130,1140.14,252,436490,1732,-191360
2015-04-27,108 ( -0.92 %),153,160020,1045.88,252,325140,1290,-165120
2015-04-24,109 ( 0.93 %),152,349940,2302.24,314,497620,1585,-147680
2015-04-23,108 ( 0 %),134,210710,1572.46,265,247560,934,-36850
2015-04-22,108 ( 0 %),152,198940,1308.82,244,269880,1106,-70940
2015-04-21,108 ( 0 %),190,228440,1202.32,254,252040,992,-23600
2015-04-20,108 ( 0 %),198,236650,1195.2,305,357970,1174,-121320
2015-04-17,108 ( 0 %),214,299870,1401.26,265,320700,1210,-20830
2015-04-16,108 ( -0.92 %),179,199730,1115.81,282,363450,1289,-163720
2015-04-15,109 ( -0.91 %),200,284040,1420.2,389,476590,1225,-192550
2015-04-14,110 ( 0 %),264,529620,2006.14,532,601070,1130,-71450
2015-04-13,110 ( 1.85 %),321,635250,1978.97,515,570550,1108,64700
2015-04-10,108 ( 1.89 %),207,577120,2788.02,511,477850,935,99270
2015-04-09,106 ( 0 %),143,258040,1804.48,236,272570,1155,-14530
2015-04-08,106 ( 0 %),192,409000,2130.21,305,369410,1211,39590
2015-04-07,106 ( 1.92 %),189,341870,1808.84,230,251690,1094,90180
2015-04-06,104 ( -0.95 %),140,177810,1270.07,193,301430,1562,-123620
2015-04-03,105 ( -0.94 %),154,155600,1010.39,208,252440,1214,-96840
2015-04-02,106 ( 0.95 %),178,243940,1370.45,198,275630,1392,-31690
2015-04-01,105 ( -0.94 %),228,408860,1793.25,290,437810,1510,-28950
2015-03-31,106 ( 0.95 %),173,255010,1474.05,222,278050,1252,-23040
2015-03-30,105 ( 0 %),179,180240,1006.93,244,277990,1139,-97750
2015-03-27,105 ( -1.87 %),138,201880,1462.9,271,393110,1451,-191230
2015-03-26,107 ( 0 %),225,224760,998.93,261,344130,1319,-119370
2015-03-25,107 ( 0 %),151,203980,1350.86,245,305030,1245,-101050
2015-03-24,107 ( 0 %),178,262310,1473.65,258,263140,1020,-830
2015-03-23,107 ( 0 %),177,259310,1465.03,302,348940,1155,-89630
2015-03-20,107 ( -0.93 %),166,278220,1676.02,256,393320,1536,-115100
2015-03-19,108 ( -0.92 %),211,259840,1231.47,339,420180,1239,-160340
2015-03-18,109 ( 0 %),191,188250,985.6,317,397040,1252,-208790
2015-03-17,109 ( 0 %),164,232230,1416.04,342,385440,1127,-153210
2015-03-16,109 ( 0.93 %),222,475220,2140.63,372,465900,1252,9320
2015-03-13,108 ( -0.92 %),179,310290,1733.46,358,422460,1180,-112170
2015-03-12,109 ( 0.93 %),201,323150,1607.71,310,422370,1362,-99220
2015-03-11,108 ( 0 %),207,336520,1625.7,358,526250,1470,-189730
2015-03-10,108 ( 0.93 %),173,335810,1941.1,294,393560,1339,-57750
2015-03-09,107 ( 0 %),212,264810,1249.1,316,331880,1050,-67070
2015-03-06,107 ( -0.93 %),224,283530,1265.76,333,421070,1264,-137540
2015-03-05,108 ( -0.92 %),233,266440,1143.52,373,376730,1010,-110290
2015-03-04,109 ( 0.93 %),228,304420,1335.18,374,347890,930,-43470
2015-03-03,108 ( 0.93 %),284,351500,1237.68,275,319910,1163,31590
2015-03-02,107 ( -0.93 %),270,282240,1045.33,324,365250,1127,-83010
2015-02-27,108 ( 0 %),261,328010,1256.74,357,266580,747,61430
2015-02-26,108 ( -0.92 %),291,410690,1411.31,510,399700,784,10990
2015-02-25,109 ( 1.87 %),354,539320,1523.5,546,461780,846,77540
2015-02-24,107 ( 0.94 %),226,465490,2059.69,320,257720,805,207770
2015-02-13,106 ( 0.95 %),266,421370,1584.1,470,374490,797,46880
2015-02-12,105 ( 0 %),180,345530,1919.61,345,252670,732,92860
2015-02-11,105 ( 1.94 %),233,504640,2165.84,408,431130,1057,73510
2015-02-10,103 ( -0.96 %),188,216280,1150.43,362,318910,881,-102630
2015-02-09,104 ( 0.97 %),280,303390,1083.54,377,390150,1035,-86760
2015-02-06,103 ( 0 %),180,192730,1070.72,410,336510,821,-143780
2015-02-05,103 ( 0 %),274,464460,1695.11,486,483710,995,-19250
2015-02-04,103 ( 1.98 %),298,380200,1275.84,255,297740,1168,82460
2015-02-03,101 ( -1.94 %),298,374740,1257.52,309,444610,1439,-69870
2015-02-02,103 ( -0.96 %),225,294120,1307.2,432,408800,946,-114680
2015-01-30,104 ( -0.95 %),260,317230,1220.12,556,463520,834,-146290
2015-01-29,105 ( 3.96 %),476,851480,1788.82,791,760240,961,91240
2015-01-28,101 ( -0.98 %),248,230980,931.37,398,336150,845,-105170
2015-01-27,102 ( 2.51 %),401,609700,1520.45,673,529730,787,79970
2015-01-26,99.5 ( -0.5 %),253,307360,1214.86,283,288110,1018,19250
2015-01-23,100 ( 0.5 %),273,209830,768.61,274,255220,931,-45390
2015-01-22,99.5 ( -0.5 %),163,133520,819.14,262,187540,716,-54020
2015-01-21,100 ( 0 %),209,337600,1615.31,404,320840,794,16760
2015-01-20,100 ( 0.5 %),196,211760,1080.41,254,215500,848,-3740
2015-01-19,99.5 ( -0.5 %),256,203720,795.78,214,210470,984,-6750
2015-01-16,100 ( 0 %),208,129550,622.84,198,173020,874,-43470
2015-01-15,100 ( -0.99 %),278,208110,748.6,269,265550,987,-57440
2015-01-14,101 ( -0.98 %),222,212250,956.08,400,336210,841,-123960
2015-01-13,102 ( 2 %),247,273960,1109.15,300,226800,756,47160
2015-01-12,100 ( -2.91 %),277,247950,895.13,401,492660,1229,-244710
2015-01-09,103 ( 4.57 %),413,854160,2068.18,698,562090,805,292070
2015-01-08,98.5 ( 0.51 %),251,249540,994.18,273,169830,622,79710
2015-01-07,98 ( 2.08 %),334,421070,1260.69,370,291120,787,129950
2015-01-06,96 ( 0 %),245,212480,867.27,275,214530,780,-2050
2015-01-05,96 ( 0.52 %),203,174760,860.89,233,159700,685,15060
2014-12-31,95.5 ( 1.6 %),267,267330,1001.24,286,216180,756,51150
2014-12-30,94 ( 0 %),199,146850,737.94,163,120670,740,26180
2014-12-29,94 ( 0 %),223,181410,813.5,219,173250,791,8160
2014-12-26,94 ( -0.53 %),276,272560,987.54,270,285750,1058,-13190
2014-12-25,94.5 ( -0.53 %),201,161540,803.68,164,164060,1000,-2520
2014-12-24,95 ( -0.52 %),244,177680,728.2,243,298620,1229,-120940
2014-12-23,95.5 ( 2.14 %),468,627530,1340.88,593,587320,990,40210
2014-12-22,93.5 ( -0.53 %),306,161510,527.81,173,162880,942,-1370
2014-12-19,94 ( 0 %),365,216240,592.44,206,269220,1307,-52980
2014-12-18,94 ( 1.62 %),502,279760,557.29,223,180040,807,99720
2014-12-17,92.5 ( -5.13 %),452,443070,980.24,407,477940,1174,-34870
2014-12-16,97.5 ( -1.02 %),277,169070,610.36,279,206950,742,-37880
2014-12-15,98.5 ( -0.51 %),184,109630,595.82,169,151820,898,-42190
2014-12-12,99 ( 0 %),176,144200,819.32,179,154400,863,-10200
2014-12-11,99 ( 0 %),196,132310,675.05,168,107920,642,24390
2014-12-10,99 ( 0.51 %),257,152220,592.3,201,152260,758,-40
2014-12-09,98.5 ( -1.01 %),294,225710,767.72,318,260410,819,-34700
2014-12-08,99.5 ( 0 %),229,187550,819,267,176160,660,11390
2014-12-05,99.5 ( -1.49 %),229,148100,646.72,267,205850,771,-57750
2014-12-04,101 ( 1 %),247,211820,857.57,270,175590,650,36230
2014-12-03,100 ( 0.5 %),219,185600,847.49,203,148770,733,36830
2014-12-02,99.5 ( 0 %),215,155650,723.95,198,137370,694,18280
2014-12-01,99.5 ( 0.51 %),284,250650,882.57,213,137890,647,112760
2014-11-28,99 ( -0.5 %),374,284040,759.47,233,305380,1311,-21340
2014-11-27,99.5 ( -0.5 %),296,236580,799.26,244,274620,1125,-38040
2014-11-26,100 ( 0 %),345,219620,636.58,249,192620,774,27000
2014-11-25,100 ( 0 %),327,281060,859.51,222,225790,1017,55270
2014-11-24,100 ( -0.99 %),400,273720,684.3,278,242520,872,31200
2014-11-21,101 ( 0 %),336,179650,534.67,195,213340,1094,-33690
2014-11-20,101 ( 0 %),511,342660,670.57,191,216970,1136,125690
2014-11-19,101 ( -1.94 %),549,297720,542.3,290,392280,1353,-94560
2014-11-18,103 ( -0.96 %),359,251100,699.44,297,341950,1151,-90850
2014-11-17,104 ( 0 %),378,274080,725.08,330,396360,1201,-122280
2014-11-14,104 ( 0 %),375,302010,805.36,378,406900,1076,-104890
2014-11-13,104 ( 0 %),321,382550,1191.74,322,335760,1043,46790
2014-11-12,104 ( 0 %),309,226820,734.05,321,261380,814,-34560
2014-11-11,104 ( 0 %),350,373050,1065.86,336,298290,888,74760
2014-11-10,104 ( 0 %),348,303010,870.72,339,353200,1042,-50190
2014-11-07,104 ( 0 %),347,242130,697.78,326,324910,997,-82780
2014-11-06,104 ( 0 %),298,254350,853.52,298,259290,870,-4940
2014-11-05,104 ( -0.95 %),473,347950,735.62,349,399490,1145,-51540
2014-11-04,105 ( 0 %),230,296290,1288.22,423,373040,882,-76750
2014-11-03,105 ( 0 %),242,213520,882.31,375,318590,850,-105070
2014-10-31,105 ( 0.96 %),254,204220,804.02,302,207330,687,-3110
2014-10-30,104 ( 0 %),252,255870,1015.36,299,202360,677,53510
2014-10-29,104 ( 0.97 %),525,487680,928.91,283,418140,1478,69540
2014-10-28,103 ( -0.96 %),399,305000,764.41,260,288600,1110,16400
2014-10-27,104 ( -1.89 %),307,216490,705.18,368,456380,1240,-239890
2014-10-24,106 ( -0.93 %),347,228270,657.84,379,424860,1121,-196590
2014-10-23,107 ( 0 %),260,275120,1058.15,465,448450,964,-173330
2014-10-22,107 ( 0 %),302,227060,751.85,385,401440,1043,-174380
2014-10-21,107 ( 0.94 %),331,394240,1191.06,507,471840,931,-77600
2014-10-20,106 ( -0.93 %),327,228510,698.81,291,300270,1032,-71760
2014-10-17,107 ( 1.9 %),480,362900,756.04,334,316870,949,46030
2014-10-16,105 ( -0.94 %),493,494890,1003.83,531,647260,1219,-152370
2014-10-15,106 ( -1.85 %),473,364780,771.21,412,576900,1400,-212120
2014-10-14,108 ( -0.92 %),264,354170,1341.55,477,563550,1181,-209380
2014-10-13,109 ( -0.91 %),266,276420,1039.17,467,550280,1178,-273860
2014-10-10,110 ( 0 %),257,248610,967.35,533,594150,1115,-345540
2014-10-09,110 ( 0 %),388,419990,1082.45,872,720390,826,-300400
2014-10-08,110 ( 3.77 %),557,843420,1514.22,742,819790,1105,23630
2014-10-07,106 ( -0.93 %),425,324720,764.05,359,296360,826,28360
2014-10-06,107 ( 0 %),630,539530,856.4,398,452000,1136,87530
2014-10-03,107 ( -0.93 %),466,368040,789.79,509,516560,1015,-148520
2014-10-02,108 ( 0.93 %),379,393050,1037.07,439,310580,707,82470
2014-10-01,107 ( 1.9 %),511,579820,1134.68,484,296700,613,283120
2014-09-30,105 ( 0 %),620,474440,765.23,471,337030,716,137410
2014-09-29,105 ( -0.94 %),360,241010,669.47,334,286040,856,-45030
2014-09-26,106 ( 0 %),398,276040,693.57,309,304360,985,-28320
2014-09-25,106 ( 0 %),495,330940,668.57,343,300090,875,30850
2014-09-24,106 ( -1.85 %),332,185530,558.83,374,356240,953,-170710
2014-09-23,108 ( 0 %),438,334770,764.32,399,473860,1188,-139090
2014-09-22,108 ( 1.89 %),515,512640,995.42,461,409760,889,102880
2014-09-19,106 ( -0.93 %),461,341520,740.82,271,267850,988,73670
2014-09-18,107 ( 0 %),515,401430,779.48,327,435750,1333,-34320
2014-09-17,107 ( -0.93 %),441,209990,476.17,411,391540,953,-181550
2014-09-16,108 ( 0 %),0,0,0,0,0,0,0
2014-09-15,108 ( -0.92 %),557,487240,874.76,508,683920,1346,-196680
2014-09-12,109 ( 0 %),469,265440,565.97,377,384890,1021,-119450
2014-09-11,109 ( 0 %),452,251880,557.26,344,447290,1300,-195410
2014-09-10,109 ( -0.91 %),599,497970,831.34,417,636470,1526,-138500
2014-09-09,110 ( -0.9 %),877,510330,581.9,542,910280,1679,-399950
2014-09-08,111 ( 0 %),602,397940,661.03,419,534260,1275,-136320
2014-09-05,111 ( 0 %),672,417820,621.76,372,527220,1417,-109400
2014-09-04,111 ( -0.89 %),490,263110,536.96,361,364340,1009,-101230
2014-09-03,112 ( 0.9 %),589,413480,702,460,421350,916,-7870
2014-08-29,111 ( 0 %),656,415320,633.11,393,417160,1061,-1840
2014-08-28,111 ( -0.89 %),609,319350,524.38,475,626100,1318,-306750
2014-08-27,112 ( 0 %),490,329150,671.73,361,469590,1301,-140440
2014-08-26,112 ( 0 %),570,443720,778.46,467,615670,1318,-171950
2014-08-25,112 ( -0.88 %),749,639000,853.14,512,1065420,2081,-426420
2014-08-22,113 ( 0 %),661,547220,827.87,418,904320,2163,-357100
2014-08-21,113 ( 0.89 %),853,452800,530.83,422,674360,1598,-221560
2014-08-20,112 ( -1.75 %),886,425490,480.24,453,936680,2068,-511190
2014-08-19,114 ( -0.87 %),758,445750,588.06,506,989790,1956,-544040
2014-08-18,115 ( -0.86 %),695,435240,626.24,567,928220,1637,-492980
2014-08-15,116 ( 0 %),699,510900,730.9,317,598540,1888,-87640
2014-08-14,116 ( 1.75 %),1001,918020,917.1,347,710570,2048,207450
2014-08-13,114 ( -16.79 %),1773,1338870,755.14,589,1696120,2880,-357250
2014-08-12,137 ( -0.72 %),593,483660,815.62,512,915150,1787,-431490
2014-08-11,138 ( -1.43 %),0,0,0,0,0,0,0
2014-08-08,140 ( 0 %),386,552360,1430.98,530,673800,1271,-121440
2014-08-07,140 ( 1.45 %),391,635650,1625.7,483,474960,983,160690
2014-08-06,138 ( 0.73 %),294,299950,1020.24,362,296060,818,3890
2014-08-05,137 ( 0 %),329,323600,983.59,425,395010,929,-71410
2014-08-04,137 ( 1.48 %),389,443190,1139.31,346,377700,1092,65490
2014-08-01,135 ( -0.74 %),418,301520,721.34,271,366420,1352,-64900
2014-07-31,136 ( 0.74 %),333,287670,863.87,289,318430,1102,-30760
2014-07-30,135 ( -0.74 %),316,288830,914.02,282,386580,1371,-97750
2014-07-29,136 ( 0.74 %),0,0,0,0,0,0,0
2014-07-28,135 ( -0.74 %),460,406870,884.5,433,514110,1187,-107240
2014-07-25,136 ( -0.73 %),368,376760,1023.8,400,395210,988,-18450
2014-07-24,137 ( 0.74 %),396,454260,1147.12,439,445050,1014,9210
2014-07-23,136 ( -0.73 %),497,550350,1107.34,462,635110,1375,-84760
2014-07-22,137 ( -1.44 %),450,428370,951.93,732,613320,838,-184950
2014-07-21,139 ( 4.51 %),910,1481110,1627.59,1041,1203520,1156,277590
2014-07-18,133 ( 3.1 %),527,957450,1816.79,762,766810,1006,190640
2014-07-17,129 ( 0 %),261,247700,949.04,309,331250,1072,-83550
2014-07-16,129 ( 0 %),316,358890,1135.73,431,446380,1036,-87490
2014-07-15,129 ( 0.78 %),269,304180,1130.78,361,309400,857,-5220
2014-07-14,128 ( 0.79 %),319,342360,1073.23,251,344740,1373,-2380
2014-07-11,127 ( 0 %),312,272750,874.2,324,239580,739,33170
2014-07-10,127 ( -0.78 %),416,475620,1143.32,407,400190,983,75430
2014-07-09,128 ( -0.78 %),408,395910,970.37,399,487860,1223,-91950
2014-07-08,129 ( 0 %),376,397690,1057.69,546,522430,957,-124740
2014-07-07,129 ( -0.77 %),370,448340,1211.73,579,428210,740,20130
2014-07-04,130 ( 2.36 %),589,951760,1615.89,759,723660,953,228100
2014-07-03,127 ( 1.6 %),331,535500,1617.82,470,312610,665,222890
2014-07-02,125 ( 2.46 %),540,615870,1140.5,532,459640,864,156230
2014-07-01,122 ( 0 %),294,269040,915.1,297,268910,905,130
2014-06-30,122 ( 0 %),291,222500,764.6,248,203710,821,18790
2014-06-27,122 ( -0.81 %),230,158330,688.39,297,258390,870,-100060
2014-06-25,122 ( 0.83 %),300,371660,1238.87,316,258960,819,112700
2014-06-24,121 ( 0 %),215,150590,700.42,196,200160,1021,-49570
2014-06-23,121 ( 0 %),257,219970,855.91,230,203170,883,16800
2014-06-20,121 ( 0 %),307,235970,768.63,216,234210,1084,1760
2014-06-19,0 ( 0 %),338,370360,1095.74,266,275920,1037,94440
2014-06-18,122 ( 0 %),336,328130,976.58,274,252960,923,75170
2014-06-17,122 ( 0 %),365,363120,994.85,299,367590,1229,-4470
2014-06-16,122 ( 0 %),259,210430,812.47,245,209510,855,920
2014-06-13,122 ( -0.81 %),311,284700,915.43,320,333620,1043,-48920
2014-06-12,123 ( 0.82 %),326,297510,912.61,268,242260,904,55250
2014-06-11,122 ( 0 %),525,457630,871.68,273,435450,1595,22180
2014-06-10,122 ( -1.61 %),329,314990,957.42,273,402050,1473,-87060
2014-06-09,124 ( 0 %),380,333430,877.45,312,412850,1323,-79420
2014-06-06,124 ( 0 %),201,132190,657.66,231,212760,921,-80570
2014-06-05,124 ( 0 %),294,247040,840.27,256,317240,1239,-70200
2014-06-04,124 ( 0 %),378,418440,1106.98,391,396130,1013,22310
2014-06-03,124 ( 0 %),324,373310,1152.19,316,268280,849,105030
2014-06-02,124 ( 0.81 %),449,521630,1161.76,378,405310,1072,116320
2014-05-30,123 ( 0 %),436,394780,905.46,338,323480,957,71300
2014-05-29,123 ( 0 %),536,251730,469.65,315,271450,862,-19720
2014-05-28,123 ( -0.81 %),543,338230,622.89,309,307870,996,30360
2014-05-27,124 ( 0.81 %),601,394160,655.84,274,349890,1277,44270
2014-05-26,123 ( -1.6 %),544,278690,512.3,248,303790,1225,-25100
2014-05-23,125 ( -0.79 %),316,205910,651.61,389,272300,700,-66390
2014-05-22,126 ( 0.8 %),565,513860,909.49,555,503190,907,10670
2014-05-21,125 ( 1.63 %),493,356040,722.19,348,283960,816,72080
2014-05-20,123 ( 0.82 %),493,441280,895.09,395,392520,994,48760
2014-05-19,122 ( 0.83 %),539,413630,767.4,370,412570,1115,1060
2014-05-16,121 ( 0.83 %),585,485100,829.23,386,557770,1445,-72670
2014-05-15,120 ( -3.23 %),698,512170,733.77,463,690020,1490,-177850
2014-05-14,124 ( 2.48 %),910,618420,679.58,394,510330,1295,108090
2014-05-13,121 ( -0.82 %),727,483870,665.57,499,646400,1295,-162530
2014-05-12,124 ( -4.62 %),1092,822980,753.64,605,806170,1333,16810
2014-05-09,130 ( 4 %),1087,835940,769.03,522,617210,1182,218730
2014-05-08,125 ( -6.72 %),1403,1042620,743.14,816,1438890,1763,-396270
2014-05-07,134 ( 0.75 %),441,314000,712.02,271,248720,918,65280
2014-05-06,133 ( -2.92 %),823,456610,554.81,482,649610,1348,-193000
2014-05-05,137 ( -1.44 %),539,366580,680.11,411,632600,1539,-266020
2014-04-29,139 ( 0 %),323,304440,942.54,235,306320,1303,-1880
2014-04-28,139 ( -1.42 %),400,272170,680.42,318,617120,1941,-344950
2014-04-25,141 ( 1.44 %),392,438390,1118.34,357,478970,1342,-40580
2014-04-24,139 ( 0 %),434,440570,1015.14,303,374080,1235,66490
2014-04-23,139 ( -0.71 %),314,312320,994.65,246,377860,1536,-65540
2014-04-22,140 ( 0.72 %),439,564760,1286.47,240,441620,1840,123140
2014-04-21,139 ( -0.71 %),426,565880,1328.36,317,502250,1584,63630
2014-04-18,140 ( -0.71 %),441,436230,989.18,322,575970,1789,-139740
2014-04-17,141 ( 0 %),623,531810,853.63,360,437780,1216,94030
2014-04-16,141 ( 0 %),631,553810,877.67,402,567470,1412,-13660
2014-04-15,141 ( -0.7 %),605,677470,1119.79,350,545400,1558,132070
2014-04-14,142 ( -0.7 %),668,720420,1078.47,345,692060,2006,28360
2014-04-11,143 ( -0.69 %),689,759960,1102.99,348,462060,1328,297900
2014-04-10,144 ( -2.04 %),678,572990,845.12,539,1138430,2112,-565440
2014-04-08,147 ( -0.68 %),462,547630,1185.35,678,997270,1471,-449640
2014-04-07,148 ( 2.07 %),1286,1471010,1143.86,1069,1943770,1818,-472760
2014-04-04,145 ( 0.69 %),412,839380,2037.33,599,776960,1297,62420
2014-04-03,144 ( 2.13 %),379,865190,2282.82,533,666740,1251,198450
2014-04-02,141 ( 0 %),452,451790,999.54,376,536730,1427,-84940
2014-04-01,141 ( 0 %),448,552090,1232.34,376,489550,1302,62540
2014-03-31,141 ( 0 %),406,583180,1436.4,331,482040,1456,101140
2014-03-28,141 ( 0.71 %),530,628710,1186.25,278,479090,1723,149620
2014-03-27,140 ( 0 %),734,751200,1023.43,319,652790,2046,98410
2014-03-26,140 ( -1.41 %),777,731620,941.6,396,1064040,2687,-332420
2014-03-25,142 ( -0.7 %),635,680460,1071.59,402,790690,1967,-110230
2014-03-24,143 ( -0.69 %),629,733630,1166.34,434,1016840,2343,-283210
2014-03-21,144 ( 0.7 %),737,797810,1082.51,332,552020,1663,245790
2014-03-20,143 ( -2.05 %),851,773610,909.06,505,865750,1714,-92140
2014-03-19,146 ( -0.68 %),695,566560,815.19,451,685980,1521,-119420
2014-03-18,147 ( -0.68 %),732,876730,1197.72,512,831530,1624,45200
2014-03-17,148 ( -1.33 %),529,708020,1338.41,662,1024470,1548,-316450
2014-03-14,150 ( 2.74 %),920,1595390,1734.12,1381,1779480,1289,-184090
2014-03-13,146 ( 3.55 %),876,2038980,2327.6,1522,1670540,1098,368440
2014-03-12,141 ( 0.71 %),575,1880100,3269.74,998,1225980,1228,654120
2014-03-11,140 ( 0 %),510,566790,1111.35,479,770350,1608,-203560
2014-03-10,140 ( 0.72 %),379,437060,1153.19,418,485700,1162,-48640
2014-03-07,139 ( 0 %),411,325640,792.31,367,454620,1239,-128980
2014-03-06,139 ( 0 %),324,373310,1152.19,316,268280,849,105030
2014-03-05,139 ( 0 %),457,379720,830.9,396,465220,1175,-85500
2014-03-04,139 ( -1.42 %),544,569500,1046.88,422,614030,1455,-44530
2014-03-03,141 ( 0 %),368,338240,919.13,434,454910,1048,-116670
2014-02-28,141 ( -0.7 %),350,733270,2095.06,615,647330,1053,85940
2014-02-27,142 ( 2.16 %),1316,2700810,2052.29,1382,1954270,1414,746540
2014-02-26,139 ( 0 %),527,565050,1072.2,382,463020,1212,102030
2014-02-25,139 ( 0 %),540,709820,1314.48,434,670020,1544,39800
2014-02-24,139 ( 0.72 %),453,392120,865.61,372,534020,1436,-141900
2014-02-21,138 ( 0 %),518,965960,1864.79,436,594440,1363,371520
2014-02-20,138 ( -0.72 %),675,515760,764.09,535,871770,1629,-356010
2014-02-19,139 ( -0.71 %),495,535930,1082.69,453,669250,1477,-133320
2014-02-18,140 ( 0 %),448,430420,960.76,425,572990,1348,-142570
2014-02-17,140 ( 0 %),433,358410,827.74,398,501330,1260,-142920
2014-02-14,140 ( 0.72 %),475,722690,1521.45,599,785560,1311,-62870
2014-02-13,139 ( -0.71 %),451,322360,714.77,379,522970,1380,-200610
2014-02-12,140 ( 0.72 %),376,244340,649.84,278,285010,1025,-40670
2014-02-11,139 ( -0.71 %),580,440750,759.91,300,563650,1879,-122900
2014-02-10,140 ( 0 %),533,372780,699.4,316,513360,1625,-140580
2014-02-07,140 ( 0 %),452,352170,779.14,315,582170,1848,-230000
2014-02-06,140 ( -0.71 %),295,320500,1086.44,296,376740,1273,-56240
2014-01-27,141 ( -0.7 %),265,264280,997.28,281,386590,1376,-122310
2014-01-24,142 ( 0.71 %),219,483380,2207.21,578,586860,1015,-103480
2014-01-23,141 ( 0.71 %),205,298060,1453.95,376,388200,1032,-90140
2014-01-22,140 ( -0.71 %),341,464220,1361.35,522,751270,1439,-287050
2014-01-21,141 ( -0.7 %),263,261070,992.66,547,452420,827,-191350
2014-01-20,142 ( 2.16 %),510,1390650,2726.76,927,1192500,1286,198150
2014-01-17,139 ( 1.46 %),620,1666620,2688.1,774,980670,1267,685950
2014-01-16,137 ( -0.72 %),308,566210,1838.34,331,301440,911,264770
2014-01-15,138 ( 0.73 %),296,365300,1234.12,338,356870,1056,8430
2014-01-14,137 ( 0 %),256,765450,2990.04,306,275350,900,490100
2014-01-13,137 ( -0.72 %),258,522180,2023.95,316,242650,768,279530
2014-01-10,138 ( 1.47 %),448,1288600,2876.34,536,463110,864,825490
2014-01-09,136 ( 0 %),291,355540,1221.79,218,179910,825,175630
2014-01-08,136 ( 0.74 %),277,401490,1449.42,188,163190,868,238300
2014-01-07,135 ( -0.74 %),300,404930,1349.77,252,257440,1022,147490
2014-01-06,136 ( 0 %),328,382300,1165.55,251,245640,979,136660
2014-01-03,136 ( 0.74 %),253,365060,1442.92,203,166180,819,198880
2014-01-02,135 ( 0 %),327,392830,1201.31,221,184330,834,208500
2013-12-31,135 ( 0 %),483,549030,1136.71,210,375950,1790,173080
2013-12-30,135 ( -0.74 %),389,398410,1024.19,250,342540,1370,55870
2013-12-27,136 ( 0.74 %),470,502770,1069.72,199,228460,1148,274310
2013-12-26,135 ( -0.74 %),642,537720,837.57,253,545760,2157,-8040
2013-12-25,136 ( -0.73 %),671,591720,881.85,249,722940,2903,-131220
2013-12-24,137 ( -0.72 %),327,150670,460.76,280,627750,2242,-477080
2013-12-23,138 ( -0.72 %),399,190490,477.42,312,398460,1277,-207970
2013-12-20,139 ( 0 %),277,174740,630.83,289,290870,1006,-116130
2013-12-19,139 ( 0.72 %),347,212530,612.48,264,325190,1232,-112660
2013-12-18,138 ( -0.72 %),299,186420,623.48,296,450940,1523,-264520
2013-12-17,139 ( 0 %),292,208590,714.35,304,342850,1128,-134260
2013-12-16,139 ( -0.14 %),199,135220,679.5,288,303040,1052,-167820
2013-12-13,140 ( 0 %),292,195190,668.46,321,354890,1106,-159700
2013-12-12,140 ( -0.71 %),296,173650,586.66,367,439840,1198,-266190
2013-12-11,141 ( 0.71 %),297,361280,1216.43,280,391520,1398,-30240
2013-12-10,140 ( 0.72 %),479,329530,687.95,313,386130,1234,-56600
2013-12-09,139 ( -1.42 %),636,410270,645.08,460,704860,1532,-294590
2013-12-06,141 ( -0.7 %),353,200330,567.51,260,287030,1104,-86700
2013-12-05,142 ( 0.71 %),451,448410,994.26,238,399130,1677,49280
2013-12-04,141 ( -0.7 %),313,352700,1126.84,268,499700,1865,-147000
2013-12-03,142 ( 0.71 %),501,646570,1290.56,377,643240,1706,3330
2013-12-02,141 ( -0.7 %),379,356040,939.42,217,390790,1801,-34750
2013-11-29,142 ( 0 %),606,573800,946.86,317,676220,2133,-102420
2013-11-28,142 ( -1.39 %),465,451880,971.78,296,669390,2261,-217510
2013-11-27,144 ( 0 %),417,863310,2070.29,657,742450,1130,120860
2013-11-26,144 ( 2.13 %),730,1745060,2390.49,1031,1266590,1229,478470
2013-11-25,141 ( 0 %),273,186590,683.48,324,511250,1578,-324660
2013-11-22,141 ( 0 %),302,289100,957.28,306,470680,1538,-181580
2013-11-21,141 ( 0 %),350,402830,1150.94,452,621090,1374,-218260
2013-11-20,141 ( -0.7 %),203,260520,1283.35,365,441660,1210,-181140
2013-11-19,142 ( 0 %),173,306000,1768.79,461,575180,1248,-269180
2013-11-18,142 ( 0.71 %),207,313950,1516.67,415,428720,1033,-114770
2013-11-15,141 ( 1.44 %),356,973700,2735.11,639,769200,1204,204500
2013-11-14,139 ( 0 %),227,232750,1025.33,280,345100,1232,-112350
2013-11-13,139 ( 0 %),274,192530,702.66,244,375260,1538,-182730
2013-11-12,139 ( 0 %),396,231780,585.3,326,466650,1431,-234870
2013-11-11,139 ( 0 %),361,170460,472.19,296,439980,1486,-269520
2013-11-08,139 ( -0.71 %),302,396100,1311.59,248,451300,1820,-55200
2013-11-07,140 ( -0.71 %),322,242990,754.63,318,468870,1474,-225880
2013-11-06,141 ( 0 %),275,302810,1101.13,343,491970,1434,-189160
2013-11-05,141 ( 0.71 %),218,250090,1147.2,281,269550,959,-19460
2013-11-04,140 ( 0 %),232,179370,773.15,294,282990,963,-103620
2013-11-01,140 ( 0 %),280,231210,825.75,279,323850,1161,-92640
2013-10-31,140 ( -0.71 %),232,219080,944.31,279,343520,1231,-124440
2013-10-30,141 ( 0 %),268,236250,881.53,244,256360,1051,-20110
2013-10-29,141 ( 0 %),400,470590,1176.47,417,623350,1495,-152760
2013-10-28,141 ( -0.7 %),244,238670,978.16,349,336690,965,-98020
2013-10-25,142 ( 0 %),276,362900,1314.86,475,602670,1269,-239770
2013-10-24,142 ( 0.71 %),447,817650,1829.19,842,984630,1169,-166980
2013-10-23,141 ( 0 %),239,313440,1311.46,346,393450,1137,-80010
2013-10-22,141 ( -0.7 %),282,339850,1205.14,310,323560,1044,16290
2013-10-21,142 ( 0 %),253,259190,1024.47,379,276000,728,-16810
2013-10-18,142 ( 0.71 %),262,312450,1192.56,356,506880,1424,-194430
2013-10-17,141 ( -0.7 %),237,271970,1147.55,472,524170,1111,-252200
2013-10-16,142 ( 0 %),295,341120,1156.34,407,444770,1093,-103650
2013-10-15,142 ( 0.71 %),296,433310,1463.89,443,464490,1049,-31180
2013-10-14,141 ( 0.71 %),356,417940,1173.99,369,364830,989,53110
2013-10-11,140 ( 0 %),358,831060,2321.4,436,499620,1146,331440
2013-10-10,140 ( -1.41 %),391,540180,1381.53,494,442910,897,97270
2013-10-09,142 ( 1.43 %),594,877750,1477.69,721,712690,988,165060
2013-10-08,140 ( 0 %),351,319610,910.57,379,462560,1220,-142950
2013-10-07,140 ( 0 %),355,353290,995.18,442,399950,905,-46660
2013-10-04,140 ( 0.72 %),338,308690,913.28,361,353400,979,-44710
2013-10-03,139 ( -0.71 %),263,302290,1149.39,387,401680,1038,-99390
2013-10-02,140 ( 0.72 %),328,309120,942.44,456,440160,965,-131040
2013-10-01,139 ( -1.42 %),314,332800,1059.87,564,523240,928,-190440
2013-09-30,141 ( 0.71 %),313,400450,1279.39,454,319030,703,81420
2013-09-27,140 ( 0.72 %),298,215360,722.68,402,327360,814,-112000
2013-09-26,139 ( -0.71 %),372,270220,726.4,576,446890,776,-176670
2013-09-25,140 ( 1.45 %),440,693930,1577.11,682,614020,900,79910
2013-09-24,138 ( 0.73 %),358,331380,925.64,340,322860,950,8520
2013-09-23,137 ( -0.72 %),398,355780,893.92,386,398070,1031,-42290
2013-09-20,138 ( 0.73 %),301,215100,714.62,265,238340,899,-23240
2013-09-19,137 ( 0.74 %),306,223840,731.5,350,268000,766,-44160
2013-09-18,136 ( -0.73 %),335,268030,800.09,401,335460,837,-67430
2013-09-17,137 ( 0 %),386,283540,734.56,366,289410,791,-5870
2013-09-16,137 ( -0.72 %),373,316600,848.79,381,345490,907,-28890
2013-09-13,138 ( 0.73 %),444,289740,652.57,363,323760,892,-34020
2013-09-12,137 ( -0.72 %),372,266790,717.18,386,404650,1048,-137860
2013-09-11,138 ( 0 %),420,370990,883.31,522,505070,968,-134080
2013-09-10,138 ( 1.47 %),487,424400,871.46,456,462660,1015,-38260
2013-09-09,136 ( -2.16 %),682,502950,737.46,717,779850,1088,-276900
2013-09-06,139 ( 0 %),606,1121370,1850.45,1215,1884490,1551,-763120
2013-09-05,139 ( 2.21 %),742,1392360,1876.5,1237,1561530,1262,-169170
2013-09-04,136 ( 2.26 %),951,1171580,1231.95,1267,1262910,997,-91330
2013-09-03,133 ( 2.31 %),793,740050,933.23,643,605370,941,134680
2013-08-30,130 ( -1.52 %),1965,2125390,1081.62,971,1993150,2053,132240
2013-08-29,132 ( -0.75 %),1255,1332700,1061.91,696,1278750,1837,53950
2013-08-28,133 ( -4.32 %),1113,1114180,1001.06,937,1603110,1711,-488930
2013-08-27,139 ( -0.71 %),785,981740,1250.62,555,927750,1672,53990
2013-08-26,140 ( 2.94 %),1750,1828540,1044.88,850,1393220,1639,435320
2013-08-23,136 ( -4.9 %),2554,2326040,910.74,1158,2878230,2486,-552190
2013-08-22,143 ( -2.05 %),809,914120,1129.94,525,934240,1780,-20120
2013-08-21,146 ( 0 %),794,746140,939.72,439,591460,1347,154680
2013-08-20,146 ( -1.35 %),1157,1111810,960.94,672,1382370,2057,-270560
2013-08-19,150 ( 0 %),853,1344620,1576.34,493,965070,1958,379550
2013-08-16,150 ( -0.66 %),722,781430,1082.31,597,899300,1506,-117870
2013-08-15,151 ( 1.34 %),570,814050,1428.16,453,520830,1150,293220
2013-08-14,149 ( 1.36 %),586,948200,1618.09,410,396530,967,551670
2013-08-13,147 ( 1.38 %),472,843830,1787.78,387,478390,1236,365440
2013-08-12,145 ( 0 %),402,494190,1229.33,320,399370,1248,94820
2013-08-09,145 ( 0 %),479,559350,1167.75,340,475490,1398,83860
2013-08-08,145 ( 0 %),518,605760,1169.42,304,472240,1553,133520
2013-08-07,145 ( -0.68 %),701,873460,1246.02,345,722520,2094,150940
2013-08-06,146 ( 1.39 %),767,948080,1236.09,473,599330,1267,348750
2013-08-05,144 ( -1.37 %),686,789420,1150.76,500,886130,1772,-96710
2013-08-02,146 ( 0.69 %),463,673630,1454.92,386,572260,1483,101370
2013-08-01,145 ( 0 %),615,774410,1259.2,395,480780,1217,293630
2013-07-31,145 ( 2.11 %),614,734620,1196.45,372,586100,1576,148520
2013-07-30,142 ( 0.71 %),720,623020,865.31,366,812840,2221,-189820
2013-07-29,141 ( -2.08 %),591,535250,905.67,506,942680,1863,-407430
2013-07-26,144 ( 0.7 %),490,464150,947.24,347,514370,1482,-50220
2013-07-25,143 ( 0.7 %),698,764990,1095.97,396,586280,1481,178710
2013-07-24,142 ( -2.07 %),805,726560,902.56,534,954270,1787,-227710
2013-07-23,145 ( 0 %),618,1060560,1716.12,685,911650,1331,148910
2013-07-22,145 ( 0.69 %),486,751490,1546.28,465,541900,1165,209590
2013-07-19,144 ( 2.86 %),605,1284360,2122.91,653,794920,1217,489440
2013-07-18,140 ( 0 %),477,925800,1940.88,480,572120,1192,353680
2013-07-17,140 ( 0.72 %),418,678530,1623.28,613,808420,1319,-129890
2013-07-16,139 ( 1.46 %),679,1358500,2000.74,904,1107790,1225,250710
2013-07-15,137 ( 0 %),393,491450,1250.51,455,428990,943,62460
2013-07-12,137 ( 0.74 %),479,464730,970.21,417,377100,904,87630
2013-07-11,136 ( 0 %),367,362970,989.02,431,651730,1512,-288760
2013-07-10,136 ( 0 %),359,491360,1368.69,594,613300,1032,-121940
2013-07-09,136 ( 1.49 %),384,622670,1621.54,531,560890,1056,61780
2013-07-08,134 ( 0 %),377,538180,1427.53,385,418300,1086,119880
2013-07-05,134 ( 0 %),407,327680,805.11,312,346010,1109,-18330
2013-07-04,134 ( 0 %),400,362880,907.2,333,487320,1463,-124440
2013-07-03,134 ( -0.74 %),418,444890,1064.33,435,622790,1432,-177900
2013-07-02,135 ( 3.05 %),621,906610,1459.92,597,710700,1190,195910
2013-07-01,131 ( -0.76 %),417,359000,860.91,266,328770,1236,30230
2013-06-28,132 ( 0 %),311,305420,982.06,323,394600,1222,-89180
2013-06-27,132 ( 1.54 %),493,547190,1109.92,293,396000,1352,151190
2013-06-26,130 ( 0 %),592,750110,1267.08,354,583840,1649,166270
2013-06-25,130 ( -2.99 %),937,853250,910.62,566,975640,1724,-122390
2013-06-24,134 ( 0 %),464,432240,931.55,311,487490,1567,-55250
2013-06-21,134 ( 0 %),406,398160,980.69,291,438380,1506,-40220
2013-06-20,134 ( -0.74 %),402,351390,874.1,305,418890,1373,-67500
2013-06-19,135 ( 1.5 %),433,464060,1071.73,335,320990,958,143070
2013-06-18,133 ( 0.76 %),500,445780,891.56,290,328550,1133,117230
2013-06-17,132 ( -3.65 %),719,569370,791.89,433,833360,1925,-263990
2013-06-14,137 ( 0.74 %),432,435770,1008.73,300,350120,1167,85650
2013-06-13,138 ( -0.72 %),581,590810,1016.88,342,622200,1819,-31390
2013-06-12,139 ( -0.71 %),326,329440,1010.55,357,374400,1049,-44960
2013-06-11,140 ( 1.45 %),455,668690,1469.65,490,576440,1176,92250
2013-06-10,138 ( 1.47 %),479,784260,1637.29,598,616130,1030,168130
2013-06-07,136 ( 0.74 %),342,435570,1273.6,495,468760,947,-33190
2013-06-06,135 ( 0.75 %),363,487270,1342.34,329,365130,1110,122140
2013-06-05,134 ( 1.52 %),496,613890,1237.68,350,475230,1358,138660
2013-06-04,132 ( -0.75 %),392,368000,938.78,319,442630,1388,-74630
2013-06-03,133 ( -0.75 %),416,308590,741.8,342,464410,1358,-155820
2013-05-31,134 ( 0 %),451,526320,1167.01,447,590370,1321,-64050
2013-05-30,134 ( 0.75 %),512,498930,974.47,368,412770,1122,86160
2013-05-29,133 ( -1.48 %),628,536580,854.43,474,623160,1315,-86580
2013-05-28,135 ( 0.75 %),577,658630,1141.47,428,461580,1078,197050
2013-05-27,134 ( 2.29 %),678,981130,1447.09,705,794670,1127,186460
2013-05-24,131 ( 0.77 %),490,876580,1788.94,680,682140,1003,194440
2013-05-23,130 ( 0 %),442,542590,1227.58,702,595700,849,-53110
2013-05-22,130 ( 1.56 %),393,582340,1481.78,652,622140,954,-39800
2013-05-21,128 ( 1.59 %),765,1132330,1480.17,958,1274770,1331,-142440
2013-05-20,126 ( 0.8 %),447,571450,1278.41,394,464730,1180,106720
2013-05-17,125 ( 0 %),369,452570,1226.48,446,481630,1080,-29060
2013-05-16,125 ( 0.81 %),361,430290,1191.94,300,391500,1305,38790
2013-05-15,124 ( 0 %),318,430660,1354.28,261,368730,1413,61930
2013-05-14,124 ( 0 %),492,502500,1021.34,304,447320,1471,55180
2013-05-13,124 ( 0 %),338,238570,705.83,262,319520,1220,-80950
2013-05-10,124 ( 0 %),378,392820,1039.21,434,553770,1276,-160950
2013-05-09,124 ( 0 %),347,261430,753.4,284,358830,1263,-97400
2013-05-08,124 ( 0 %),269,197080,732.64,315,358670,1139,-161590
2013-05-07,124 ( -0.8 %),380,406120,1068.74,536,539040,1006,-132920
2013-05-06,125 ( 1.63 %),324,472870,1459.48,443,398560,900,74310
2013-05-03,123 ( 0.82 %),495,347510,702.04,246,432850,1760,-85340
2013-05-02,122 ( -1.61 %),643,476740,741.43,400,940000,2350,-463260
2013-04-26,124 ( -1.59 %),588,532130,904.98,673,1188550,1766,-656420
2013-04-25,126 ( 0.8 %),401,372790,929.65,410,603940,1473,-231150
2013-04-24,125 ( 0 %),318,221580,696.79,408,448800,1100,-227220
2013-04-23,125 ( 2.46 %),615,799190,1299.5,533,558250,1047,240940
2013-04-22,122 ( -0.81 %),459,443960,967.23,391,454040,1161,-10080
2013-04-18,123 ( -0.81 %),604,825220,1366.26,514,601680,1171,223540
2013-04-17,124 ( 2.48 %),704,729370,1036.04,528,502820,952,226550
2013-04-16,121 ( 0.83 %),1371,1450140,1057.72,778,983850,1265,466290
2013-04-15,120 ( -4 %),1175,881940,750.59,862,1148200,1332,-266260
2013-04-12,125 ( -2.34 %),864,715230,827.81,696,840290,1207,-125060
2013-04-11,128 ( 1.59 %),1124,1001210,890.76,660,929820,1409,71390
2013-04-10,126 ( -2.33 %),852,760700,892.84,850,1074580,1264,-313880
2013-04-09,129 ( 3.2 %),931,876370,941.32,723,666600,922,209770
2013-04-08,125 ( 1.63 %),544,538360,989.63,503,402530,800,135830
2013-04-05,123 ( 2.5 %),596,561630,942.33,403,363650,902,197980
2013-04-04,120 ( -2.44 %),831,664140,799.21,546,776120,1421,-111980
2013-04-03,123 ( 0.82 %),787,792710,1007.26,493,664450,1348,128260
2013-04-02,122 ( 0 %),847,674240,796.03,736,1028830,1398,-354590
2013-04-01,122 ( 5.17 %),1418,1388000,978.84,865,955720,1105,432280
2013-03-29,116 ( 0.87 %),805,1064930,1322.89,508,722350,1422,342580
2013-03-28,115 ( 1.77 %),587,687020,1170.39,417,363290,871,323730
2013-03-27,113 ( 0 %),693,650980,939.37,470,505990,1077,144990
2013-03-26,113 ( -1.74 %),736,558500,758.83,718,795760,1108,-237260
2013-03-25,115 ( 1.77 %),679,829580,1221.77,646,652390,1010,177190
2013-03-22,113 ( 1.8 %),939,1257560,1339.25,1044,1067210,1022,190350
2013-03-21,111 ( 3.74 %),1416,1699910,1200.5,1272,1333130,1048,366780
2013-03-20,107 ( 1.9 %),519,576190,1110.19,534,448520,840,127670
2013-03-19,105 ( 0 %),425,384060,903.67,477,414990,870,-30930
2013-03-18,105 ( 0.96 %),827,850510,1028.43,889,1353630,1523,-503120
2013-03-15,104 ( 0 %),468,304160,649.91,355,414520,1168,-110360
2013-03-14,104 ( 0 %),406,325000,800.49,347,552420,1592,-227420
2013-03-13,104 ( 0 %),508,448220,882.32,390,1061770,2722,-613550
2013-03-12,104 ( -0.95 %),522,361050,691.67,462,835160,1808,-474110
2013-03-11,105 ( 0.96 %),593,394310,664.94,422,418630,992,-24320
2013-03-08,104 ( -0.95 %),473,396710,838.71,405,434410,1073,-37700
2013-03-07,105 ( 0 %),473,427950,904.76,564,598450,1061,-170500
2013-03-06,105 ( 1.94 %),614,847130,1379.69,938,875660,934,-28530
2013-03-05,103 ( 0.98 %),513,605610,1180.53,476,553610,1163,52000
2013-03-04,102 ( -0.97 %),397,502710,1266.27,445,396660,891,106050
2013-03-01,103 ( 0 %),415,425010,1024.12,562,430750,766,-5740
2013-02-28,103 ( 0.98 %),462,620640,1343.38,598,497870,833,122770
2013-02-27,102 ( 0.99 %),634,656170,1034.97,589,552380,938,103790
2013-02-26,101 ( -1.94 %),656,689220,1050.64,651,617190,948,72030
2013-02-25,103 ( 0.98 %),576,614530,1066.89,597,591330,991,23200
2013-02-22,102 ( 0.99 %),841,869340,1033.7,701,804800,1148,64540
2013-02-21,101 ( -2.88 %),669,587770,878.58,820,746120,910,-158350
2013-02-20,104 ( 2.97 %),1025,1060150,1034.29,1197,1004940,840,55210
2013-02-19,101 ( -0.98 %),582,456700,784.71,497,428760,863,27940
2013-02-18,102 ( 0 %),576,326060,566.08,421,359860,855,-33800
2013-02-08,102 ( 0 %),435,347600,799.08,357,301210,844,46390
2013-02-07,102 ( -0.97 %),440,327610,744.57,492,407260,828,-79650
2013-02-06,103 ( 3.52 %),599,627420,1047.45,625,538260,861,89160
2013-02-05,99.5 ( -1.49 %),897,715870,798.07,493,784920,1592,-69050
2013-02-04,101 ( -0.98 %),638,378430,593.15,433,355880,822,22550
2013-02-01,102 ( 0.99 %),901,732060,812.5,500,479130,958,252930
2013-01-31,101 ( -1.94 %),747,515410,689.97,637,548030,860,-32620
2013-01-30,103 ( -0.96 %),816,673200,825,820,742330,905,-69130
2013-01-29,104 ( -0.95 %),709,577770,814.91,1150,898190,781,-320420
2013-01-28,105 ( 5.53 %),830,1158050,1395.24,1714,1223570,714,-65520
2013-01-25,99.5 ( 0.51 %),727,744820,1024.51,1241,939230,757,-194410
2013-01-24,99 ( 1.02 %),379,346030,913.01,536,468330,874,-122300
2013-01-23,98 ( 1.55 %),604,580330,960.81,849,688790,811,-108460
2013-01-22,96.5 ( 0 %),497,463170,931.93,473,443420,937,19750
2013-01-21,96.5 ( -1.03 %),405,177500,438.27,323,223090,691,-45590
2013-01-18,97.5 ( -0.51 %),618,475010,768.62,484,429430,887,45580
2013-01-17,98 ( -1.51 %),857,586790,684.7,500,602370,1205,-15580
2013-01-16,99.5 ( -0.5 %),686,438740,639.56,497,486290,978,-47550
2013-01-15,100 ( 0.5 %),820,600170,731.91,498,459280,922,140890
2013-01-14,99.5 ( -3.4 %),1128,729350,646.59,682,931180,1365,-201830
2013-01-11,103 ( 3 %),997,853800,856.37,639,735180,1151,118620
2013-01-10,100 ( 4.71 %),1072,1159760,1081.87,818,769910,941,389850
2013-01-09,95.5 ( 3.8 %),797,874730,1097.53,616,547770,889,326960
2013-01-08,92 ( 4.55 %),780,1433970,1838.42,781,810380,1038,623590
2013-01-07,88 ( 0 %),346,249700,721.68,464,431180,929,-181480
2013-01-04,88 ( 1.73 %),517,381270,737.47,394,307750,781,73520
2013-01-03,86.5 ( -0.57 %),492,247690,503.43,390,323860,830,-76170
2013-01-02,87 ( -1.14 %),643,323470,503.06,422,512790,1215,-189320
2012-12-28,88 ( 0 %),493,265350,538.24,382,428760,1122,-163410
2012-12-27,88 ( 0 %),691,419260,606.74,672,688880,1025,-269620
2012-12-26,88 ( 3.53 %),677,560820,828.39,567,418670,738,142150
2012-12-25,85 ( 1.8 %),371,339950,916.31,287,258910,902,81040
2012-12-24,83.5 ( 0.6 %),443,330420,745.87,309,310630,1005,19790
2012-12-21,83 ( -1.19 %),443,286330,646.34,261,240690,922,45640
2012-12-20,84 ( -0.59 %),515,322240,625.71,277,279720,1010,42520
2012-12-19,84.5 ( 2.18 %),1004,698380,695.6,520,836960,1610,-138580
2012-12-18,124 ( -0.8 %),605,441180,729.22,335,624340,1864,-183160
2012-12-17,125 ( -2.34 %),614,327070,532.69,363,502950,1386,-175880
2012-12-14,128 ( 0.79 %),304,223960,736.71,191,230860,1209,-6900
2012-12-13,127 ( 0 %),497,285660,574.77,237,280750,1185,4910
2012-12-12,127 ( -0.78 %),672,345720,514.46,293,520380,1776,-174660
2012-12-11,128 ( -1.54 %),370,151220,408.7,305,415820,1363,-264600
2012-12-10,130 ( 0 %),252,145900,578.97,207,303340,1465,-157440
2012-12-07,130 ( 0 %),211,221620,1050.33,259,236490,913,-14870
2012-12-06,130 ( -0.76 %),279,172770,619.25,267,315240,1181,-142470
2012-12-05,131 ( 0.77 %),312,252860,810.45,350,320760,916,-67900
2012-12-04,130 ( 0.78 %),224,206560,922.14,242,162050,670,44510
2012-12-03,129 ( 0 %),218,162240,744.22,210,170650,813,-8410
2012-11-30,129 ( 0 %),218,249260,1143.39,219,142990,653,106270
2012-11-29,129 ( 0.78 %),276,319090,1156.12,264,169680,643,149410
2012-11-28,128 ( -0.78 %),281,201630,717.54,221,146740,664,54890
2012-11-27,129 ( 0.78 %),340,301370,886.38,226,167360,741,134010
2012-11-26,128 ( -1.54 %),305,277940,911.28,323,284930,882,-6990
2012-11-23,130 ( 0 %),338,251070,742.81,315,399630,1269,-148560
2012-11-22,130 ( 0 %),297,216510,728.99,315,350040,1111,-133530
2012-11-21,130 ( 0 %),465,285590,614.17,432,445600,1031,-160010
2012-11-20,130 ( 0.78 %),550,449000,816.36,266,305300,1148,143700
2012-11-19,129 ( -0.77 %),406,220610,543.37,282,295770,1049,-75160
2012-11-16,130 ( -1.52 %),474,193870,409.01,367,353810,964,-159940
2012-11-15,132 ( 0 %),720,377370,524.12,654,599630,917,-222260
2012-11-14,132 ( 4.76 %),674,566690,840.79,490,493310,1007,73380
2012-11-13,126 ( -0.79 %),268,215000,802.24,256,335180,1309,-120180
2012-11-12,127 ( 0.79 %),286,181940,636.15,214,246600,1152,-64660
2012-11-09,126 ( 0.8 %),305,204140,669.31,237,222810,940,-18670
2012-11-08,125 ( -1.57 %),331,257280,777.28,323,374730,1160,-117450
2012-11-07,127 ( 0 %),329,173310,526.78,327,331730,1014,-158420
2012-11-06,127 ( 0.79 %),517,325150,628.92,413,368440,892,-43290
2012-11-05,126 ( 4.13 %),581,465720,801.58,359,215220,599,250500
2012-11-02,121 ( -4.72 %),713,370470,519.59,464,480400,1035,-109930
2012-11-01,127 ( 1.6 %),499,452870,907.56,263,219220,834,233650
2012-10-31,125 ( -1.57 %),725,534440,737.16,372,427100,1148,107340
2012-10-30,127 ( -0.78 %),430,262620,610.74,274,284940,1040,-22320
2012-10-29,128 ( -0.78 %),389,317530,816.27,260,233900,900,83630
2012-10-26,129 ( 1.57 %),544,464640,854.12,325,221250,681,243390
2012-10-25,127 ( -4.51 %),856,708480,827.66,659,885160,1343,-176680
2012-10-24,133 ( -2.21 %),501,281350,561.58,416,534290,1284,-252940
2012-10-23,136 ( 0 %),521,474180,910.13,375,481540,1284,-7360
2012-10-22,136 ( 2.26 %),488,617280,1264.92,404,378990,938,238290
2012-10-19,133 ( 2.31 %),784,919480,1172.81,500,607550,1215,311930
2012-10-18,130 ( 2.36 %),600,505410,842.35,386,447660,1160,57750
2012-10-17,127 ( -0.78 %),377,309580,821.17,434,369950,852,-60370
2012-10-16,128 ( 4.07 %),554,412310,744.24,359,247370,689,164940
2012-10-15,123 ( 4.24 %),657,696770,1060.53,362,361840,1000,334930
2012-10-12,118 ( 0 %),266,453280,1704.06,238,223460,939,229820
2012-10-11,118 ( 0 %),358,553070,1544.89,196,245560,1253,307510
2012-10-10,118 ( 0 %),273,221840,812.6,199,315390,1585,-93550
2012-10-09,118 ( 0 %),373,461360,1236.89,378,573450,1517,-112090
2012-10-08,118 ( 2.61 %),458,657070,1434.65,390,358670,920,298400
2012-10-05,115 ( 0 %),306,297320,971.63,183,164840,901,132480
2012-10-04,115 ( 0 %),318,346270,1088.9,195,198570,1018,147700
2012-10-03,115 ( 0.88 %),391,339040,867.11,220,221640,1007,117400
2012-10-02,114 ( -1.72 %),382,380440,995.92,273,388150,1422,-7710
2012-10-01,116 ( -0.85 %),339,371920,1097.11,244,358360,1469,13560
2012-09-28,117 ( -0.85 %),436,496610,1139.01,356,393970,1107,102640
2012-09-27,118 ( 1.72 %),375,435190,1160.51,429,443670,1034,-8480
2012-09-26,116 ( 2.65 %),547,582010,1064,404,520360,1288,61650
2012-09-25,113 ( 2.73 %),424,436730,1030.02,374,367650,983,69080
2012-09-24,110 ( -0.9 %),237,295910,1248.57,237,153480,648,142430
2012-09-21,111 ( 0.91 %),221,381810,1727.65,219,278690,1273,103120
2012-09-20,110 ( 0 %),370,382010,1032.46,255,286740,1124,95270
2012-09-19,110 ( 1.85 %),329,458770,1394.44,199,296510,1490,162260
2012-09-18,108 ( -2.7 %),314,509710,1623.28,323,299650,928,210060
2012-09-17,111 ( 0.91 %),302,519180,1719.14,326,322960,991,196220
2012-09-14,110 ( 3.77 %),391,567460,1451.3,402,497060,1236,70400
2012-09-13,106 ( 0 %),206,156950,761.89,203,277970,1369,-121020
2012-09-12,106 ( 0.95 %),216,214360,992.41,208,137530,661,76830
2012-09-11,105 ( 0.96 %),268,260320,971.34,166,90990,548,169330
2012-09-10,104 ( -1.89 %),353,326300,924.36,228,237230,1040,89070
2012-09-07,106 ( 0.95 %),235,271010,1153.23,208,186460,896,84550
2012-09-06,105 ( -1.87 %),255,446010,1749.06,222,241960,1090,204050
2012-09-05,107 ( 0 %),233,218880,939.4,245,229690,938,-10810
2012-09-04,107 ( 1.9 %),290,336380,1159.93,241,227650,945,108730
2012-08-31,105 ( 1.94 %),237,231430,976.5,209,167600,802,63830
2012-08-30,103 ( -0.96 %),230,187900,816.96,174,192200,1105,-4300
2012-08-29,104 ( 0.97 %),301,274650,912.46,202,250830,1242,23820
2012-08-28,103 ( 0.98 %),319,255860,802.07,176,186510,1060,69350
2012-08-27,102 ( -1.92 %),232,280940,1210.95,242,286460,1184,-5520
2012-08-24,104 ( 1.96 %),704,738320,1048.75,316,472900,1497,265420
2012-08-23,102 ( -4.67 %),228,345450,1515.13,240,462880,1929,-117430
2012-08-22,107 ( 1.9 %),521,705150,1353.45,314,311970,994,393180
2012-08-21,105 ( -4.55 %),323,292410,905.29,370,538620,1456,-246210
2012-08-20,112 ( 0.9 %),322,410050,1273.45,310,281850,909,128200
2012-08-17,111 ( -1.77 %),286,181320,633.99,304,268020,882,-86700
2012-08-16,113 ( -1.74 %),368,209640,569.67,377,411380,1091,-201740
2012-08-15,115 ( 3.6 %),423,319280,754.8,291,259840,893,59440
2012-08-14,111 ( 4.72 %),605,824090,1362.13,410,335960,819,488130
2012-08-13,106 ( 1.92 %),273,389070,1425.16,276,157470,571,231600
2012-08-10,104 ( -0.95 %),305,409670,1343.18,375,333460,889,76210
2012-08-09,105 ( 2.94 %),411,443870,1079.98,286,277970,972,165900
2012-08-08,102 ( -0.97 %),418,312250,747.01,380,337070,887,-24820
2012-08-07,103 ( 0.98 %),460,365250,794.02,516,553680,1073,-188430
2012-08-06,102 ( 4.62 %),765,833970,1090.16,476,571790,1201,262180
2012-08-03,97.5 ( 4.84 %),677,1036690,1531.3,123,108780,884,927910
2012-08-02,93 ( 4.49 %),747,1164580,1559.01,137,122880,897,1041700
2012-08-01,89 ( -0.56 %),109,70250,644.5,155,93050,600,-22800
2012-07-31,89.5 ( 0.56 %),137,119170,869.85,233,165840,712,-46670
2012-07-30,89 ( 2.3 %),354,521070,1471.95,450,357770,795,163300
2012-07-27,87 ( 0 %),96,118920,1238.75,158,106990,677,11930
2012-07-26,87 ( 0 %),124,190640,1537.42,224,189920,848,720
2012-07-25,87 ( 0 %),122,105770,866.97,190,100630,530,5140
2012-07-24,87 ( 0 %),129,131880,1022.33,159,116770,734,15110
2012-07-23,87 ( -0.57 %),121,137060,1132.73,247,134150,543,2910
2012-07-20,87.5 ( 0 %),129,94220,730.39,244,122790,503,-28570
2012-07-19,87.5 ( 0 %),125,117260,938.08,179,77300,432,39960
2012-07-18,87.5 ( 1.16 %),138,136740,990.87,188,83920,446,52820
2012-07-17,86.5 ( 0 %),118,88610,750.93,134,64240,479,24370
2012-07-16,86.5 ( -1.14 %),115,377470,3282.35,220,122710,558,254760
2012-07-13,87.5 ( 1.16 %),185,300090,1622.11,268,114320,427,185770
2012-07-12,86.5 ( 0.58 %),108,123940,1147.59,150,68170,454,55770
2012-07-10,85.5 ( 0 %),155,145910,941.35,192,96100,501,49810
2012-07-09,85.5 ( -1.16 %),125,97100,776.8,231,98500,426,-1400
2012-07-06,86.5 ( -0.57 %),118,101360,858.98,92,98580,1072,2780
2012-07-05,87 ( 0 %),114,175520,1539.65,137,98770,721,76750
2012-07-04,87 ( 0 %),123,225440,1832.85,128,88270,690,137170
2012-07-03,87 ( -0.57 %),120,88150,734.58,111,81430,734,6720
2012-07-02,87.5 ( -0.57 %),111,187920,1692.97,160,109340,683,78580
2012-06-29,88 ( 2.33 %),113,83600,739.82,95,72320,761,11280
2012-06-28,86 ( 0 %),117,72860,622.74,89,59610,670,13250
2012-06-27,86 ( 0 %),104,61750,593.75,71,31800,448,29950
2012-06-26,86 ( -0.58 %),142,104630,736.83,110,88670,806,15960
2012-06-25,86.5 ( 0 %),140,98610,704.36,119,78620,661,19990
2012-06-22,86.5 ( 0 %),131,86080,657.1,100,60950,610,25130
2012-06-21,86.5 ( -1.14 %),105,74840,712.76,97,77590,800,-2750
2012-06-20,87.5 ( -0.57 %),131,64870,495.19,110,63450,577,1420
2012-06-19,88 ( 0 %),84,79750,949.4,129,107240,831,-27490
2012-06-18,88 ( -0.56 %),159,166730,1048.62,153,76270,498,90460
2012-06-15,88.5 ( 2.31 %),227,234940,1034.98,339,205660,607,29280
2012-06-14,86.5 ( 0.58 %),153,245030,1601.5,167,103380,619,141650
2012-06-13,86 ( 0 %),129,81260,629.92,91,48020,528,33240
2012-06-12,86 ( 0 %),159,105110,661.07,104,91750,882,13360
2012-06-11,86 ( 0.58 %),161,70820,439.88,84,61130,728,9690
2012-06-08,85.5 ( -0.58 %),147,76540,520.68,107,82450,771,-5910
2012-06-07,86 ( 0 %),188,98120,521.91,81,84470,1043,13650
2012-06-06,86 ( -0.58 %),177,151470,855.76,116,114660,988,36810
2012-06-05,86.5 ( 0.58 %),113,66540,588.85,92,72210,785,-5670
2012-06-04,86 ( -1.15 %),139,47400,341.01,110,59380,540,-11980
2012-06-01,87 ( 0.58 %),116,56420,486.38,86,71030,826,-14610
2012-05-31,86.5 ( -1.14 %),155,83300,537.42,94,91270,971,-7970
2012-05-30,87.5 ( 0 %),157,74610,475.22,131,66080,504,8530
2012-05-29,87.5 ( 0.57 %),97,43740,450.93,105,56460,538,-12720
2012-05-28,87 ( -0.57 %),140,63050,450.36,148,57670,390,5380
2012-05-25,87.5 ( 1.16 %),235,169980,723.32,126,132310,1050,37670
2012-05-24,86.5 ( -1.14 %),190,124740,656.53,112,107020,956,17720
2012-05-23,87.5 ( -0.57 %),142,90410,636.69,120,101180,843,-10770
2012-05-22,88 ( -1.12 %),165,72720,440.73,160,100010,625,-27290
2012-05-21,89 ( 1.71 %),167,83850,502.1,110,69260,630,14590
2012-05-18,87.5 ( -0.57 %),191,108140,566.18,147,160840,1094,-52700
2012-05-17,88 ( 0 %),174,72380,415.98,122,125260,1027,-52880
2012-05-16,88 ( -1.12 %),261,159660,611.72,180,176220,979,-16560
2012-05-15,89 ( -0.56 %),157,153970,980.7,208,159160,765,-5190
2012-05-14,89.5 ( -0.56 %),157,114480,729.17,231,235620,1020,-121140
2012-05-11,90 ( 0 %),144,102060,708.75,196,141400,721,-39340
2012-05-10,90 ( -0.55 %),145,78570,541.86,229,161850,707,-83280
2012-05-09,90.5 ( 0.56 %),166,89200,537.35,184,121670,661,-32470
2012-05-08,90 ( 0 %),158,102580,649.24,202,169670,840,-67090
2012-05-07,90 ( 0 %),171,111500,652.05,202,156450,775,-44950
2012-05-04,90 ( 0 %),188,127910,680.37,193,166040,860,-38130
2012-05-03,90 ( -0.55 %),179,119130,665.53,158,123690,783,-4560
2012-05-02,90.5 ( 0 %),202,119220,590.2,182,140510,772,-21290
2012-04-27,90.5 ( -0.55 %),159,104990,660.31,199,157330,791,-52340
2012-04-26,91 ( 1.11 %),286,170880,597.48,391,290990,744,-120110
2012-04-25,90 ( 0 %),254,111020,437.09,158,113320,717,-2300
2012-04-24,90 ( 0 %),180,84160,467.56,170,100250,590,-16090
2012-04-23,90 ( 0 %),205,81250,396.34,165,126470,766,-45220
2012-04-20,90 ( 0 %),212,96030,452.97,158,119540,757,-23510
2012-04-19,90 ( -1.1 %),244,104890,429.88,166,143350,864,-38460
2012-04-18,91 ( 0 %),270,176480,653.63,212,136950,646,39530
2012-04-17,91 ( 0 %),359,131750,366.99,224,182160,813,-50410
2012-04-16,91 ( 0 %),280,175360,626.29,215,160100,745,15260
2012-04-13,91 ( -0.55 %),231,91830,397.53,227,220730,972,-128900
2012-04-12,91.5 ( 0 %),276,166000,601.45,226,255930,1132,-89930
2012-04-11,91.5 ( 0 %),245,167930,685.43,194,213580,1101,-45650
2012-04-10,91.5 ( -0.54 %),206,113310,550.05,165,144570,876,-31260
2012-04-09,92 ( -0.54 %),197,102070,518.12,205,92760,452,9310
2012-04-06,92.5 ( 1.65 %),235,125180,532.68,180,167490,930,-42310
2012-04-05,93 ( 0 %),205,159890,779.95,177,195270,1103,-35380
2012-04-04,93 ( 0 %),198,107970,545.3,151,77260,512,30710
2012-04-03,93 ( 1.09 %),258,185250,718.02,129,108120,838,77130
2012-03-30,92 ( -0.54 %),250,170700,682.8,177,173390,980,-2690
2012-03-29,92.5 ( -1.07 %),290,209920,723.86,255,275260,1079,-65340
2012-03-28,93.5 ( 1.08 %),266,218330,820.79,199,219780,1104,-1450
2012-03-27,92.5 ( -2.12 %),302,260620,862.98,284,252900,890,7720
2012-03-26,94.5 ( -1.56 %),346,202220,584.45,350,307840,880,-105620
2012-03-23,96 ( 4.92 %),527,455900,865.09,395,313770,794,142130
2012-03-22,91.5 ( 0 %),155,131850,850.65,211,164760,781,-32910
2012-03-21,91.5 ( 0 %),205,120510,587.85,214,223020,1042,-102510
2012-03-20,91.5 ( 0 %),199,105270,528.99,169,139100,823,-33830
2012-03-19,91.5 ( 0 %),150,101300,675.33,150,159050,1060,-57750
2012-03-16,91.5 ( -1.08 %),196,94850,483.93,153,179140,1171,-84290
2012-03-15,92.5 ( 1.09 %),148,96440,651.62,154,110960,721,-14520
2012-03-14,91.5 ( 0 %),140,221420,1581.57,219,219530,1002,1890
2012-03-13,91.5 ( 0 %),142,140740,991.13,124,131390,1060,9350
2012-03-12,91.5 ( 0.55 %),174,231940,1332.99,179,123570,690,108370
2012-03-09,91 ( -0.55 %),234,221830,947.99,181,206090,1139,15740
2012-03-08,91.5 ( -2.14 %),214,185070,864.81,138,154930,1123,30140
2012-03-07,93.5 ( 1.08 %),232,239600,1032.76,180,151600,842,88000
2012-03-06,92.5 ( -3.14 %),314,218140,694.71,266,367410,1381,-149270
2012-03-05,95.5 ( 4.95 %),578,635020,1098.65,302,328040,1086,306980
2012-03-02,91 ( 0.55 %),211,208130,986.4,164,126330,770,81800
2012-03-01,90.5 ( -0.55 %),134,123300,920.15,139,151030,1087,-27730
2012-02-29,91 ( 0 %),142,144170,1015.28,165,129120,783,15050
2012-02-28,91 ( -0.55 %),157,136500,869.43,230,178430,776,-41930
2012-02-27,91.5 ( 0 %),137,125770,918.03,166,113760,685,12010
2012-02-24,91.5 ( -0.54 %),160,153930,962.06,197,142610,724,11320
2012-02-23,92 ( 0.55 %),247,247350,1001.42,232,196150,845,51200
2012-02-22,91.5 ( 0 %),203,153780,757.54,179,107380,600,46400
2012-02-21,91.5 ( -0.54 %),188,190640,1014.04,274,242640,886,-52000
2012-02-20,92 ( 1.1 %),301,256410,851.86,222,232690,1048,23720
2012-02-17,91 ( 2.82 %),360,372330,1034.25,329,257730,783,114600
2012-02-16,88.5 ( 0.57 %),128,151820,1186.09,169,136230,806,15590
2012-02-15,88 ( 0.57 %),145,168290,1160.62,164,118040,720,50250
2012-02-14,87.5 ( 0.57 %),177,224610,1268.98,187,165740,886,58870
2012-02-13,87 ( -0.57 %),133,136740,1028.12,148,97850,661,38890
2012-02-10,87.5 ( -1.13 %),138,90120,653.04,203,172830,851,-82710
2012-02-09,88.5 ( 1.14 %),153,183290,1197.97,233,209020,897,-25730
2012-02-08,87.5 ( 0.57 %),173,109320,631.91,143,82990,580,26330
2012-02-07,87 ( 0 %),146,121520,832.33,128,100550,786,20970
2012-02-06,87 ( -0.57 %),119,72140,606.22,174,129410,744,-57270
2012-02-03,87.5 ( -0.57 %),203,146280,720.59,233,222870,957,-76590
2012-02-02,88 ( 1.73 %),265,187950,709.25,155,125560,810,62390
2012-02-01,86.5 ( 0.58 %),205,182920,892.29,197,172820,877,10100
2012-01-31,86 ( 1.18 %),209,139430,667.13,146,109350,749,30080
2012-01-30,85 ( 0.59 %),172,73240,425.81,69,57390,832,15850
2012-01-20,84.5 ( -0.59 %),135,100740,746.22,142,137800,970,-37060
2012-01-19,85 ( 0.59 %),198,128120,647.07,111,124530,1122,3590
2012-01-18,84.5 ( -0.59 %),139,74160,533.53,160,159130,995,-84970
2012-01-17,85 ( 0.59 %),157,135080,860.38,233,173360,744,-38280
2012-01-16,84.5 ( 3.05 %),225,223480,993.24,222,152870,689,70610
2012-01-13,82 ( 1.23 %),181,128960,712.49,162,61590,380,67370
2012-01-12,81 ( 0 %),146,86230,590.62,141,71470,507,14760
2012-01-11,81 ( 0 %),171,107380,627.95,127,67170,529,40210
2012-01-10,81 ( 0 %),158,104910,663.99,108,73840,684,31070
2012-01-09,81 ( 0.62 %),160,89720,560.75,153,76720,501,13000
2012-01-06,80.5 ( 1.26 %),371,284020,765.55,226,143200,634,140820
2012-01-05,79.5 ( -3.64 %),313,248410,793.64,230,261720,1138,-13310
2012-01-04,82.5 ( -2.37 %),189,162920,862.01,237,186050,785,-23130
2012-01-03,84.5 ( -2.31 %),292,172280,590,348,219570,631,-47290
2011-12-30,86.5 ( -2.81 %),294,196260,667.55,332,262220,790,-65960
2011-12-29,89 ( -0.56 %),56,45190,806.96,74,38870,525,6320
2011-12-28,89.5 ( 0.56 %),86,54770,636.86,57,39000,684,15770
2011-12-27,89 ( 0 %),73,65340,895.07,79,61450,778,3890
2011-12-26,89 ( -0.56 %),74,90460,1222.43,78,61320,786,29140
2011-12-23,89.5 ( -1.1 %),115,73860,642.26,65,68260,1050,5600
2011-12-22,90.5 ( -1.63 %),96,71490,744.69,92,115500,1255,-44010
2011-12-21,92 ( 0 %),52,69050,1327.88,80,71850,898,-2800
2011-12-20,92 ( 0.55 %),81,91970,1135.43,139,83350,600,8620
2011-12-19,91.5 ( 1.1 %),96,130260,1356.88,146,67420,462,62840
2011-12-16,90.5 ( 0.56 %),71,80260,1130.42,77,40530,526,39730
2011-12-15,90 ( 0.56 %),73,103260,1414.52,98,70310,717,32950
2011-12-14,89.5 ( -0.56 %),113,98940,875.58,142,94060,662,4880
2011-12-13,90 ( -1.64 %),95,86790,913.58,114,139430,1223,-52640
2011-12-12,91.5 ( -0.54 %),128,116700,911.72,117,200970,1718,-84270
2011-12-09,92 ( 0 %),83,110110,1326.63,96,57380,598,52730
2011-12-08,92 ( 0 %),111,107230,966.04,90,61500,683,45730
2011-12-07,92 ( 0 %),96,94920,988.75,95,67460,710,27460
2011-12-06,92 ( 0 %),128,141800,1107.81,123,93620,761,48180
2011-12-05,92 ( 0.55 %),175,98140,560.8,68,48460,713,49680
2011-12-02,91.5 ( 0 %),111,100760,907.75,118,61390,520,39370
2011-12-01,91.5 ( 0 %),179,260840,1457.21,77,99650,1294,161190
2011-11-30,91.5 ( -1.08 %),126,133830,1062.14,122,139220,1141,-5390
2011-11-29,92.5 ( 1.98 %),274,195680,714.16,172,201070,1169,-5390
2011-11-28,136 ( -0.73 %),254,254270,1001.06,191,247850,1298,6420
2011-11-25,137 ( -0.72 %),227,279360,1230.66,139,299030,2151,-19670
2011-11-24,138 ( -2.82 %),110,79310,721,112,208460,1861,-129150
2011-11-23,142 ( 0 %),130,148730,1144.08,97,159070,1640,-10340
2011-11-22,142 ( 0 %),105,74130,706,124,158410,1278,-84280
2011-11-21,142 ( 4.41 %),211,304530,1443.27,121,128300,1060,176230
2011-11-18,136 ( 0 %),100,124420,1244.2,106,104510,986,19910
2011-11-17,136 ( -2.16 %),173,147790,854.28,155,190010,1226,-42220
2011-11-16,139 ( 0 %),90,80160,890.67,66,58510,887,21650
2011-11-15,139 ( -0.71 %),84,86090,1024.88,85,104590,1230,-18500
2011-11-14,140 ( 1.45 %),110,125540,1141.27,114,69360,608,56180
2011-11-11,138 ( 0 %),123,144230,1172.6,128,158290,1237,-14060
2011-11-10,138 ( -2.82 %),124,145640,1174.52,179,235650,1316,-90010
2011-11-09,142 ( -1.39 %),129,105470,817.6,216,175810,814,-70340
2011-11-08,144 ( 0 %),131,101160,772.21,185,149360,807,-48200
2011-11-07,144 ( 2.86 %),207,131330,634.44,119,151650,1274,-20320
2011-11-04,140 ( 3.7 %),213,160380,752.96,136,134420,988,25960
2011-11-03,135 ( 1.5 %),137,50050,365.33,125,88460,708,-38410
2011-11-02,133 ( 4.72 %),232,142680,615,158,131910,835,10770
2011-11-01,127 ( 0 %),66,52860,800.91,94,41610,443,11250
2011-10-31,127 ( -0.78 %),59,66280,1123.39,88,59650,678,6630
2011-10-28,128 ( 0.79 %),96,75410,785.52,71,54910,773,20500
2011-10-27,127 ( 0.79 %),56,48470,865.54,52,43280,832,5190
2011-10-26,126 ( -0.79 %),60,55440,924,56,38210,682,17230
2011-10-25,127 ( 0 %),45,41430,920.67,65,48660,749,-7230
2011-10-24,127 ( -0.78 %),66,55700,843.94,70,44480,635,11220
2011-10-21,128 ( 0.79 %),61,46650,764.75,55,31130,566,15520
2011-10-20,127 ( 0.79 %),63,56160,891.43,49,31640,646,24520
2011-10-19,126 ( -0.79 %),70,47120,673.14,73,50060,686,-2940
2011-10-18,127 ( 0 %),43,43660,1015.35,57,33510,588,10150
2011-10-17,127 ( -0.78 %),67,51930,775.07,81,41600,514,10330
2011-10-14,128 ( 0.79 %),62,79710,1285.65,77,42880,557,36830
2011-10-13,127 ( 0 %),46,57190,1243.26,69,37760,547,19430
2011-10-12,127 ( -0.78 %),94,122380,1301.91,45,42460,944,79920
2011-10-11,128 ( -0.78 %),91,105130,1155.27,93,71570,770,33560
2011-10-10,129 ( -0.77 %),108,76390,707.31,95,69410,731,6980
2011-10-07,130 ( 1.56 %),100,138350,1383.5,96,95700,997,42650
2011-10-06,128 ( 1.59 %),92,155110,1685.98,103,90180,876,64930
2011-10-05,126 ( 0.8 %),45,26050,578.89,46,37520,816,-11470
2011-10-04,125 ( -0.79 %),62,38220,616.45,52,48650,936,-10430
2011-10-03,126 ( 0.8 %),79,116130,1470,71,63950,901,52180
2011-09-30,125 ( -0.79 %),149,128130,859.93,86,137580,1600,-9450
2011-09-29,126 ( -1.56 %),72,34600,480.56,73,108000,1479,-73400
2011-09-28,128 ( 0.79 %),79,114880,1454.18,123,135800,1104,-20920
2011-09-27,127 ( 0 %),103,65320,634.17,80,61450,768,3870
2011-09-26,127 ( -1.55 %),84,45180,537.86,76,61230,806,-16050
2011-09-23,129 ( 0 %),103,60590,588.25,103,52590,511,8000
2011-09-22,129 ( -0.77 %),54,54420,1007.78,102,63850,626,-9430
2011-09-21,130 ( 1.56 %),86,118210,1374.53,91,37450,412,80760
2011-09-20,128 ( 0.79 %),86,81420,946.74,64,29380,459,52040
2011-09-19,127 ( 0.79 %),90,64440,716,63,26800,425,37640
2011-09-16,126 ( 0 %),92,109660,1191.96,55,18530,337,91130
2011-09-15,126 ( -0.79 %),97,125070,1289.38,87,63960,735,61110
2011-09-14,127 ( -3.05 %),146,108760,744.93,125,136350,1091,-27590
2011-09-13,131 ( 0 %),100,79080,790.8,98,71470,729,7610
2011-09-12,133 ( 1.53 %),91,99910,1097.91,114,82360,722,17550
2011-09-09,131 ( 0 %),70,40090,572.71,55,49280,896,-9190
2011-09-08,131 ( 0.77 %),95,82180,865.05,69,57000,826,25180
2011-09-07,130 ( 1.56 %),121,192790,1593.31,80,92490,1156,100300
2011-09-06,128 ( 0.79 %),79,104640,1324.56,95,78990,831,25650
2011-09-05,127 ( -0.78 %),94,67710,720.32,70,98570,1408,-30860
2011-09-01,128 ( 1.59 %),78,88020,1128.46,80,101860,1273,-13840
2011-08-31,126 ( 0 %),93,79100,850.54,110,143730,1307,-64630
2011-08-30,126 ( 3.28 %),101,81270,804.65,138,72730,527,8540
2011-08-29,122 ( 1.67 %),91,96870,1064.51,70,48380,691,48490
2011-08-26,120 ( 0.84 %),65,89760,1380.92,72,48330,671,41430
2011-08-25,119 ( 0 %),58,57080,984.14,67,46920,700,10160
2011-08-24,119 ( 0.85 %),90,147640,1640.44,106,57880,546,89760
2011-08-23,118 ( 0.85 %),55,85330,1551.45,81,44410,548,40920
2011-08-22,117 ( 0 %),91,98920,1087.03,56,64420,1150,34500
2011-08-19,117 ( 0 %),70,135270,1932.43,57,36540,641,98730
2011-08-18,117 ( 0 %),105,184840,1760.38,89,75160,844,109680
2011-08-17,117 ( 0.86 %),115,199870,1738,113,72900,645,126970
2011-08-16,116 ( 0.87 %),82,221620,2702.68,73,44030,603,177590
2011-08-15,115 ( 0 %),69,195980,2840.29,72,48320,671,147660
2011-08-12,115 ( 0 %),81,217150,2680.86,91,55630,611,161520
2011-08-11,115 ( 0 %),53,142030,2679.81,85,65840,775,76190
2011-08-10,115 ( 1.77 %),69,180010,2608.84,120,57930,483,122080
2011-08-09,113 ( -0.88 %),78,255210,3271.92,131,187750,1433,67460
2011-08-08,114 ( -0.87 %),36,95330,2648.06,63,54950,872,40380
2011-08-05,115 ( 0.88 %),60,143220,2387,75,46430,619,96790
2011-08-04,114 ( 0 %),81,138280,1707.16,69,63280,917,75000
2011-08-03,114 ( 0 %),75,161140,2148.53,104,84830,816,76310
2011-08-02,114 ( 0 %),61,106430,1744.75,107,83970,785,22460
2011-08-01,114 ( -0.87 %),51,106750,2093.14,86,55950,651,50800
2011-07-29,115 ( 0.88 %),82,165010,2012.32,75,48800,651,116210
2011-07-28,114 ( 0 %),70,147160,2102.29,108,126800,1174,20360
2011-07-27,114 ( -0.87 %),68,139570,2052.5,97,110330,1137,29240
2011-07-26,115 ( 0 %),76,301030,3960.92,124,100580,811,200450
2011-07-25,115 ( 0.88 %),70,226070,3229.57,89,57430,645,168640
2011-07-22,114 ( 0 %),45,101650,2258.89,64,43670,682,57980
2011-07-21,114 ( 0.88 %),79,114780,1452.91,92,46190,502,68590
2011-07-20,113 ( 0 %),109,111600,1023.85,78,50260,644,61340
2011-07-19,113 ( 0 %),133,129610,974.51,99,78060,788,51550
2011-07-18,113 ( 0 %),105,91070,867.33,65,46090,709,44980
2011-07-15,113 ( 0.89 %),118,92870,787.03,81,51850,640,41020
2011-07-14,112 ( -0.88 %),106,87170,822.36,91,77690,854,9480
2011-07-13,113 ( -0.88 %),139,254140,1828.35,139,111920,805,142220
2011-07-12,114 ( 0 %),119,172480,1449.41,105,79740,759,92740
2011-07-11,114 ( -0.87 %),104,82940,797.5,110,67310,612,15630
2011-07-08,115 ( 0 %),75,68550,914,113,73680,652,-5130
2011-07-07,115 ( 0 %),98,106320,1084.9,111,114240,1029,-7920
2011-07-06,115 ( 0 %),115,136370,1185.83,199,149470,751,-13100
2011-07-05,115 ( 1.77 %),156,247000,1583.33,283,281370,994,-34370
2011-07-04,113 ( 2.73 %),98,202420,2065.51,116,70350,606,132070
2011-07-01,110 ( 0.92 %),113,164710,1457.61,78,81180,1041,83530
2011-06-30,109 ( -0.91 %),126,138590,1099.92,159,255240,1605,-116650
2011-06-29,110 ( 0 %),328,3787310,11546.68,217,326930,1507,3460380
2011-06-28,110 ( -2.65 %),134,145590,1086.49,146,204190,1399,-58600
2011-06-27,113 ( 2.73 %),597,7498350,12560.05,296,480690,1624,7017660
2011-06-24,110 ( 0 %),254,225270,886.89,173,336000,1942,-110730
2011-06-23,110 ( -0.9 %),153,202420,1323.01,181,193940,1071,8480
2011-06-22,111 ( 0 %),220,447140,2032.45,303,473600,1563,-26460
2011-06-21,111 ( 4.72 %),259,705480,2723.86,240,216470,902,489010
2011-06-20,106 ( 0 %),125,179980,1439.84,146,114780,786,65200
2011-06-17,106 ( 0.95 %),113,175070,1549.29,143,94180,659,80890
2011-06-16,105 ( 0 %),77,136880,1777.66,120,65830,549,71050
2011-06-15,105 ( -0.94 %),125,196830,1574.64,168,165320,984,31510
2011-06-14,106 ( 0.95 %),148,272960,1844.32,237,219570,926,53390
2011-06-13,105 ( 0.96 %),167,403360,2415.33,225,319610,1420,83750
2011-06-10,104 ( 0 %),157,239370,1524.65,221,240850,1090,-1480
2011-06-09,104 ( 0 %),116,179200,1544.83,143,128870,901,50330
2011-06-08,104 ( 0.97 %),158,247130,1564.11,239,191360,801,55770
2011-06-07,103 ( 4.04 %),246,386690,1571.91,132,224560,1701,162130
2011-06-06,99 ( -2.94 %),224,238080,1062.86,143,176520,1234,61560
2011-06-03,102 ( -2.86 %),217,216470,997.56,264,282530,1070,-66060
2011-06-02,105 ( 0 %),238,198700,834.87,227,352180,1551,-153480
2011-06-01,105 ( 2.94 %),233,316870,1359.96,193,303930,1575,12940
2011-05-31,102 ( 4.08 %),264,244340,925.53,135,168170,1246,76170
2011-05-30,98 ( -3.92 %),194,185070,953.97,179,282010,1575,-96940
2011-05-27,102 ( 4.08 %),143,259370,1813.78,101,138260,1369,121110
2011-05-26,98 ( 4.81 %),317,572800,1806.94,222,314270,1416,258530
2011-05-25,93.5 ( -4.59 %),205,405730,1979.17,259,641090,2475,-235360
2011-05-24,98 ( -4.85 %),254,539550,2124.21,276,595430,2157,-55880
2011-05-23,103 ( -4.63 %),162,417800,2579.01,376,665510,1770,-247710
2011-05-20,108 ( -4.42 %),252,416160,1651.43,301,668190,2220,-252030
2011-05-19,113 ( -0.88 %),161,238000,1478.26,197,348130,1767,-110130
2011-05-18,114 ( 0.88 %),190,469710,2472.16,240,280100,1167,189610
2011-05-17,113 ( 2.73 %),178,488040,2741.8,301,424470,1410,63570
2011-05-16,110 ( -1.79 %),142,218600,1539.44,205,274820,1341,-56220
2011-05-13,112 ( -1.75 %),188,242610,1290.48,131,200300,1529,42310
2011-05-12,114 ( 0 %),213,270930,1271.97,194,326490,1683,-55560
2011-05-11,114 ( 4.59 %),313,547460,1749.07,216,292190,1353,255270
2011-05-10,109 ( 0.93 %),152,221840,1459.47,180,213000,1183,8840
2011-05-09,108 ( 0.93 %),206,331200,1607.77,168,206910,1232,124290
2011-05-06,107 ( 0 %),223,451090,2022.83,176,322920,1835,128170
2011-05-05,107 ( -0.93 %),216,462930,2143.19,248,394790,1592,68140
2011-05-04,108 ( 2.86 %),263,408790,1554.33,174,452650,2601,-43860
2011-04-29,105 ( 0 %),164,263390,1606.04,171,232810,1361,30580
2011-04-28,105 ( 2.94 %),385,638550,1658.57,304,550330,1810,88220
2011-04-27,102 ( 4.62 %),433,818940,1891.32,407,426370,1048,392570
2011-04-26,97.5 ( 1.56 %),144,286830,1991.88,321,267940,835,18890
2011-04-25,96 ( 1.05 %),83,123750,1490.96,111,69950,630,53800
2011-04-22,95 ( 0 %),89,195800,2200,134,100510,750,95290
2011-04-21,95 ( 0.53 %),128,196680,1536.56,137,123650,903,73030
2011-04-20,94.5 ( 1.07 %),111,161240,1452.61,110,90230,820,71010
2011-04-19,93.5 ( 0 %),121,185420,1532.4,116,87440,754,97980
2011-04-18,93.5 ( -1.06 %),113,113340,1003.01,122,107400,880,5940
2011-04-15,94.5 ( -0.53 %),124,142160,1146.45,155,110570,713,31590
2011-04-14,95 ( -1.04 %),104,121910,1172.21,168,138660,825,-16750
2011-04-13,96 ( -0.52 %),104,159360,1532.31,187,184070,984,-24710
2011-04-08,96.5 ( 1.05 %),175,320420,1830.97,204,261240,1281,59180
2011-04-07,95.5 ( 0 %),134,164090,1224.55,129,141640,1098,22450
2011-04-06,95.5 ( 1.06 %),258,297350,1152.52,120,158090,1317,139260
2011-04-05,94.5 ( -3.57 %),853,8526080,9995.4,288,860220,2987,7665860
2011-04-04,98 ( 3.7 %),310,689470,2224.1,470,642540,1367,46930
2011-04-01,94.5 ( 2.72 %),201,385070,1915.77,219,267760,1223,117310
2011-03-31,92 ( -1.08 %),118,139060,1178.47,106,177240,1672,-38180
2011-03-30,93 ( -0.53 %),112,161400,1441.07,149,167930,1127,-6530
2011-03-29,93.5 ( -0.53 %),148,246470,1665.34,186,242020,1301,4450
2011-03-28,94 ( -0.53 %),85,135640,1595.76,168,193060,1149,-57420
2011-03-25,94.5 ( 0 %),112,183240,1636.07,128,184050,1438,-810
2011-03-24,94.5 ( -1.05 %),135,215680,1597.63,213,270790,1271,-55110
2011-03-23,95.5 ( 3.24 %),347,622770,1794.73,302,470960,1559,151810
2011-03-22,92.5 ( 0.54 %),171,219720,1284.91,160,245200,1532,-25480
2011-03-21,92 ( 0 %),107,162690,1520.47,131,185410,1415,-22720
2011-03-18,92 ( 2.79 %),102,182410,1788.33,161,160140,995,22270
2011-03-17,89.5 ( 0 %),113,169750,1502.21,63,138490,2198,31260
2011-03-16,89.5 ( 0 %),110,153930,1399.36,79,121230,1535,32700
2011-03-15,89.5 ( -1.65 %),130,165160,1270.46,105,235770,2245,-70610
2011-03-14,91 ( -1.09 %),124,165300,1333.06,137,148770,1086,16530
2011-03-11,92 ( 0 %),104,154880,1489.23,139,199860,1438,-44980
2011-03-10,92 ( 0 %),156,231430,1483.53,139,176170,1267,55260
2011-03-09,92 ( -1.08 %),171,350180,2047.84,274,320710,1170,29470
2011-03-08,93 ( 4.49 %),233,341030,1463.65,189,209860,1110,131170
2011-03-07,89 ( 1.14 %),148,245440,1658.38,111,138140,1245,107300
2011-03-04,88 ( 0.57 %),150,275080,1833.87,102,107390,1053,167690
2011-03-03,87.5 ( 0.57 %),117,98760,844.1,74,63230,854,35530
2011-03-02,87 ( -1.69 %),169,240680,1424.14,101,107650,1066,133030
2011-03-01,88.5 ( 0 %),216,89320,413.52,83,72780,877,16540
2011-02-28,88.5 ( 0 %),166,399500,2406.63,76,93120,1225,306380
2011-02-25,88.5 ( 1.72 %),174,218570,1256.15,78,58310,748,160260
2011-02-24,87 ( -0.57 %),229,487900,2130.57,118,220820,1871,267080
2011-02-23,87.5 ( 1.16 %),200,198760,993.8,85,112330,1322,86430
2011-02-22,86.5 ( -0.57 %),298,472920,1586.98,91,170980,1879,301940
2011-02-21,87 ( -3.33 %),284,462290,1627.78,194,309250,1594,153040
2011-02-18,90 ( -1.64 %),213,349990,1643.15,126,220540,1750,129450
2011-02-17,91.5 ( -0.54 %),166,140420,845.9,104,132710,1276,7710
2011-02-16,92 ( 0 %),102,122010,1196.18,83,93860,1131,28150
2011-02-15,92 ( 0.55 %),159,161830,1017.8,101,107600,1065,54230
2011-02-14,91.5 ( -1.08 %),141,189940,1347.09,82,101100,1233,88840
2011-02-11,92.5 ( 1.09 %),152,228060,1500.39,123,107870,877,120190
2011-02-10,91.5 ( 0 %),236,293980,1245.68,111,223640,2015,70340
2011-02-09,91.5 ( -2.14 %),210,209240,996.38,87,225610,2593,-16370
2011-02-08,93.5 ( 0 %),187,270740,1447.81,116,187520,1617,83220
2011-01-28,93.5 ( 1.08 %),207,325050,1570.29,121,152540,1261,172510
2011-01-27,92.5 ( 0 %),229,343370,1499.43,125,183220,1466,160150
2011-01-26,92.5 ( -3.65 %),278,476320,1713.38,212,400980,1891,75340
2011-01-25,96 ( -2.04 %),237,305260,1288.02,345,499550,1448,-194290
2011-01-24,98 ( 4.81 %),345,1248400,3618.55,440,812400,1846,436000
2011-01-21,93.5 ( 4.47 %),345,933720,2706.43,227,332480,1465,601240
2011-01-20,89.5 ( 4.68 %),232,441100,1901.29,166,243210,1465,197890
2011-01-19,85.5 ( 0 %),66,70870,1073.79,82,114500,1396,-43630
2011-01-18,85.5 ( 0 %),64,117630,1837.97,97,76670,790,40960
2011-01-17,85.5 ( -0.58 %),112,117750,1051.34,102,106570,1045,11180
2011-01-14,86 ( 0.58 %),110,132150,1201.36,91,66400,730,65750
2011-01-13,85.5 ( 0 %),48,91910,1914.79,112,116680,1042,-24770
2011-01-12,85.5 ( 0 %),71,93930,1322.96,85,64070,754,29860
2011-01-11,85.5 ( 0 %),81,64650,798.15,96,60790,633,3860
2011-01-10,85.5 ( 0.59 %),83,188770,2274.34,112,117280,1047,71490
2011-01-07,85 ( 0 %),91,117050,1286.26,69,51240,743,65810
2011-01-06,85 ( 0 %),64,81580,1274.69,80,106550,1332,-24970
2011-01-05,85 ( -0.58 %),67,45930,685.52,44,62490,1420,-16560
2011-01-04,85.5 ( -0.58 %),76,131190,1726.18,100,94730,947,36460
2010-12-31,86 ( 0 %),64,53160,830.62,84,75700,901,-22540
2010-12-30,86 ( 0 %),61,34540,566.23,79,52440,664,-17900
2010-12-29,86 ( 1.18 %),74,47030,635.54,75,48280,644,-1250
2010-12-28,85 ( -0.58 %),76,67040,882.11,78,70630,906,-3590
2010-12-27,85.5 ( 0.59 %),98,121060,1235.31,92,75370,819,45690
2010-12-24,85 ( -0.58 %),112,259210,2314.38,121,83400,689,175810
2010-12-23,85.5 ( -0.58 %),90,296820,3298,67,72120,1076,224700
2010-12-22,86 ( -0.58 %),82,81000,987.8,81,85760,1059,-4760
2010-12-21,86.5 ( 1.17 %),69,104800,1518.84,107,92280,862,12520
2010-12-20,85.5 ( 0.59 %),111,216830,1953.42,99,69820,705,147010
2010-12-17,85 ( -1.16 %),124,101100,815.32,66,121720,1844,-20620
2010-12-16,86 ( -0.58 %),65,50500,776.92,66,52830,800,-2330
2010-12-15,86.5 ( -0.57 %),76,57230,753.03,97,89170,919,-31940
2010-12-14,87 ( -1.14 %),123,70750,575.2,127,138330,1089,-67580
2010-12-13,88 ( 2.33 %),147,188040,1279.18,124,99660,804,88380
2010-12-10,86 ( 0.58 %),117,230970,1974.1,103,85090,826,145880
2010-12-09,85.5 ( 1.79 %),67,78730,1175.07,102,77960,764,770
2010-12-08,84 ( -0.59 %),99,103140,1041.82,90,75900,843,27240
2010-12-07,84.5 ( 0 %),105,261060,2486.29,76,74730,983,186330
2010-12-06,84.5 ( -0.59 %),125,99130,793.04,86,79620,926,19510
2010-12-03,85 ( 0.59 %),134,119160,889.25,91,101420,1115,17740
2010-12-02,84.5 ( 0.6 %),84,79650,948.21,88,79760,906,-110
2010-12-01,84 ( -0.59 %),90,85670,951.89,76,73550,968,12120
2010-11-30,84.5 ( 0 %),109,80180,735.6,105,97090,925,-16910
2010-11-29,84.5 ( 0 %),78,76490,980.64,54,55090,1020,21400
2010-11-26,84.5 ( 0 %),72,91840,1275.56,62,66050,1065,25790
2010-11-25,84.5 ( 0 %),75,53960,719.47,67,63490,948,-9530
2010-11-24,84.5 ( 0.6 %),76,81070,1066.71,83,51320,618,29750
2010-11-23,84 ( 0 %),71,68890,970.28,59,41070,696,27820
2010-11-22,84 ( 0 %),99,97860,988.48,78,86880,1114,10980
2010-11-19,84 ( -0.59 %),128,336060,2625.47,104,105650,1016,230410
2010-11-18,84.5 ( 1.2 %),76,86990,1144.61,66,51590,782,35400
2010-11-17,83.5 ( 1.21 %),116,129800,1118.97,76,76790,1010,53010
2010-11-16,82.5 ( -1.2 %),99,109280,1103.84,98,124700,1272,-15420
2010-11-15,83.5 ( -0.6 %),128,116460,909.84,90,155950,1733,-39490
2010-11-12,84 ( -1.18 %),140,193690,1383.5,87,138920,1597,54770
2010-11-11,85 ( -0.58 %),92,98380,1069.35,61,93250,1529,5130
2010-11-10,85.5 ( 0 %),170,178440,1049.65,71,88290,1244,90150
2010-11-09,85.5 ( -0.58 %),119,232140,1950.76,108,173540,1607,58600
2010-11-08,86 ( -0.58 %),140,159690,1140.64,88,146340,1663,13350
2010-11-05,86.5 ( 0 %),114,189910,1665.88,81,132620,1637,57290
2010-11-04,86.5 ( 0 %),101,248170,2457.13,84,150290,1789,97880
2010-11-03,86.5 ( 0 %),111,114160,1028.47,73,128390,1759,-14230
2010-11-02,86.5 ( 0 %),115,243970,2121.48,84,128040,1524,115930
2010-11-01,86.5 ( -0.57 %),104,63480,610.38,73,100470,1376,-36990
2010-10-29,87 ( 0 %),111,253860,2287.03,106,162390,1532,91470
2010-10-28,87 ( 0.58 %),54,56440,1045.19,58,65540,1130,-9100
2010-10-27,86.5 ( -1.14 %),141,125760,891.91,92,134960,1467,-9200
2010-10-26,87.5 ( 0 %),110,185900,1690,122,148500,1217,37400
2010-10-25,87.5 ( 0 %),110,388510,3531.91,105,201150,1916,187360
2010-10-22,87.5 ( 0 %),112,137630,1228.84,113,127550,1129,10080
2010-10-21,87.5 ( 0.57 %),91,285860,3141.32,102,146060,1432,139800
2010-10-20,87 ( -1.14 %),84,153560,1828.1,86,189440,2203,-35880
2010-10-19,88 ( -0.56 %),55,150810,2742,111,209570,1888,-58760
2010-10-18,88.5 ( 0 %),48,148320,3090,111,114170,1029,34150
2010-10-15,88.5 ( -0.56 %),66,196760,2981.21,136,138450,1018,58310
2010-10-14,89 ( 0.56 %),58,118890,2049.83,111,78950,711,39940
2010-10-13,88.5 ( 0 %),104,228080,2193.08,123,103870,844,124210
2010-10-12,88.5 ( 0 %),66,142400,2157.58,115,76110,662,66290
2010-10-11,88.5 ( 0.57 %),87,118180,1358.39,149,89250,599,28930
2010-10-08,88 ( 0.57 %),114,83870,735.7,107,96930,906,-13060
2010-10-07,87.5 ( -0.57 %),93,154140,1657.42,128,85740,670,68400
2010-10-06,88 ( 1.15 %),128,172260,1345.78,98,103870,1060,68390
2010-10-05,87 ( -0.57 %),112,97840,873.57,76,85800,1129,12040
2010-10-04,87.5 ( -1.13 %),95,82160,864.84,99,97400,984,-15240
2010-10-01,88.5 ( 0 %),97,50410,519.69,81,50600,625,-190
2010-09-30,88.5 ( 0 %),65,54050,831.54,88,67920,772,-13870
2010-09-29,88.5 ( 0 %),72,68610,952.92,114,120140,1054,-51530
2010-09-28,88.5 ( 0 %),67,43020,642.09,98,82880,846,-39860
2010-09-27,88.5 ( 0.57 %),110,95510,868.27,91,112640,1238,-17130
2010-09-24,88 ( -0.56 %),116,100780,868.79,113,165230,1462,-64450
2010-09-23,88.5 ( -0.56 %),79,94070,1190.76,115,125480,1091,-31410
2010-09-22,89 ( 0 %),140,142230,1015.93,125,110150,881,32080
2010-09-21,89 ( 0 %),108,112820,1044.63,135,150840,1117,-38020
2010-09-20,89 ( 0 %),97,236180,2434.85,164,149250,910,86930
2010-09-17,89 ( 0.56 %),95,83110,874.84,99,88020,889,-4910
2010-09-16,88.5 ( 0 %),95,106050,1116.32,121,127460,1053,-21410
2010-09-15,88.5 ( 0 %),103,118910,1154.47,117,85580,731,33330
2010-09-14,88.5 ( 0 %),67,104200,1555.22,89,112330,1262,-8130
2010-09-13,88.5 ( 0 %),84,98090,1167.74,88,94050,1069,4040
2010-09-10,88.5 ( 0 %),156,351140,2250.9,166,182010,1096,169130
2010-09-09,88.5 ( 0.57 %),157,96250,613.06,102,116320,1140,-20070
2010-09-08,88 ( 0 %),137,284420,2076.06,122,120750,990,163670
2010-09-07,88 ( -0.56 %),123,76620,622.93,104,103410,994,-26790
2010-09-06,88.5 ( 0 %),118,70500,597.46,99,103690,1047,-33190
2010-09-01,88.5 ( -0.56 %),110,94770,861.55,101,109950,1089,-15180
2010-08-31,89 ( 0.56 %),113,169450,1499.56,150,178070,1187,-8620
2010-08-30,88.5 ( 1.72 %),100,116710,1167.1,124,114200,921,2510
2010-08-27,87 ( 0.58 %),83,65090,784.22,63,66240,1051,-1150
2010-08-26,86.5 ( 0 %),112,168140,1501.25,55,83700,1522,84440
2010-08-25,86.5 ( -0.57 %),156,237990,1525.58,139,126800,912,111190
2010-08-24,87 ( -1.69 %),116,108870,938.53,104,128250,1233,-19380
2010-08-23,88.5 ( -0.56 %),78,53150,681.41,90,126090,1401,-72940
2010-08-20,89 ( 0.56 %),88,44110,501.25,106,62340,588,-18230
2010-08-19,88.5 ( 0 %),105,353240,3364.19,156,205150,1315,148090
2010-08-18,88.5 ( -1.12 %),110,279470,2540.64,119,190960,1605,88510
2010-08-17,89.5 ( -1.1 %),105,102970,980.67,97,114380,1179,-11410
2010-08-16,90.5 ( 1.12 %),107,92370,863.27,83,74000,892,18370
2010-08-13,89.5 ( 2.87 %),238,757420,3182.44,125,358440,2868,398980
2010-08-12,90 ( -1.64 %),169,580370,3434.14,158,311360,1971,269010
2010-08-11,91.5 ( 0.55 %),166,684930,4126.08,115,204520,1778,480410
2010-08-10,91 ( 0 %),206,787790,3824.22,194,330640,1704,457150
2010-08-09,91 ( -0.55 %),156,565520,3625.13,173,266220,1539,299300
2010-08-06,91.5 ( -0.54 %),136,202700,1490.44,97,153760,1585,48940
2010-08-05,92 ( 0.55 %),123,257540,2093.82,122,112570,923,144970
2010-08-04,91.5 ( 0 %),153,180110,1177.19,106,174600,1647,5510
2010-08-03,91.5 ( 0.55 %),127,456630,3595.51,138,198920,1441,257710
2010-08-02,91 ( -0.55 %),132,455440,3450.3,158,273060,1728,182380
2010-07-30,91.5 ( 0 %),137,492560,3595.33,141,238470,1691,254090
2010-07-29,91.5 ( 0 %),89,264810,2975.39,120,161180,1343,103630
2010-07-28,91.5 ( -0.54 %),155,500310,3227.81,129,226970,1759,273340
2010-07-27,92 ( 0 %),94,341620,3634.26,109,128540,1179,213080
2010-07-26,92 ( 0 %),96,155690,1621.77,136,158810,1168,-3120
2010-07-23,92 ( -0.54 %),87,127970,1470.92,138,131620,954,-3650
2010-07-22,92.5 ( -1.07 %),53,81540,1538.49,142,135540,955,-54000
2010-07-21,93.5 ( 0.54 %),83,134900,1625.3,181,224730,1242,-89830
2010-07-20,93 ( 0.54 %),99,227650,2299.49,279,287070,1029,-59420
2010-07-19,92.5 ( 0 %),90,168900,1876.67,190,128800,678,40100
2010-07-16,92.5 ( 0.54 %),77,143320,1861.3,185,105060,568,38260
2010-07-15,92 ( 0 %),74,222370,3005,185,171980,930,50390
2010-07-14,92 ( 0 %),109,514680,4721.83,301,312540,1038,202140
2010-07-13,92 ( 0.55 %),108,375040,3472.59,206,196240,953,178800
2010-07-12,91.5 ( 0.55 %),85,135850,1598.24,133,107620,809,28230
2010-07-09,91 ( 0 %),106,461840,4356.98,212,205380,969,256460
2010-07-08,91 ( 0 %),118,280630,2378.22,205,255480,1246,25150
2010-07-07,91 ( 0 %),136,187990,1382.28,192,139560,727,48430
2010-07-06,91 ( 0 %),141,721750,5118.79,291,358970,1234,362780
2010-07-05,91 ( -0.55 %),119,515640,4333.11,219,263590,1204,252050
2010-07-02,91.5 ( 0.55 %),123,937370,7620.89,299,376300,1259,561070
2010-07-01,91 ( 1.11 %),104,311830,2998.37,241,213670,887,98160
2010-06-30,90 ( -0.55 %),131,352670,2692.14,178,204690,1150,147980
2010-06-29,90.5 ( 0 %),95,294660,3101.68,208,151280,727,143380
2010-06-28,90.5 ( -0.55 %),114,472850,4147.81,209,266820,1277,206030
2010-06-25,91 ( 0 %),137,270730,1976.13,223,200170,898,70560
2010-06-24,91 ( 0.55 %),133,334560,2515.49,224,144400,645,190160
2010-06-23,90.5 ( 1.12 %),150,607170,4047.8,319,286100,897,321070
2010-06-22,89.5 ( 0 %),92,247600,2691.3,219,169810,775,77790
2010-06-21,89.5 ( 0 %),122,294530,2414.18,213,219830,1032,74700
2010-06-18,89.5 ( 0 %),119,229470,1928.32,206,166970,811,62500
2010-06-17,89.5 ( -0.56 %),107,173870,1624.95,227,184050,811,-10180
2010-06-16,90 ( 0.56 %),123,197010,1601.71,176,171340,974,25670
2010-06-15,89.5 ( -0.56 %),107,291120,2720.75,169,123450,730,167670
2010-06-14,90 ( 0 %),132,394250,2986.74,269,267300,994,126950
2010-06-11,90 ( 0 %),225,1198770,5327.87,529,926060,1751,272710
2010-06-10,90 ( 0.56 %),123,292440,2377.56,216,218910,1013,73530
2010-06-09,89.5 ( 1.7 %),148,680320,4596.76,306,347290,1135,333030
2010-06-08,88 ( 0 %),144,391840,2721.11,203,186910,921,204930
2010-06-07,88 ( -2.22 %),237,485520,2048.61,167,432320,2589,53200
2010-06-04,90 ( 0.56 %),136,655550,4820.22,347,379390,1093,276160
2010-06-03,89.5 ( 1.13 %),135,439620,3256.44,287,391430,1364,48190
2010-06-02,88.5 ( -0.56 %),199,515700,2591.46,112,349430,3120,166270
2010-06-01,89 ( 0.56 %),166,492700,2968.07,151,229660,1521,263040
2010-05-31,88.5 ( -1.67 %),145,293670,2025.31,180,196090,1089,97580
2010-05-28,90 ( 1.12 %),142,303110,2134.58,211,270680,1283,32430
2010-05-27,89 ( -0.56 %),109,231610,2124.86,180,204950,1139,26660
2010-05-26,89.5 ( 0.56 %),124,397080,3202.26,151,205630,1362,191450
2010-05-25,89 ( 0.56 %),144,422660,2935.14,177,246690,1394,175970
2010-05-24,88.5 ( 1.14 %),177,426020,2406.89,115,298750,2598,127270
2010-05-21,87.5 ( -2.78 %),326,790960,2426.26,242,427620,1767,363340
2010-05-20,90 ( 0.56 %),241,634590,2633.15,202,469690,2325,164900
2010-05-19,89.5 ( -1.65 %),230,638330,2775.35,273,458550,1680,179780
2010-05-18,91 ( 0 %),144,295780,2054.03,285,280970,986,14810
2010-05-17,91 ( -1.09 %),106,393560,3712.83,253,276140,1091,117420
2010-05-14,92 ( 0.55 %),189,502420,2658.31,320,317500,992,184920
2010-05-13,91.5 ( 0.55 %),159,349810,2200.06,333,254540,764,95270
2010-05-12,91 ( -1.09 %),173,613620,3546.94,366,507610,1387,106010
2010-05-11,92 ( 1.66 %),199,521560,2620.9,254,242510,955,279050
2010-05-10,90.5 ( -1.09 %),227,782850,3448.68,409,523380,1280,259470
2010-05-07,91.5 ( -1.08 %),223,624190,2799.06,286,457590,1600,166600
2010-05-06,92.5 ( 0 %),167,679580,4069.34,474,555450,1172,124130
2010-05-05,92.5 ( -0.54 %),171,456370,2668.83,440,468970,1066,-12600
2010-05-04,93 ( -1.06 %),151,424260,2809.67,407,444050,1091,-19790
2010-04-29,94 ( 0 %),202,566320,2803.56,754,707930,939,-141610
2010-04-28,94 ( 1.08 %),267,974420,3649.51,1084,1188870,1097,-214450
2010-04-27,93 ( 3.91 %),285,1087350,3815.26,1039,870650,838,216700
2010-04-26,89.5 ( 1.7 %),132,512070,3879.32,520,562900,1082,-50830
2010-04-22,88 ( 0 %),130,195380,1502.92,377,372150,987,-176770
2010-04-21,88 ( -0.56 %),148,237470,1604.53,317,365700,1154,-128230
2010-04-20,88.5 ( 0 %),111,430950,3882.43,435,395540,909,35410
2010-04-19,88.5 ( 0 %),185,596310,3223.3,700,757860,1083,-161550
2010-04-16,88.5 ( -0.56 %),179,321170,1794.25,380,337190,887,-16020
2010-04-15,89 ( 1.14 %),131,386070,2947.1,488,510230,1046,-124160
2010-04-14,88 ( 0 %),195,473510,2428.26,628,675400,1075,-201890
2010-04-13,88 ( 0 %),143,475400,3324.48,873,966040,1107,-490640
2010-04-12,88 ( 1.73 %),167,491820,2945.03,785,763190,972,-271370
2010-04-09,86.5 ( 0 %),180,379820,2110.11,367,405390,1105,-25570
2010-04-08,86.5 ( 1.17 %),202,447220,2213.96,352,515410,1464,-68190
2010-04-07,86.5 ( -0.57 %),257,457920,1781.79,475,697100,1468,-239180
2010-04-06,87 ( -0.57 %),203,340710,1678.37,457,693460,1517,-352750
2010-04-05,87.5 ( 1.16 %),171,279140,1632.4,376,404310,1075,-125170
2010-04-02,86.5 ( 1.17 %),229,324910,1418.82,382,471700,1235,-146790
2010-04-01,85.5 ( 0.59 %),238,476850,2003.57,372,496850,1336,-20000
2010-03-31,85 ( 0.59 %),272,307930,1132.1,274,276630,1010,31300
2010-03-30,84.5 ( -1.74 %),334,316710,948.23,183,512170,2799,-195460
2010-03-29,86 ( 0.58 %),271,348600,1286.35,292,515990,1767,-167390
2010-03-26,85.5 ( -0.58 %),350,295990,845.69,183,351470,1921,-55480
2010-03-25,86 ( 0 %),255,242190,949.76,225,170070,756,72120
2010-03-24,86 ( 0.58 %),292,222680,762.6,142,180190,1269,42490
2010-03-23,85.5 ( -1.16 %),274,186100,679.2,270,234100,867,-48000
2010-03-22,86.5 ( -0.57 %),203,189530,933.65,297,254230,856,-64700
2010-03-19,87 ( -1.14 %),184,129930,706.14,269,216710,806,-86780
2010-03-18,88 ( 0.57 %),357,240950,674.93,194,179850,927,61100
2010-03-17,87.5 ( 0 %),308,212840,691.04,280,229100,818,-16260
2010-03-16,87.5 ( -1.69 %),301,244520,812.36,373,281290,754,-36770
2010-03-15,89 ( 0 %),391,415680,1063.12,557,656200,1178,-240520
2010-03-12,89 ( 0 %),353,347350,983.99,318,255730,804,91620
2010-03-11,89 ( -0.56 %),394,415960,1055.74,356,362830,1019,53130
2010-03-10,89.5 ( -2.19 %),365,319820,876.22,598,431000,721,-111180
2010-03-09,91.5 ( 2.81 %),509,2090000,4106.09,1505,1324580,880,765420
2010-03-08,89 ( 1.14 %),274,534140,1949.42,1010,917530,908,-383390
2010-03-05,88 ( 0.57 %),339,534150,1575.66,856,734620,858,-200470
2010-03-04,87.5 ( 1.16 %),266,846670,3182.97,905,865400,956,-18730
2010-03-03,86.5 ( 2.37 %),288,434150,1507.47,309,398510,1290,35640
2010-03-02,84.5 ( -0.59 %),493,629440,1276.75,380,858170,2258,-228730
2010-03-01,85 ( 0 %),454,642180,1414.49,370,872370,2358,-230190
2010-02-26,85 ( -3.41 %),839,1282900,1529.08,530,1561310,2946,-278410
2010-02-25,88 ( 1.73 %),286,795030,2779.83,530,1061110,2002,-266080
2010-02-24,87.5 ( 1.16 %),442,728540,1648.28,387,760950,1966,-32410
2010-02-23,86.5 ( -3.35 %),375,653160,1741.76,865,1100910,1273,-447750
2010-02-22,89.5 ( -1.1 %),479,917220,1914.86,811,1171370,1444,-254150
2010-02-12,90.5 ( 1.69 %),390,1313520,3368,1263,2050380,1623,-736860
2010-02-11,89 ( 4.71 %),422,1886000,4469.19,1195,1772610,1483,113390
2010-02-10,85 ( 4.94 %),474,1578910,3331.03,347,747390,2154,831520
2010-02-09,81 ( -4.71 %),954,2403510,2519.4,422,2500290,5925,-96780
2010-02-08,85 ( 0 %),357,714950,2002.66,399,423990,1063,290960
2010-02-05,85 ( -4.49 %),379,615400,1623.75,1077,1625940,1510,-1010540
2010-02-04,89 ( 3.49 %),507,1613180,3181.81,1916,2253910,1176,-640730
2010-02-03,86 ( 4.88 %),540,2476250,4585.65,1614,1734560,1075,741690
2010-02-02,82 ( 1.23 %),389,999950,2570.57,1543,1507200,977,-507250
2010-02-01,81 ( 4.52 %),283,487400,1722.26,432,422140,977,65260
2010-01-29,77.5 ( -0.64 %),276,533720,1933.77,466,651730,1399,-118010
2010-01-28,78 ( 0 %),229,330280,1442.27,461,467040,1013,-136760
2010-01-27,78 ( -4.29 %),424,708430,1670.83,765,1135580,1484,-427150
2010-01-26,81.5 ( 4.49 %),376,994330,2644.49,831,851660,1025,142670
2010-01-25,78 ( 2.63 %),296,535440,1808.92,663,541750,817,-6310
2010-01-22,76 ( 0 %),301,462550,1536.71,561,657000,1171,-194450
2010-01-21,76 ( -2.56 %),337,677280,2009.73,898,1275680,1421,-598400
2010-01-20,78 ( 4.7 %),565,988700,1749.91,824,782420,950,206280
2010-01-19,74.5 ( 4.93 %),494,766210,1551.03,257,340230,1324,425980
2010-01-18,71 ( -4.05 %),663,507410,765.32,182,397660,2185,109750
2010-01-15,74 ( -2.63 %),396,405720,1024.55,278,432510,1556,-26790
2010-01-14,76 ( 0 %),335,392670,1172.15,301,277610,922,115060
2010-01-13,76 ( 2.7 %),585,864800,1478.29,340,616660,1814,248140
2010-01-12,74 ( -3.27 %),696,629390,904.3,247,568270,2301,61120
2010-01-11,76.5 ( -1.29 %),606,506030,835.03,273,410750,1505,95280
2010-01-08,77.5 ( -3.12 %),632,561590,888.59,475,738450,1555,-176860
2010-01-07,80 ( -3.03 %),313,293990,939.27,571,568990,996,-275000
2010-01-06,82.5 ( 0.61 %),385,801810,2082.62,861,818700,951,-16890
2010-01-05,82 ( 4.46 %),440,990170,2250.39,453,826510,1825,163660
2010-01-04,78.5 ( 4.67 %),526,815750,1550.86,336,593490,1766,222260
2009-12-31,75 ( 0 %),453,486070,1073,482,589820,1224,-103750
2009-12-30,75 ( 0.67 %),436,351440,806.06,252,358360,1422,-6920
2009-12-29,74.5 ( -3.25 %),349,272500,780.8,469,317840,678,-45340
2009-12-28,77 ( 4.76 %),393,744070,1893.31,716,468030,654,276040
2009-12-25,73.5 ( 5 %),874,1124430,1286.53,452,805790,1783,318640
2009-12-24,70 ( 0 %),375,511690,1364.51,273,511700,1874,-10
2009-12-23,70 ( 0.72 %),399,705440,1768.02,308,573610,1862,131830
2009-12-22,69.5 ( -0.71 %),263,471550,1792.97,379,663990,1752,-192440
2009-12-21,70 ( 4.48 %),388,633100,1631.7,212,371970,1755,261130
2009-12-18,67 ( 4.69 %),391,581710,1487.75,147,417890,2843,163820
2009-12-17,64 ( -3.76 %),319,364470,1142.54,282,295320,1047,69150
2009-12-16,66.5 ( -4.32 %),281,377710,1344.16,432,626870,1451,-249160
2009-12-15,69.5 ( 0 %),285,426430,1496.25,261,474730,1819,-48300
2009-12-14,69.5 ( 0.72 %),424,452250,1066.63,247,378270,1531,73980
2009-12-11,69 ( -0.72 %),424,679340,1602.22,426,515940,1211,163400
2009-12-10,69.5 ( -4.79 %),805,1008510,1252.81,334,1330520,3984,-322010
2009-12-09,73 ( -3.95 %),539,631780,1172.13,336,810930,2413,-179150
2009-12-08,76 ( -0.65 %),529,718250,1357.75,298,583120,1957,135130
2009-12-07,76.5 ( -1.29 %),403,330000,818.86,181,220790,1220,109210
2009-12-04,77.5 ( 0 %),340,514460,1513.12,300,496450,1655,18010
2009-12-03,77.5 ( -1.9 %),253,428390,1693.24,492,660930,1343,-232540
2009-12-02,79 ( -0.63 %),304,440170,1447.93,414,578910,1398,-138740
2009-12-01,79.5 ( 1.27 %),463,696710,1504.77,349,842430,2414,-145720
2009-11-30,78.5 ( 1.29 %),369,502700,1362.33,295,362830,1230,139870
2009-11-27,77.5 ( 0 %),921,1152300,1251.14,390,916310,2350,235990
2009-11-26,77.5 ( -4.91 %),398,465560,1169.75,350,795300,2272,-329740
2009-11-25,81.5 ( -2.98 %),568,532310,937.17,485,589690,1216,-57380
2009-11-24,84 ( 0 %),334,349490,1046.38,424,581450,1371,-231960
2009-11-23,84 ( -3.45 %),254,234250,922.24,580,580410,1001,-346160
2009-11-20,87 ( 0 %),244,486100,1992.21,1161,999980,861,-513880
2009-11-19,87 ( 0.58 %),318,561850,1766.82,1001,840240,839,-278390
2009-11-18,86.5 ( 2.37 %),305,940990,3085.21,1149,887960,773,53030
2009-11-17,84.5 ( 0.6 %),410,515610,1257.59,644,588150,913,-72540
2009-11-16,84 ( -1.18 %),267,243750,912.92,904,685190,758,-441440
2009-11-13,85 ( 0 %),408,525640,1288.33,738,745340,1010,-219700
2009-11-12,85 ( 0 %),303,405900,1339.6,933,727980,780,-322080
2009-11-11,85 ( 3.03 %),379,580740,1532.3,777,633100,815,-52360
2009-11-10,82.5 ( 1.23 %),365,596930,1635.42,898,648990,723,-52060
2009-11-09,81.5 ( -2.98 %),628,493230,785.4,533,526190,987,-32960
2009-11-06,84 ( 0 %),321,451280,1405.86,777,640410,824,-189130
2009-11-05,84 ( 3.07 %),486,447760,921.32,426,387820,910,59940
2009-11-04,81.5 ( 0.62 %),860,878910,1021.99,483,581580,1204,297330
2009-11-03,81 ( -3.57 %),783,937690,1197.56,585,869670,1487,68020
2009-11-02,84 ( -4 %),741,679720,917.3,671,950420,1416,-270700
2009-10-30,87.5 ( 0.57 %),545,741430,1360.42,1261,1612060,1278,-870630
2009-10-29,87 ( -2.25 %),593,994290,1676.71,1372,1209530,882,-215240
2009-10-28,89 ( 4.71 %),653,1439530,2204.49,1202,1124360,935,315170
2009-10-27,85 ( 0 %),983,1232670,1253.99,875,1039680,1188,192990
2009-10-26,85 ( -0.58 %),688,797290,1158.85,712,685480,963,111810
2009-10-23,85.5 ( -0.58 %),900,1069020,1187.8,895,945110,1056,123910
2009-10-22,86 ( 0 %),1492,1569590,1052,921,941160,1022,628430
2009-10-21,86 ( -1.15 %),1498,1114830,744.21,569,844890,1485,269940
2009-10-20,87 ( 0 %),685,422320,616.53,754,769370,1020,-347050
2009-10-19,87 ( -1.14 %),730,556730,762.64,641,918050,1432,-361320
2009-10-16,88 ( -3.3 %),645,455790,706.65,1108,1222860,1104,-767070
2009-10-15,91 ( 1.11 %),443,838120,1891.92,1638,1527500,933,-689380
2009-10-14,90 ( 4.65 %),814,882270,1083.87,642,553220,862,329050
2009-10-13,86 ( -2.82 %),853,548310,642.8,703,724460,1031,-176150
2009-10-12,88.5 ( -0.56 %),728,486080,667.69,934,799710,856,-313630
2009-10-09,89 ( -0.56 %),692,795040,1148.9,1008,1320680,1310,-525640
2009-10-08,89.5 ( 1.13 %),454,814850,1794.82,1000,1225680,1226,-410830
2009-10-07,88.5 ( 4.73 %),747,926130,1239.8,451,577200,1280,348930
2009-10-06,84.5 ( -0.59 %),830,804540,969.33,392,888010,2265,-83470
2009-10-05,85 ( -0.58 %),716,469620,655.89,362,531100,1467,-61480
2009-10-02,85.5 ( -2.84 %),1551,1397070,900.75,614,1359640,2214,37430
2009-10-01,88 ( -2.22 %),902,919860,1019.8,744,1564180,2102,-644320
2009-09-30,90 ( 4.65 %),1077,1352430,1255.74,420,819260,1951,533170
2009-09-29,86 ( -2.27 %),1803,1462690,811.25,524,1601190,3056,-138500
2009-09-28,88 ( -3.3 %),1400,804200,574.43,485,1445080,2980,-640880
2009-09-25,91 ( 0.55 %),1446,989770,684.49,341,956930,2806,32840
2009-09-24,90.5 ( -4.74 %),1761,1302180,739.45,561,1885750,3361,-583570
2009-09-23,95 ( -4.04 %),2060,1743960,846.58,900,2217070,2463,-473110
2009-09-22,99 ( 4.76 %),2621,2516910,960.29,708,2556270,3611,-39360
2009-09-21,94.5 ( 5 %),1396,1487610,1065.62,112,503510,4496,984100
2009-09-18,90 ( 4.65 %),1675,2821680,1684.59,92,577530,6278,2244150
2009-09-17,172 ( 4.88 %),816,1150740,1410.22,545,893400,1639,257340
2009-09-16,164 ( -1.8 %),780,417710,535.53,328,399710,1219,18000
2009-09-15,167 ( -4.57 %),717,407950,568.97,561,764680,1363,-356730
2009-09-14,175 ( 2.94 %),523,340550,651.15,509,553040,1087,-212490
2009-09-11,170 ( 4.94 %),655,694170,1059.8,397,512000,1290,182170
2009-09-10,162 ( 4.52 %),589,589120,1000.2,407,346430,851,242690
2009-09-09,155 ( -1.27 %),180,177930,988.5,445,275980,620,-98050
2009-09-08,157 ( 4.67 %),300,470570,1568.57,291,269240,925,201330
2009-09-07,150 ( 0.67 %),309,208260,673.98,238,219140,921,-10880
2009-09-04,149 ( -1.97 %),416,260530,626.27,258,273610,1061,-13080
2009-09-03,152 ( -2.56 %),985,623590,633.09,239,667160,2791,-43570
2009-09-01,156 ( -1.27 %),287,214900,748.78,336,360270,1072,-145370
2009-08-31,158 ( 1.28 %),398,398070,1000.18,260,504620,1941,-106550
2009-08-28,156 ( 1.3 %),343,278710,812.57,250,458220,1833,-179510
2009-08-27,154 ( 2.67 %),401,295870,737.83,168,222040,1322,73830
2009-08-26,150 ( -4.46 %),580,303360,523.03,187,444290,2376,-140930
2009-08-25,157 ( -0.63 %),398,279510,702.29,241,343460,1425,-63950
2009-08-24,158 ( -1.25 %),335,284040,847.88,210,464820,2213,-180780
2009-08-21,160 ( 3.23 %),609,730430,1199.39,172,624080,3628,106350
2009-08-20,155 ( 4.73 %),396,641950,1621.09,187,224210,1199,417740
2009-08-19,148 ( 0 %),153,82560,539.61,188,229230,1219,-146670
2009-08-18,148 ( -1.99 %),257,200270,779.26,176,277330,1576,-77060
2009-08-17,151 ( 0.67 %),170,168790,992.88,166,169650,1022,-860
2009-08-14,150 ( 1.35 %),197,198870,1009.49,214,185440,867,13430
2009-08-13,148 ( 0 %),272,354230,1302.32,240,370390,1543,-16160
2009-08-12,148 ( -1.33 %),236,244780,1037.2,210,266080,1267,-21300
2009-08-11,150 ( 3.45 %),288,286280,994.03,181,250030,1381,36250
2009-08-10,145 ( 2.84 %),194,235430,1213.56,172,261690,1521,-26260
2009-08-07,141 ( 0 %),185,190870,1031.73,199,167600,842,23270
2009-08-06,141 ( -1.4 %),252,277470,1101.07,282,323530,1147,-46060
2009-08-05,143 ( 3.62 %),336,602860,1794.23,236,396670,1681,206190
2009-08-04,138 ( 4.55 %),276,594630,2154.46,177,284230,1606,310400
2009-08-03,132 ( 4.76 %),245,545010,2224.53,242,124130,513,420880
2009-07-31,126 ( 2.44 %),244,524510,2149.63,207,370790,1791,153720
2009-07-30,123 ( -0.81 %),200,196300,981.5,246,206470,839,-10170
2009-07-29,124 ( 0 %),163,342200,2099.39,400,486710,1217,-144510
2009-07-28,124 ( 0 %),182,491900,2702.75,448,373930,835,117970
2009-07-27,124 ( 3.33 %),203,377040,1857.34,436,499160,1145,-122120
2009-07-24,120 ( 4.35 %),276,683510,2476.49,190,376280,1980,307230
2009-07-23,115 ( 1.77 %),227,467200,2058.15,178,334000,1876,133200
2009-07-22,113 ( 2.73 %),146,368530,2524.18,136,253270,1862,115260
2009-07-21,110 ( 0.92 %),193,354760,1838.13,149,273300,1834,81460
2009-07-20,109 ( -2.68 %),210,330280,1572.76,190,266780,1404,63500
2009-07-17,114 ( -5 %),393,475380,1209.62,346,579770,1676,-104390
2009-07-16,120 ( 0 %),242,307290,1269.79,239,470990,1971,-163700
2009-07-15,120 ( 4.35 %),336,752640,2240,303,486470,1606,266170
2009-07-14,115 ( 2.68 %),729,1253170,1719.03,586,1397010,2384,-143840
2009-07-13,112 ( 4.67 %),509,1638510,3219.08,201,535160,2662,1103350
2009-07-10,107 ( 4.9 %),1063,3311360,3115.11,98,49310,503,3262050
2009-07-09,102 ( 4.08 %),1443,3535050,2449.79,172,71590,416,3463460
2009-07-08,98 ( 3.16 %),176,406170,2307.78,279,218250,782,187920
2009-07-07,95 ( -2.06 %),133,395740,2975.49,235,411500,1751,-15760
2009-07-06,97 ( 4.3 %),110,328730,2988.45,141,223050,1582,105680
2009-07-03,93 ( 2.2 %),123,187520,1524.55,108,96370,892,91150
2009-07-02,91 ( 1.11 %),274,621530,2268.36,123,236870,1926,384660
2009-07-01,90 ( -2.17 %),216,427340,1978.43,133,285030,2143,142310
2009-06-30,92 ( -3.66 %),90,132630,1473.67,157,120120,765,12510
2009-06-29,95.5 ( -1.55 %),54,77190,1429.44,316,261340,827,-184150
2009-06-26,97 ( 0 %),80,329450,4118.12,270,292910,1085,36540
2009-06-25,97 ( 3.74 %),106,299590,2826.32,321,251020,782,48570
2009-06-24,93.5 ( 4.47 %),230,267510,1163.09,52,74770,1438,192740
2009-06-23,89.5 ( -4.28 %),200,401740,2008.7,186,284270,1528,117470
2009-06-22,93.5 ( -1.06 %),100,153790,1537.9,153,97490,637,56300
2009-06-19,94.5 ( 0 %),130,206810,1590.85,111,158380,1427,48430
2009-06-18,94.5 ( 5 %),245,401990,1640.78,72,81620,1134,320370
2009-06-17,90 ( -3.23 %),476,710050,1491.7,105,285980,2724,424070
2009-06-16,93 ( -4.62 %),214,358980,1677.48,219,423620,1934,-64640
2009-06-15,97.5 ( -4.41 %),218,388200,1780.73,226,326480,1445,61720
2009-06-12,102 ( -2.86 %),255,185730,728.35,261,273610,1048,-87880
2009-06-11,105 ( 3.96 %),195,187660,962.36,211,188320,893,-660
2009-06-10,101 ( -4.72 %),173,247660,1431.56,550,500400,910,-252740
2009-06-09,106 ( 4.95 %),250,456680,1826.72,414,316690,765,139990
2009-06-08,101 ( 4.66 %),193,466970,2419.53,216,142560,660,324410
2009-06-05,96.5 ( 2.66 %),337,311820,925.28,474,399780,843,-87960
2009-06-04,94 ( 1.08 %),178,345760,1942.47,260,313680,1206,32080
2009-06-03,93 ( 0 %),161,454880,2825.34,294,421630,1434,33250
2009-06-02,93 ( 1.64 %),234,231610,989.79,265,472500,1783,-240890
2009-06-01,91.5 ( 3.98 %),406,408280,1005.62,106,390260,3682,18020
2009-05-29,88 ( -2.22 %),242,273950,1132.02,133,313100,2354,-39150
2009-05-28,90 ( -1.64 %),456,483130,1059.5,104,346180,3329,136950
2009-05-27,91.5 ( -0.54 %),337,361480,1072.64,127,263020,2071,98460
2009-05-26,92 ( -2.65 %),409,382290,934.69,130,363410,2795,18880
2009-05-25,94.5 ( 2.72 %),300,260990,869.97,74,252630,3414,8360
2009-05-22,92 ( -2.65 %),170,265270,1560.41,123,417840,3397,-152570
2009-05-21,94.5 ( -0.53 %),240,346400,1443.33,132,322130,2440,24270
2009-05-20,95 ( -1.04 %),265,243190,917.7,188,537900,2861,-294710
2009-05-19,96 ( -1.03 %),171,182930,1069.77,207,586830,2835,-403900
2009-05-18,97 ( -1.02 %),134,177580,1325.22,147,285050,1939,-107470
2009-05-15,98 ( 2.62 %),123,199390,1621.06,149,276890,1858,-77500
2009-05-14,95.5 ( -2.55 %),145,237130,1635.38,139,331990,2388,-94860
2009-05-13,98 ( 0 %),134,262890,1961.87,220,447890,2036,-185000
2009-05-12,98 ( 0 %),121,196230,1621.74,174,350300,2013,-154070
2009-05-11,98 ( 2.62 %),111,231550,2086.04,232,332040,1431,-100490
2009-05-08,95.5 ( -3.54 %),145,214660,1480.41,212,242250,1143,-27590
2009-05-07,99 ( 3.12 %),141,223570,1585.6,219,147950,676,75620
2009-05-06,96 ( 3.23 %),118,409480,3470.17,668,507930,760,-98450
2009-05-05,93 ( 4.49 %),116,412900,3559.48,211,221270,1049,191630
2009-05-04,89 ( 4.71 %),121,440760,3642.64,163,163680,1004,277080
2009-04-29,85 ( 0 %),89,102760,1154.61,104,115200,1108,-12440
2009-04-28,85 ( -1.73 %),102,125420,1229.61,128,181300,1416,-55880
2009-04-27,86.5 ( 4.22 %),80,250810,3135.12,315,288790,917,-37980
2009-04-24,83 ( 0 %),279,361080,1294.19,91,99320,1091,261760
2009-04-23,83 ( -2.35 %),164,127240,775.85,118,151840,1287,-24600
2009-04-22,85 ( 1.19 %),97,204950,2112.89,197,259840,1319,-54890
2009-04-21,84 ( 5 %),294,510050,1734.86,151,232310,1538,277740
2009-04-20,80 ( -4.19 %),171,369700,2161.99,165,173130,1049,196570
2009-04-17,83.5 ( -4.57 %),189,233310,1234.44,206,390250,1894,-156940
2009-04-16,87.5 ( 0.57 %),187,441900,2363.1,252,580590,2304,-138690
2009-04-15,87 ( -1.69 %),256,735480,2872.97,271,840510,3102,-105030
2009-04-14,88.5 ( 0 %),254,440380,1733.78,306,613370,2004,-172990
2009-04-13,88.5 ( 4.73 %),297,297490,1001.65,188,339890,1808,-42400
2009-04-10,84.5 ( 3.05 %),334,287750,861.53,149,363880,2442,-76130
2009-04-09,82 ( -0.61 %),169,116740,690.77,83,81780,985,34960
2009-04-08,82.5 ( -4.62 %),163,83450,511.96,138,454250,3292,-370800
2009-04-07,86.5 ( 1.17 %),107,129310,1208.5,199,299310,1504,-170000
2009-04-03,85.5 ( 4.27 %),112,230750,2060.27,233,373440,1603,-142690
2009-04-02,82 ( 2.5 %),65,92520,1423.38,184,132440,720,-39920
2009-04-01,80 ( 1.91 %),101,118470,1172.97,109,95020,872,23450
2009-03-31,78.5 ( -1.88 %),77,118650,1540.91,124,160020,1290,-41370
2009-03-30,80 ( -0.62 %),73,124130,1700.41,143,143820,1006,-19690
2009-03-27,80.5 ( -1.23 %),154,119130,773.57,167,259830,1556,-140700
2009-03-26,81.5 ( 1.88 %),60,123990,2066.5,203,272390,1342,-148400
2009-03-25,80 ( 0.63 %),90,125570,1395.22,193,332780,1724,-207210
2009-03-24,79.5 ( 4.61 %),101,264080,2614.65,132,183430,1390,80650
2009-03-23,76 ( -0.65 %),143,194080,1357.2,82,90490,1104,103590
2009-03-20,76.5 ( -1.29 %),189,290380,1536.4,84,85680,1020,204700
2009-03-19,77.5 ( -2.52 %),113,145190,1284.87,210,189770,904,-44580
2009-03-18,79.5 ( 3.92 %),170,227990,1341.12,198,273140,1379,-45150
2009-03-17,76.5 ( 2 %),82,123640,1507.8,152,120540,793,3100
2009-03-16,75 ( 0.67 %),113,95530,845.4,80,89700,1121,5830
2009-03-13,74.5 ( 0 %),89,78880,886.29,101,100940,999,-22060
2009-03-12,74.5 ( -1.32 %),79,121740,1541.01,88,105990,1204,15750
2009-03-11,75.5 ( -0.66 %),128,78880,616.25,111,125830,1134,-46950
2009-03-10,76 ( 0.66 %),148,149100,1007.43,67,68570,1023,80530
2009-03-09,75.5 ( 1.34 %),93,120440,1295.05,63,58820,934,61620
2009-03-06,74.5 ( 0 %),123,167030,1357.97,80,72410,905,94620
2009-03-05,74.5 ( -1.97 %),208,178890,860.05,83,115460,1391,63430
2009-03-04,76 ( 2.7 %),53,67630,1276.04,102,73430,720,-5800
2009-03-03,74 ( -2.63 %),118,107680,912.54,63,56150,891,51530
2009-03-02,76 ( 2.01 %),76,144030,1895.13,95,75330,793,68700
2009-02-27,74.5 ( 1.36 %),174,272470,1565.92,76,117510,1546,154960
2009-02-26,73.5 ( -3.92 %),112,138610,1237.59,126,330540,2623,-191930
2009-02-25,76.5 ( 4.79 %),108,235500,2180.56,66,149360,2263,86140
2009-02-24,73 ( -0.68 %),148,401150,2710.47,91,302370,3323,98780
2009-02-23,73.5 ( -1.34 %),114,289630,2540.61,97,184970,1907,104660
2009-02-20,74.5 ( -1.97 %),177,366560,2070.96,47,221550,4714,145010
2009-02-19,76 ( 1.33 %),110,220320,2002.91,74,96860,1309,123460
2009-02-18,75 ( -1.96 %),196,376860,1922.76,80,247900,3099,128960
2009-02-17,76.5 ( -3.16 %),129,222110,1721.78,62,212910,3434,9200
2009-02-16,79 ( 0.64 %),79,134590,1703.67,44,46770,1063,87820
2009-02-13,78.5 ( -0.63 %),92,159780,1736.74,43,106650,2480,53130
2009-02-12,79 ( 0 %),109,178170,1634.59,50,85290,1706,92880
2009-02-11,79 ( 0 %),112,155860,1391.61,40,70960,1774,84900
2009-02-10,79 ( -2.47 %),105,112730,1073.62,36,80440,2234,32290
2009-02-09,81 ( 0 %),94,74250,789.89,58,96300,1660,-22050
2009-02-06,81 ( 4.52 %),98,200400,2044.9,103,159920,1553,40480
2009-02-05,77.5 ( -1.27 %),100,162890,1628.9,78,116910,1499,45980
2009-02-04,78.5 ( 0 %),110,146880,1335.27,45,91480,2033,55400
2009-02-03,78.5 ( -4.27 %),107,174810,1633.74,87,208260,2394,-33450
2009-02-02,82 ( 0 %),45,73240,1627.56,40,42890,1072,30350
2009-01-23,82 ( 0 %),77,114610,1488.44,33,74520,2258,40090
2009-01-22,82 ( -1.2 %),111,215570,1942.07,54,128100,2372,87470
2009-01-21,83 ( -1.78 %),47,117670,2503.62,48,111190,2316,6480
2009-01-20,84.5 ( 0 %),39,104190,2671.54,55,75170,1367,29020
2009-01-19,84.5 ( 0 %),67,115390,1722.24,70,57570,822,57820
2009-01-16,84.5 ( 1.81 %),92,193690,2105.33,137,207730,1516,-14040
2009-01-15,83 ( -2.35 %),131,323460,2469.16,72,217710,3024,105750
2009-01-14,85 ( 1.19 %),103,222610,2161.26,83,109610,1321,113000
2009-01-13,84 ( 0 %),67,178220,2660,61,46810,767,131410
2009-01-12,84 ( -1.18 %),84,263270,3134.17,59,143820,2438,119450
2009-01-09,85 ( -1.16 %),139,494090,3554.6,111,323490,2914,170600
2009-01-08,86 ( -0.58 %),101,320190,3170.2,151,260010,1722,60180
2009-01-07,86.5 ( 1.76 %),117,425150,3633.76,209,288400,1380,136750
2009-01-06,85 ( 1.19 %),66,210560,3190.3,131,148850,1136,61710
2009-01-05,84 ( -0.59 %),109,293240,2690.28,77,152430,1980,140810
2009-01-02,84.5 ( 1.81 %),71,287900,4054.93,83,90670,1092,197230
2008-12-31,83 ( 0 %),101,186460,1846.14,100,125450,1254,61010
2008-12-30,83 ( 0 %),93,336720,3620.65,105,207110,1972,129610
2008-12-29,83 ( 0.61 %),60,186770,3112.83,79,70660,894,116110
2008-12-26,82.5 ( 0 %),89,260330,2925.06,83,116270,1401,144060
2008-12-25,82.5 ( -0.6 %),65,194850,2997.69,75,75260,1003,119590
2008-12-24,83 ( 1.22 %),100,294140,2941.4,95,114720,1208,179420
2008-12-23,82 ( -2.96 %),90,252480,2805.33,217,321920,1484,-69440
2008-12-22,84.5 ( 0.6 %),86,219650,2554.07,122,178450,1463,41200
2008-12-19,84 ( 1.2 %),88,359800,4088.64,272,254630,936,105170
2008-12-18,83 ( 1.22 %),91,275840,3031.21,145,127490,879,148350
2008-12-17,82 ( 0.61 %),140,276650,1976.07,134,141900,1059,134750
2008-12-16,81.5 ( -2.98 %),90,244940,2721.56,385,358440,931,-113500
2008-12-15,84 ( 3.07 %),124,165110,1331.53,167,171080,1024,-5970
2008-12-12,81.5 ( 4.49 %),111,349580,3149.37,174,236910,1362,112670
2008-12-11,78 ( 4 %),129,376340,2917.36,216,293020,1357,83320
2008-12-10,75 ( -0.66 %),76,124890,1643.29,137,117600,858,7290
2008-12-09,75.5 ( 4.86 %),205,382520,1865.95,101,119160,1180,263360
2008-12-08,72 ( -4 %),116,223060,1922.93,149,216120,1450,6940
2008-12-05,75 ( -1.32 %),114,222140,1948.6,141,213680,1515,8460
2008-12-04,76 ( 1.33 %),155,377750,2437.1,76,213600,2811,164150
2008-12-03,75 ( 1.35 %),113,334360,2958.94,104,111330,1070,223030
2008-12-02,74 ( -1.33 %),118,256120,2170.51,79,62870,796,193250
2008-12-01,75 ( -1.96 %),201,528820,2630.95,130,253320,1949,275500
2008-11-28,76.5 ( 4.79 %),259,509690,1967.92,70,292440,4178,217250
2008-11-27,73 ( -1.35 %),146,317860,2177.12,86,175070,2036,142790
2008-11-26,74 ( -0.67 %),204,410170,2010.64,98,208040,2123,202130
2008-11-25,76.5 ( -1.29 %),313,825140,2636.23,96,570960,5948,254180
2008-11-24,77.5 ( -4.32 %),203,217050,1069.21,108,392470,3634,-175420
2008-11-21,81 ( -1.82 %),206,158530,769.56,75,138140,1842,20390
2008-11-20,82.5 ( -2.94 %),132,125990,954.47,95,155680,1639,-29690
2008-11-19,85 ( -0.58 %),76,144650,1903.29,108,135550,1255,9100
2008-11-18,85.5 ( 0.59 %),83,84910,1023.01,85,107730,1267,-22820
2008-11-17,85 ( -1.73 %),101,158820,1572.48,111,129790,1169,29030
2008-11-14,86.5 ( 0 %),128,92410,721.95,176,232010,1318,-139600
2008-11-13,86.5 ( 4.85 %),273,337260,1235.38,116,126250,1088,211010
2008-11-12,82.5 ( -3.51 %),203,480200,2365.52,146,356250,2440,123950
2008-11-11,85.5 ( -5 %),102,75130,736.57,165,269080,1631,-193950
2008-11-10,90 ( 2.27 %),110,223710,2033.73,235,450560,1917,-226850
2008-11-07,88 ( -4.35 %),124,421270,3397.34,445,588710,1323,-167440
2008-11-06,92 ( 3.37 %),254,1024480,4033.39,567,883050,1557,141430
2008-11-05,89 ( 4.71 %),147,589190,4008.1,69,264630,3835,324560
2008-11-04,85 ( 4.94 %),282,697530,2473.51,193,374010,1938,323520
2008-11-03,81 ( 3.85 %),187,472160,2524.92,253,421890,1668,50270
2008-10-31,78 ( 4.7 %),191,345160,1807.12,110,165850,1508,179310
2008-10-30,74.5 ( 4.93 %),241,457700,1899.17,177,287850,1626,169850
2008-10-29,71 ( 4.41 %),263,681340,2590.65,63,123380,1958,557960
2008-10-28,68 ( -2.86 %),189,313760,1660.11,112,186630,1666,127130
2008-10-27,70 ( -4.76 %),102,261440,2563.14,221,298220,1349,-36780
2008-10-24,73.5 ( -4.55 %),171,216240,1264.56,211,266180,1262,-49940
2008-10-23,77 ( -4.94 %),260,409770,1576.04,163,509430,3125,-99660
2008-10-22,81 ( -2.41 %),190,326380,1717.79,178,295830,1662,30550
2008-10-21,83 ( 1.84 %),196,357890,1825.97,126,110260,875,247630
2008-10-20,81.5 ( 0 %),190,334350,1759.74,176,185750,1055,148600
2008-10-17,81.5 ( -4.68 %),429,499960,1165.41,186,531190,2856,-31230
2008-10-16,85.5 ( -4.47 %),206,403730,1959.85,168,360400,2145,43330
2008-10-15,89.5 ( 0 %),248,406200,1637.9,270,594950,2204,-188750
2008-10-14,89.5 ( 4.68 %),230,750420,3262.7,37,200270,5413,550150
2008-10-13,85.5 ( -4.47 %),241,211520,877.68,154,299960,1948,-88440
2008-10-10,89.5 ( -4.79 %),180,226550,1258.61,157,381650,2431,-155100
2008-10-09,94 ( 4.44 %),254,383670,1510.51,308,280790,912,102880
2008-10-08,90 ( 0 %),297,868930,2925.69,163,335210,2057,533720
2008-10-07,90 ( -3.74 %),256,707900,2765.23,251,358340,1428,349560
2008-10-06,93.5 ( -0.53 %),310,737030,2377.52,243,332850,1370,404180
2008-10-03,94 ( -0.53 %),254,885060,3484.49,129,248990,1930,636070
2008-10-02,94.5 ( -0.53 %),238,699120,2937.48,161,330420,2052,368700
2008-10-01,95 ( 4.97 %),725,817330,1127.35,153,251650,1645,565680
2008-09-30,90.5 ( -4.74 %),393,506850,1289.69,323,541740,1677,-34890
2008-09-29,95 ( -2.56 %),201,212120,1055.32,153,116730,763,95390
2008-09-26,97.5 ( 4.84 %),402,530190,1318.88,144,191000,1326,339190
2008-09-25,93 ( -3.88 %),591,719670,1217.72,149,494310,3318,225360
2008-09-24,97 ( -4.9 %),151,99820,661.06,150,196280,1309,-96460
2008-09-23,102 ( 2.51 %),169,369870,2188.58,200,414230,2071,-44360
2008-09-22,99.5 ( 4.74 %),206,451050,2189.56,13,31520,2425,419530
2008-09-19,95 ( 4.97 %),388,637100,1642.01,38,104930,2761,532170
2008-09-18,90.5 ( -4.74 %),175,170650,975.14,150,199360,1329,-28710
2008-09-17,95 ( -3.8 %),184,210150,1142.12,126,110150,874,100000
2008-09-16,99 ( -4.81 %),228,99420,436.05,111,123750,1115,-24330
2008-09-15,104 ( 1.96 %),332,404090,1217.14,102,146580,1437,257510
2008-09-12,102 ( -1.92 %),288,181950,631.77,100,114180,1142,67770
2008-09-11,104 ( -4.59 %),214,113590,530.79,116,105940,913,7650
2008-09-10,109 ( 0.93 %),119,104230,875.88,241,153870,638,-49640
2008-09-09,108 ( 0.93 %),174,114610,658.68,98,86360,881,28250
2008-09-08,107 ( -4.46 %),203,93980,462.96,168,167240,995,-73260
2008-09-05,112 ( -3.45 %),110,59490,540.82,276,201500,730,-142010
2008-09-04,116 ( 4.5 %),120,407850,3398.75,227,250090,1102,157760
2008-09-03,111 ( 4.72 %),329,523190,1590.24,64,312910,4889,210280
2008-08-29,106 ( -4.5 %),357,458830,1285.24,195,710700,3645,-251870
2008-08-28,111 ( -1.77 %),179,542390,3030.11,267,710680,2662,-168290
2008-08-27,113 ( -4.24 %),241,450650,1869.92,342,554360,1621,-103710
2008-08-26,118 ( 0 %),237,663900,2801.27,348,744160,2138,-80260
2008-08-25,118 ( 3.51 %),261,652080,2498.39,297,398120,1340,253960
2008-08-22,114 ( -2.56 %),181,451370,2493.76,310,481480,1553,-30110
2008-08-21,117 ( 1.74 %),164,622710,3797.01,303,559690,1847,63020
2008-08-20,115 ( 0.88 %),150,525080,3500.53,450,441680,982,83400
2008-08-19,114 ( -0.87 %),165,632390,3832.67,522,824700,1580,-192310
2008-08-18,115 ( 4.55 %),134,291110,2172.46,161,197220,1225,93890
2008-08-15,111 ( 2.78 %),161,350060,2174.29,56,73910,1320,276150
2008-08-14,108 ( 2.86 %),340,419250,1233.09,215,255710,1189,163540
2008-08-13,105 ( 0 %),231,187090,809.91,230,265840,1156,-78750
2008-08-12,105 ( -1.87 %),187,141690,757.7,353,297420,843,-155730
2008-08-11,107 ( 2.88 %),170,115760,680.94,98,83940,857,31820
2008-08-08,104 ( -0.95 %),176,170170,966.88,190,142160,748,28010
2008-08-07,105 ( 1.94 %),110,279190,2538.09,176,270840,1539,8350
2008-08-06,103 ( 3 %),463,485510,1048.62,87,232950,2678,252560
2008-08-05,100 ( -2.91 %),26,36590,1407.31,175,235660,1347,-199070
2008-08-04,103 ( -2.83 %),47,77450,1647.87,231,292680,1267,-215230
2008-08-01,106 ( -2.75 %),123,219480,1784.39,372,292120,785,-72640
2008-07-31,109 ( 1.87 %),142,192270,1354.01,265,199640,753,-7370
2008-07-30,107 ( 2.88 %),188,464590,2471.22,248,171540,692,293050
2008-07-29,104 ( 2.97 %),280,493240,1761.57,19,36580,1925,456660
2008-07-28,101 ( 2.02 %),518,372840,719.77,217,481790,2220,-108950
2008-07-25,99 ( -2.94 %),84,110790,1318.93,318,564250,1774,-453460
2008-07-24,102 ( -2.86 %),130,337350,2595,504,743270,1475,-405920
2008-07-23,105 ( -2.78 %),8,2170,271.25,564,812940,1441,-810770
2008-07-22,108 ( -2.7 %),10,8650,865,697,991070,1422,-982420
2008-07-21,111 ( -2.63 %),29,14160,488.28,522,562760,1078,-548600
2008-07-18,114 ( -2.56 %),82,54230,661.34,367,303570,827,-249340
2008-07-17,117 ( -2.5 %),441,240000,544.22,379,391370,1033,-151370
2008-07-16,120 ( -2.44 %),169,64020,378.82,276,338400,1226,-274380
2008-07-15,123 ( 2.5 %),525,363540,692.46,176,257030,1460,106510
2008-07-14,120 ( 1.69 %),408,228390,559.78,146,168790,1156,59600
2008-07-11,118 ( 2.61 %),278,396490,1426.22,87,302570,3478,93920
2008-07-10,115 ( 2.68 %),267,477040,1786.67,86,328110,3815,148930
2008-07-09,112 ( -2.61 %),344,332310,966.02,117,418860,3580,-86550
2008-07-08,115 ( 0 %),198,217020,1096.06,225,255370,1135,-38350
2008-07-07,115 ( -2.54 %),205,314860,1535.9,247,354760,1436,-39900
2008-07-04,118 ( 2.61 %),226,658610,2914.2,35,157230,4492,501380
2008-07-03,115 ( 2.68 %),202,675650,3344.8,22,134410,6110,541240
2008-07-02,112 ( 2.75 %),193,477360,2473.37,34,217540,6398,259820
2008-07-01,109 ( 2.83 %),162,243270,1501.67,14,26260,1876,217010
2008-06-30,106 ( 2.91 %),177,322530,1822.2,42,95500,2274,227030
2008-06-27,103 ( 3 %),170,575290,3384.06,185,112550,608,462740
2008-06-26,100 ( 2.56 %),105,375270,3574,166,129730,782,245540
2008-06-25,97.5 ( 2.63 %),115,443600,3857.39,23,40310,1753,403290
2008-06-24,95 ( 2.7 %),72,165220,2294.72,40,37440,936,127780
2008-06-23,92.5 ( 2.78 %),191,230530,1206.96,100,95490,955,135040
2008-06-20,90 ( -2.7 %),65,154500,2376.92,249,289950,1164,-135450
2008-06-19,92.5 ( -2.63 %),48,76910,1602.29,276,277220,1004,-200310
2008-06-18,95 ( 1.6 %),216,539500,2497.69,160,129760,811,409740
2008-06-17,93.5 ( 1.63 %),250,348220,1392.88,13,55150,4242,293070
2008-06-16,92 ( 1.66 %),293,223860,764.03,49,205790,4200,18070
2008-06-13,90.5 ( -1.63 %),359,434510,1210.33,118,475000,4025,-40490
2008-06-12,92 ( -1.6 %),76,108920,1433.16,161,999580,6209,-890660
2008-06-11,93.5 ( -1.58 %),76,160500,2111.84,174,945290,5433,-784790
2008-06-10,95 ( -1.55 %),6,1180,196.67,191,928320,4860,-927140
2008-06-09,96.5 ( -1.53 %),16,14330,895.62,179,907750,5071,-893420
2008-06-06,98 ( -2 %),15,20360,1357.33,196,1018810,5198,-998450
2008-06-05,100 ( -1.96 %),13,6990,537.69,199,831180,4177,-824190
2008-06-04,102 ( -1.92 %),10,5610,561,192,829890,4322,-824280
2008-06-03,104 ( -1.89 %),9,5950,661.11,177,781710,4416,-775760
2008-06-02,106 ( -1.85 %),5,1280,256,166,558750,3366,-557470
2008-05-30,108 ( -1.82 %),16,4740,296.25,169,620630,3672,-615890
2008-05-29,110 ( 0 %),0,0,0,0,0,0,0
2008-05-28,110 ( 0 %),0,0,0,0,0,0,0
2008-05-27,110 ( 0 %),0,0,0,0,0,0,0
2008-05-26,110 ( -1.79 %),11,73400,6672.73,203,532000,2621,-458600
2008-05-23,112 ( -1.75 %),22,16670,757.73,205,183750,896,-167080
2008-05-22,114 ( -1.72 %),4,920,230,245,502440,2051,-501520
2008-05-21,116 ( -1.69 %),14,12020,858.57,225,423000,1880,-410980
2008-05-20,118 ( -1.67 %),20,8200,410,180,367730,2043,-359530
2008-05-19,120 ( -1.64 %),19,36280,1909.47,161,326530,2028,-290250
2008-05-16,122 ( -1.61 %),56,102910,1837.68,190,342590,1803,-239680
2008-05-15,124 ( -1.59 %),4,230,57.5,241,559530,2322,-559300
2008-05-14,126 ( -1.56 %),5,3080,616,276,613100,2221,-610020
2008-05-13,128 ( -1.54 %),9,6820,757.78,324,532610,1644,-525790
2008-05-12,130 ( -1.52 %),6,28170,4695,327,476390,1457,-448220
2008-05-09,132 ( -1.49 %),14,18080,1291.43,286,383380,1340,-365300
2008-05-08,134 ( -1.47 %),22,93640,4256.36,250,376970,1508,-283330
2008-05-07,136 ( -1.45 %),123,82500,670.73,239,238040,996,-155540
2008-05-06,138 ( 1.47 %),199,332520,1670.95,115,202520,1761,130000
2008-05-05,136 ( 1.49 %),148,345560,2334.86,71,209900,2956,135660
2008-04-29,134 ( 1.52 %),87,377100,4334.48,36,40040,1112,337060
2008-04-28,132 ( 1.54 %),99,204530,2065.96,67,65580,979,138950
2008-04-25,130 ( 1.56 %),93,169450,1822.04,105,59020,562,110430
2008-04-24,128 ( 1.59 %),83,196590,2368.55,140,66170,473,130420
2008-04-23,126 ( -1.56 %),113,225310,1993.89,263,314370,1195,-89060
2008-04-22,128 ( 1.59 %),116,208020,1793.28,142,121560,856,86460
2008-04-21,126 ( 1.61 %),90,308530,3428.11,57,50760,891,257770
2008-04-18,124 ( 1.64 %),104,342650,3294.71,138,221110,1602,121540
2008-04-17,122 ( 1.67 %),151,260190,1723.11,104,92310,888,167880
2008-04-16,121 ( -1.63 %),51,117320,2300.39,220,228230,1037,-110910
2008-04-11,123 ( 1.65 %),121,423900,3503.31,314,237700,757,186200
2008-04-10,121 ( 1.68 %),200,894810,4474.05,530,555130,1047,339680
2008-04-09,119 ( 1.71 %),186,606480,3260.65,74,136790,1849,469690
2008-04-08,117 ( 1.74 %),236,907550,3845.55,90,139800,1553,767750
2008-04-07,115 ( 1.77 %),215,755650,3514.65,6,2400,400,753250
2008-04-04,113 ( 0.89 %),227,431050,1898.9,4,5400,1350,425650
2008-04-03,112 ( 0.9 %),221,396170,1792.62,5,1300,260,394870
2008-04-02,111 ( 0.91 %),264,722430,2736.48,4,5380,1345,717050
2008-04-01,110 ( 0.92 %),283,703370,2485.41,4,800,200,702570
2008-03-31,109 ( 0.93 %),278,835400,3005.04,16,23230,1452,812170
2008-03-28,108 ( 0.93 %),285,676110,2372.32,10,50560,5056,625550
2008-03-27,107 ( 0.94 %),171,492540,2880.35,13,6830,525,485710
2008-03-26,106 ( 2.91 %),242,413450,1708.47,142,265140,1867,148310
2008-03-25,103 ( -4.63 %),90,146310,1625.67,158,386220,2444,-239910
2008-03-24,108 ( -4.42 %),107,181500,1696.26,132,373760,2832,-192260
2008-03-21,113 ( -4.24 %),163,180290,1106.07,184,216180,1175,-35890
2008-03-20,118 ( 3.51 %),121,126040,1041.65,170,117070,689,8970
2008-03-19,114 ( 1.79 %),217,185910,856.73,126,133540,1060,52370
2008-03-18,112 ( -4.27 %),127,147290,1159.76,169,133430,790,13860
2008-03-17,117 ( -4.88 %),135,131500,974.07,149,214010,1436,-82510
2008-03-14,123 ( 0.82 %),152,256900,1690.13,212,212900,1004,44000
2008-03-13,122 ( 1.67 %),199,275530,1384.57,199,274590,1380,940
2008-03-12,120 ( 1.69 %),229,266110,1162.05,208,209590,1008,56520
2008-03-11,118 ( 0.85 %),498,340980,684.7,442,436690,988,-95710
2008-03-10,117 ( 4.46 %),535,1037370,1939.01,63,125410,1991,911960
2008-03-07,112 ( 4.67 %),689,1318730,1913.98,10,21920,2192,1296810
2008-03-06,107 ( 4.9 %),546,1117830,2047.31,19,25050,1318,1092780
2008-03-05,102 ( -4.67 %),133,196540,1477.74,196,216120,1103,-19580
2008-03-04,107 ( -4.46 %),106,145300,1370.75,255,196430,770,-51130
2008-03-03,112 ( -4.27 %),190,149920,789.05,178,167400,940,-17480
2008-02-29,117 ( -4.1 %),245,189680,774.2,138,205950,1492,-16270
2008-02-28,122 ( -2.4 %),191,142610,746.65,143,163910,1146,-21300
2008-02-27,125 ( 3.31 %),175,232300,1327.43,252,149610,594,82690
2008-02-26,121 ( 1.68 %),246,387880,1576.75,419,424400,1013,-36520
2008-02-25,119 ( 4.39 %),306,417590,1364.67,61,84320,1382,333270
2008-02-22,114 ( -5 %),317,388340,1225.05,189,400860,2121,-12520
2008-02-21,120 ( -4.76 %),172,282580,1642.91,281,357900,1274,-75320
2008-02-20,126 ( -3.82 %),201,113670,565.52,197,162500,825,-48830
2008-02-19,131 ( 0 %),307,241870,787.85,119,122890,1033,118980
2008-02-18,131 ( -4.38 %),335,259470,774.54,132,195610,1482,63860
2008-02-15,137 ( -0.72 %),136,90490,665.37,117,116440,995,-25950
2008-02-14,138 ( 1.47 %),201,149710,744.83,147,223310,1519,-73600
2008-02-13,136 ( -2.86 %),539,505390,937.64,83,275450,3319,229940
2008-02-12,140 ( -3.45 %),171,86870,508.01,77,88330,1147,-1460
2008-02-01,145 ( 2.11 %),293,208270,710.82,112,295610,2639,-87340
2008-01-31,142 ( 4.41 %),688,618540,899.04,136,377100,2773,241440
2008-01-30,136 ( -4.9 %),377,436770,1158.54,152,481310,3167,-44540
2008-01-29,143 ( 3.62 %),250,301630,1206.52,150,207150,1381,94480
2008-01-28,138 ( 1.47 %),160,255210,1595.06,161,313920,1950,-58710
2008-01-25,136 ( 4.62 %),180,215850,1199.17,166,122030,735,93820
2008-01-24,130 ( -4.41 %),208,188330,905.43,133,218110,1640,-29780
2008-01-23,136 ( -4.9 %),202,177470,878.56,91,236720,2601,-59250
2008-01-22,143 ( -4.67 %),459,306420,667.58,93,281060,3022,25360
2008-01-21,150 ( -1.96 %),153,97380,636.47,91,84120,924,13260
2008-01-18,153 ( 1.32 %),118,71830,608.73,72,63960,888,7870
2008-01-17,151 ( -3.21 %),304,266750,877.47,97,236900,2442,29850
2008-01-16,156 ( 4.7 %),255,325650,1277.06,85,273060,3212,52590
2008-01-15,149 ( -4.49 %),159,165050,1038.05,95,145340,1530,19710
2008-01-14,156 ( -0.64 %),87,89470,1028.39,150,186720,1245,-97250
2008-01-11,157 ( 1.29 %),151,141420,936.56,96,76740,799,64680
2008-01-10,155 ( -4.91 %),268,225140,840.07,141,294970,2092,-69830
2008-01-09,163 ( -1.81 %),73,38930,533.29,80,58880,736,-19950
2008-02-13,136 ( -2.86 %),539,505390,937.64,83,275450,3319,229940
2008-02-12,140 ( -3.45 %),171,86870,508.01,77,88330,1147,-1460
2008-02-01,145 ( 2.11 %),293,208270,710.82,112,295610,2639,-87340
2008-01-31,142 ( 4.41 %),688,618540,899.04,136,377100,2773,241440
2008-01-30,136 ( -4.9 %),377,436770,1158.54,152,481310,3167,-44540
2008-01-29,143 ( 3.62 %),250,301630,1206.52,150,207150,1381,94480
2008-01-28,138 ( 1.47 %),160,255210,1595.06,161,313920,1950,-58710
2008-01-25,136 ( 4.62 %),180,215850,1199.17,166,122030,735,93820
2008-01-24,130 ( -4.41 %),208,188330,905.43,133,218110,1640,-29780
2008-01-23,136 ( -4.9 %),202,177470,878.56,91,236720,2601,-59250
2008-01-22,143 ( -4.67 %),459,306420,667.58,93,281060,3022,25360
2008-01-21,150 ( -1.96 %),153,97380,636.47,91,84120,924,13260
2008-01-18,153 ( 1.32 %),118,71830,608.73,72,63960,888,7870
2008-01-17,151 ( -3.21 %),304,266750,877.47,97,236900,2442,29850
2008-01-16,156 ( 4.7 %),255,325650,1277.06,85,273060,3212,52590
2008-01-15,149 ( -4.49 %),159,165050,1038.05,95,145340,1530,19710
2008-01-14,156 ( -0.64 %),87,89470,1028.39,150,186720,1245,-97250
2008-01-11,157 ( 1.29 %),151,141420,936.56,96,76740,799,64680
2008-01-10,155 ( -4.91 %),268,225140,840.07,141,294970,2092,-69830
2008-01-09,163 ( -1.81 %),73,38930,533.29,80,58880,736,-19950
2007-12-07,171 ( -0.58 %),86,74460,865.81,161,99650,619,-25190
2007-12-06,172 ( 1.18 %),153,267590,1748.95,428,370050,865,-102460
2007-12-05,170 ( -1.73 %),111,72970,657.39,128,118820,928,-45850
2007-12-04,173 ( 0 %),303,354200,1168.98,209,170770,817,183430
2007-12-03,173 ( 4.22 %),352,341870,971.22,113,90060,797,251810
2007-11-30,166 ( -1.78 %),1046,694030,663.51,72,334410,4645,359620
2007-11-29,169 ( -0.59 %),451,312100,692.02,77,199050,2585,113050
2007-11-28,170 ( -2.3 %),317,278570,878.77,97,195660,2017,82910
2007-11-27,174 ( 1.16 %),93,279970,3010.43,261,321970,1234,-42000
2007-11-26,172 ( 1.18 %),116,168020,1448.45,89,87950,988,80070
2007-11-23,170 ( 0 %),134,135750,1013.06,101,200370,1984,-64620
2007-11-22,170 ( 0 %),295,197350,668.98,163,322910,1981,-125560
2007-11-21,170 ( -1.73 %),295,197350,668.98,163,322910,1981,-125560
2007-11-20,173 ( -2.81 %),223,291080,1305.29,180,180650,1004,110430
2007-11-19,178 ( 1.71 %),42,92850,2210.71,120,86260,719,6590
2007-11-16,175 ( 1.16 %),86,128790,1497.56,132,107500,814,21290
2007-11-15,173 ( 4.85 %),248,173200,698.39,95,154890,1630,18310
2007-11-14,165 ( -2.94 %),698,698870,1001.25,69,532520,7718,166350
2007-11-13,170 ( -4.49 %),121,96980,801.49,141,328260,2328,-231280
2007-11-12,178 ( -1.11 %),89,103130,1158.76,160,186170,1164,-83040
2007-11-09,180 ( 0 %),62,72870,1175.32,124,156540,1262,-83670
2007-11-08,180 ( 1.12 %),66,38460,582.73,58,88710,1529,-50250
2007-11-07,178 ( 1.14 %),230,153240,666.26,54,78500,1454,74740
2007-11-06,176 ( -1.12 %),311,230020,739.61,57,134680,2363,95340
2007-11-05,178 ( -4.3 %),382,422510,1106.05,212,475200,2242,-52690
2007-11-02,186 ( 1.09 %),172,261710,1521.57,280,320600,1145,-58890
2007-11-01,184 ( 0 %),171,177680,1039.06,113,267270,2365,-89590
2007-10-31,184 ( -2.65 %),146,168390,1153.36,156,174080,1116,-5690
2007-10-30,189 ( 4.42 %),115,372790,3241.65,198,324580,1639,48210
2007-10-29,181 ( -4.74 %),119,136350,1145.8,158,650660,4118,-514310
2007-10-26,190 ( 1.06 %),42,136520,3250.48,150,122930,820,13590
2007-10-25,188 ( 0 %),93,157010,1688.28,176,293850,1670,-136840
2007-10-24,188 ( 3.3 %),147,167360,1138.5,53,98850,1865,68510
2007-10-23,182 ( -1.62 %),255,270430,1060.51,100,276660,2767,-6230
2007-10-22,185 ( -2.63 %),164,144820,883.05,111,305010,2748,-160190
2007-10-19,190 ( -2.06 %),99,149080,1505.86,135,178990,1326,-29910
2007-10-18,194 ( 0.52 %),54,174430,3230.19,304,243840,802,-69410
2007-10-17,193 ( -0.52 %),51,63440,1243.92,176,102160,580,-38720
2007-10-16,194 ( 0 %),65,83680,1287.38,275,217600,791,-133920
2007-10-15,194 ( -0.51 %),35,36270,1036.29,308,224570,729,-188300
2007-10-12,195 ( 2.09 %),66,209280,3170.91,263,213940,813,-4660
2007-10-11,191 ( -1.55 %),73,89010,1219.32,268,222550,830,-133540
2007-10-10,194 ( 2.65 %),56,217170,3878.04,432,371300,859,-154130
2007-10-09,189 ( 1.07 %),71,94500,1330.99,230,191210,831,-96710
2007-10-08,187 ( 0 %),94,149130,1586.49,139,112520,809,36610
2007-10-05,187 ( -2.09 %),141,265130,1880.35,216,232960,1079,32170
2007-10-04,191 ( -3.54 %),137,493860,3604.82,404,572480,1417,-78620
2007-10-03,198 ( 1.54 %),110,374810,3407.36,555,459400,828,-84590
2007-10-02,195 ( 2.09 %),182,499230,2743.02,602,617320,1025,-118090
2007-10-01,191 ( 4.95 %),207,602360,2909.95,302,472290,1564,130070
2007-09-28,182 ( 4.6 %),102,370780,3635.1,373,305110,818,65670
2007-09-27,174 ( 0.58 %),104,235070,2260.29,558,473840,849,-238770
2007-09-26,173 ( -1.14 %),94,82420,876.81,305,166860,547,-84440
2007-09-25,175 ( 4.17 %),178,378670,2127.36,299,373360,1249,5310
2007-09-24,168 ( 1.2 %),126,179750,1426.59,135,127750,946,52000
2007-09-21,166 ( -1.19 %),98,89200,910.2,167,139110,833,-49910
2007-09-20,168 ( 1.2 %),163,147950,907.67,211,150650,714,-2700
2007-09-19,166 ( 0 %),93,210900,2267.74,233,158780,681,52120
2007-09-18,166 ( 0 %),68,167930,2469.56,273,156140,572,11790
2007-09-17,166 ( 0.61 %),86,254180,2955.58,292,144450,495,109730
2007-09-14,165 ( 1.85 %),145,496390,3423.38,435,199940,460,296450
2007-09-13,162 ( 0.62 %),97,157000,1618.56,160,76490,478,80510
2007-09-12,161 ( 0 %),112,158030,1410.98,220,122230,556,35800
2007-09-11,161 ( 0.62 %),152,209480,1378.16,184,112680,612,96800
2007-09-10,160 ( -1.23 %),212,171970,811.18,339,390290,1151,-218320
2007-09-07,162 ( 1.25 %),254,243950,960.43,165,305830,1854,-61880
2007-09-06,160 ( 0.63 %),520,281410,541.17,109,328220,3011,-46810
2007-09-05,159 ( -3.05 %),243,311270,1280.95,216,541270,2506,-230000
2007-09-04,164 ( 2.5 %),254,336290,1323.98,177,288550,1630,47740
2007-08-31,160 ( -1.23 %),794,525970,662.43,103,530750,5153,-4780
2007-08-30,162 ( 0 %),303,261170,861.95,119,363730,3057,-102560
2007-08-29,162 ( -0.61 %),237,128510,542.24,87,226340,2602,-97830
2007-08-28,163 ( -1.21 %),250,164670,658.68,88,195280,2219,-30610
2007-08-27,165 ( 0.61 %),155,159110,1026.52,254,293420,1155,-134310
2007-08-24,164 ( 0 %),115,82180,714.61,142,148690,1047,-66510
2007-08-23,164 ( 0 %),101,65610,649.6,85,95890,1128,-30280
2007-08-22,164 ( -0.61 %),135,144120,1067.56,266,339890,1278,-195770
2007-08-21,165 ( 1.23 %),176,161440,917.27,218,180100,826,-18660
2007-08-20,163 ( -0.61 %),339,245040,722.83,150,337340,2249,-92300
2007-08-17,164 ( -0.61 %),403,252540,626.65,77,243660,3164,8880
2007-08-16,165 ( -1.79 %),383,244480,638.33,100,281740,2817,-37260
2007-08-15,168 ( -0.59 %),193,167110,865.85,138,318270,2306,-151160
2007-08-14,169 ( 0.6 %),174,176940,1016.9,116,195410,1685,-18470
2007-08-13,168 ( -2.33 %),262,218320,833.28,138,231020,1674,-12700
2007-08-10,172 ( 0 %),158,200220,1267.22,90,192010,2133,8210
2007-08-09,172 ( 2.99 %),162,221830,1369.32,89,143590,1613,78240
2007-08-08,167 ( 1.21 %),589,392540,666.45,68,139050,2045,253490
2007-08-07,165 ( -2.94 %),241,172430,715.48,63,286080,4541,-113650
2007-08-06,170 ( -1.16 %),78,57820,741.28,73,182710,2503,-124890
2007-08-03,172 ( -1.71 %),146,109600,750.68,77,193010,2507,-83410
2007-08-02,175 ( -1.13 %),83,113310,1365.18,105,296420,2823,-183110
2007-08-01,177 ( -0.56 %),96,246540,2568.12,90,234260,2603,12280
2007-07-31,178 ( 0.56 %),105,216510,2062,94,244040,2596,-27530
2007-07-30,177 ( 2.91 %),64,166700,2604.69,86,217130,2525,-50430
2007-07-27,172 ( -3.37 %),252,131070,520.12,80,179050,2238,-47980
2007-07-26,178 ( -1.11 %),32,87690,2740.31,231,263650,1141,-175960
2007-07-25,180 ( 0 %),49,168650,3441.84,204,241020,1181,-72370
2007-07-24,180 ( 1.12 %),53,197130,3719.43,173,184560,1067,12570
2007-07-23,178 ( 1.14 %),130,124520,957.85,68,91020,1339,33500
2007-07-20,176 ( -0.56 %),63,63340,1005.4,66,98750,1496,-35410
2007-07-19,177 ( -0.56 %),56,141040,2518.57,82,160050,1952,-19010
2007-07-18,178 ( 0 %),82,69310,845.24,79,122960,1556,-53650
2007-07-17,178 ( -0.56 %),119,164450,1381.93,92,213530,2321,-49080
2007-07-16,179 ( -0.56 %),67,144270,2153.28,118,205920,1745,-61650
2007-07-13,180 ( -1.1 %),42,94300,2245.24,174,224630,1291,-130330
2007-07-12,182 ( -0.55 %),37,87340,2360.54,182,153930,846,-66590
2007-07-11,183 ( 0 %),49,162550,3317.35,239,184730,773,-22180
2007-07-10,183 ( 1.67 %),67,174060,2597.91,267,173700,651,360
2007-07-09,180 ( 0 %),412,388210,942.26,147,216330,1472,171880
2007-07-06,180 ( -1.64 %),333,438380,1316.46,216,314840,1458,123540
2007-07-05,183 ( 2.23 %),67,321090,4792.39,435,476220,1095,-155130
2007-07-04,179 ( 4.68 %),129,283810,2200.08,52,28390,546,255420
2007-07-03,171 ( -2.29 %),278,265850,956.29,86,173640,2019,92210
2007-07-02,175 ( -2.78 %),169,124200,734.91,136,404250,2972,-280050
