Ngày,Thay đổi,Số lệnh mua,Kl mua,KLTB 1 lệnh mua,Số lệnh bán,Kl bán,KLTB 1 lệnh bán,Kl ròng
2025-05-07,23.25 ( -1.27 %),0,0,0,0,0,0,0
2025-05-06,23.55 ( 0 %),0,0,0,0,0,0,0
2025-05-05,23.55 ( 0 %),0,0,0,0,0,0,0
2025-04-29,23.55 ( -0.63 %),8067,25728500,3189.35,8231,33490900,4069,-7762400
2025-04-28,23.7 ( 0.64 %),9540,42824800,4488.97,12070,53701000,4449,-10876200
2025-04-25,23.55 ( 1.29 %),12486,77899900,6238.98,19156,81175600,4238,-3275700
2025-04-24,23.25 ( -0.64 %),11582,41371700,3572.07,9443,40982100,4340,389600
2025-04-23,23.4 ( 1.3 %),12547,62755900,5001.67,15632,70014800,4479,-7258900
2025-04-22,23.1 ( 0.65 %),24095,105250100,4368.13,13192,76025700,5763,29224400
2025-04-21,22.95 ( -1.29 %),17659,72957800,4131.48,8579,71914900,8383,1042900
2025-04-18,23.25 ( 1.09 %),12399,70320300,5671.45,11749,56810600,4835,13509700
2025-04-17,23 ( 0.44 %),14035,43529500,3101.5,7788,34248900,4398,9280600
2025-04-16,22.9 ( -0.43 %),11380,59261500,5207.51,8727,43467000,4981,15794500
2025-04-15,23 ( -1.92 %),14360,53710900,3740.31,13347,55737200,4176,-2026300
2025-04-14,23.45 ( 0 %),13067,64014600,4898.95,14796,68059900,4600,-4045300
2025-04-11,23.45 ( 6.35 %),33783,148575200,4397.93,24366,134494100,5520,14081100
2025-04-10,22.05 ( 6.78 %),26360,231481800,8781.56,752,1687200,2244,229794600
2025-04-09,20.65 ( -1.2 %),29036,108198500,3726.36,16286,86135600,5289,22062900
2025-04-08,20.9 ( -6.9 %),22513,71222000,3163.59,8928,110284400,12353,-39062400
2025-04-04,22.45 ( -0.88 %),34263,130745800,3815.95,13660,111602500,8170,19143300
2025-04-03,22.65 ( -6.98 %),26454,106607000,4029.9,15016,184062500,12258,-77455500
2025-04-02,24.35 ( -1.02 %),5040,18465700,3663.83,6278,31039300,4944,-12573600
2025-04-01,24.6 ( 2.07 %),5991,34339100,5731.78,5109,23615300,4622,10723800
2025-03-31,24.1 ( 0.84 %),6067,39028500,6432.92,4658,27319600,5865,11708900
2025-03-28,23.9 ( 0 %),6288,29324200,4663.52,4557,21460400,4709,7863800
2025-03-27,23.9 ( -0.42 %),6830,23504900,3441.42,3807,22757400,5978,747500
2025-03-26,24 ( -0.83 %),7140,32953300,4615.31,4798,39255300,8182,-6302000
2025-03-25,24.2 ( -0.82 %),5307,28966100,5458.09,5188,28978100,5586,-12000
2025-03-24,24.4 ( 0.41 %),7786,36748900,4719.87,4907,29942400,6102,6806500
2025-03-21,24.3 ( 0.21 %),5721,32164800,5622.23,6446,33670300,5223,-1505500
2025-03-20,24.25 ( 1.68 %),7983,48939200,6130.43,6926,38070500,5497,10868700
2025-03-19,23.85 ( -0.21 %),11117,46209900,4156.69,4187,35283700,8427,10926200
2025-03-18,23.9 ( -1.65 %),11373,51730500,4548.54,4423,45916600,10381,5813900
2025-03-17,24.3 ( 0 %),8798,52972800,6021,4129,41356200,10016,11616600
2025-03-14,24.3 ( 0 %),6852,50859700,7422.61,5493,33228900,6049,17630800
2025-03-12,24.6 ( -0.81 %),7074,65684300,9285.31,8745,58127100,6647,7557200
2025-03-11,24.8 ( 1.22 %),8778,74093100,8440.77,7186,43119600,6001,30973500
2025-03-10,24.5 ( 0 %),6146,42624800,6935.37,9298,40505100,4356,2119700
2025-03-07,24.5 ( 1.66 %),12047,145774000,12100.44,16499,84613600,5128,61160400
2025-03-06,0 ( 0 %),4981,75535000,15164.63,11056,43343500,3920,32191500
2025-03-05,23.55 ( 0.64 %),10375,74288300,7160.32,16382,64805300,3956,9483000
2025-03-04,23.4 ( 1.3 %),8062,52130400,6466.19,7472,41271600,5524,10858800
2025-03-03,23.1 ( 0.43 %),4815,20321800,4220.52,4472,19249200,4304,1072600
2025-02-28,23 ( -0.86 %),6572,22901800,3484.75,4142,21457700,5181,1444100
2025-02-27,23.2 ( 0 %),7228,26987900,3733.8,4765,24351300,5110,2636600
2025-02-26,23.2 ( -0.85 %),5191,17012200,3277.25,5414,23685500,4375,-6673300
2025-02-25,23.4 ( 1.74 %),9278,63968400,6894.63,10857,64443800,5936,-475400
2025-02-24,23 ( 0.44 %),7039,27023200,3839.07,5414,27393000,5060,-369800
2025-02-21,22.9 ( 0.22 %),8228,37568600,4565.95,7837,46687400,5957,-9118800
2025-02-20,22.85 ( 0 %),6048,23364500,3863.18,5434,26823400,4936,-3458900
2025-02-19,22.85 ( 0.66 %),4777,19408300,4062.86,4769,21048200,4414,-1639900
2025-02-18,22.7 ( 0.22 %),5901,22378900,3792.39,4313,22891400,5308,-512500
2025-02-17,22.65 ( -0.88 %),6100,16075400,2635.31,3556,22803300,6413,-6727900
2025-02-14,22.85 ( -0.22 %),4634,16984800,3665.26,5004,25235100,5043,-8250300
2025-02-13,22.9 ( 0.88 %),4692,17177500,3661.02,3647,20052700,5498,-2875200
2025-02-12,22.7 ( -1.3 %),5321,12990800,2441.42,4077,20568500,5045,-7577700
2025-02-11,23 ( 0.44 %),3955,16082000,4066.25,4968,21890000,4406,-5808000
2025-02-10,22.9 ( 0.66 %),7645,33166700,4338.35,8996,38775400,4310,-5608700
2025-02-07,22.75 ( 0.66 %),6868,26535800,3863.69,7383,30199100,4090,-3663300
2025-02-06,22.6 ( 0.44 %),5380,22883100,4253.36,6814,24838400,3645,-1955300
2025-02-05,22.5 ( 0.22 %),4568,14794700,3238.77,4345,14615600,3364,179100
2025-02-04,22.45 ( 1.81 %),4919,21631000,4397.44,5190,19084300,3677,2546700
2025-02-03,0 ( 0 %),6432,15743400,2447.67,2824,14619100,5177,1124300
2025-01-24,22.4 ( 0.9 %),3605,17468000,4845.49,5061,18721900,3699,-1253900
2025-01-23,22.2 ( 1.83 %),4125,26589800,6446.01,6249,22249600,3561,4340200
2025-01-22,21.8 ( -0.23 %),2850,10687900,3750.14,3612,15406400,4265,-4718500
2025-01-21,21.85 ( 0 %),2764,11510100,4164.29,5054,16806600,3325,-5296500
2025-01-20,21.85 ( 1.63 %),2718,13152300,4838.96,5445,18946800,3480,-5794500
2025-01-17,21.5 ( 0.47 %),2834,11126100,3925.94,2285,9262300,4054,1863800
2025-01-16,21.4 ( 0.23 %),2867,13650500,4761.25,3216,13616300,4234,34200
2025-01-15,21.35 ( 0.23 %),3139,9520700,3033.04,2759,9447000,3424,73700
2025-01-14,21.3 ( -0.93 %),3592,15269600,4251,1957,15517500,7929,-247900
2025-01-13,21.5 ( 1.65 %),4671,21119700,4521.45,3326,12929500,3887,8190200
2025-01-10,21.15 ( -1.63 %),5588,14269800,2553.65,2835,15850900,5591,-1581100
2025-01-09,21.5 ( -0.46 %),3337,9452000,2832.48,2704,10764400,3981,-1312400
2025-01-08,21.6 ( -0.23 %),3995,16080400,4025.13,3730,13665300,3664,2415100
2025-01-07,21.65 ( 2.03 %),6919,24690000,3568.43,4200,21205500,5049,3484500
2025-01-06,24.4 ( -1.21 %),5374,21472100,3995.55,4911,29934100,6095,-8462000
2025-01-03,24.7 ( -1.98 %),5215,19046900,3652.33,4566,23962200,5248,-4915300
2025-01-02,25.2 ( 0.4 %),4079,26924300,6600.71,8441,27969500,3314,-1045200
2024-12-31,25.1 ( 1.21 %),3683,24247600,6583.65,5043,20752300,4115,3495300
2024-12-30,24.8 ( -1 %),5289,17340900,3278.67,5464,24688400,4518,-7347500
2024-12-27,25.05 ( 0.6 %),4891,34304100,7013.72,10206,36622500,3588,-2318400
2024-12-26,24.9 ( 1.84 %),4864,44428700,9134.19,8936,34489500,3860,9939200
2024-12-25,24.45 ( 2.3 %),4519,36943900,8175.24,7271,28134100,3869,8809800
2024-12-24,23.9 ( -0.62 %),3120,9503100,3045.87,1955,7699600,3938,1803500
2024-12-23,24.05 ( 0.21 %),2406,7637400,3174.31,2593,8334300,3214,-696900
2024-12-20,24 ( 0.63 %),3544,15031400,4241.37,2301,7894800,3431,7136600
2024-12-19,23.85 ( -1.45 %),6877,19062200,2771.88,2770,17760300,6412,1301900
2024-12-18,24.2 ( 0.21 %),3137,10300500,3283.55,2536,7560700,2981,2739800
2024-12-17,24.15 ( 0.21 %),2652,11301100,4261.35,2114,8124800,3843,3176300
2024-12-16,24.1 ( -0.62 %),3891,13651600,3508.51,3404,13675300,4017,-23700
2024-12-13,24.25 ( -0.21 %),3019,13656800,4523.62,2308,11258600,4878,2398200
2024-12-12,24.3 ( 0 %),2476,15589400,6296.2,4528,12780600,2823,2808800
2024-12-11,24.3 ( 0.21 %),4082,12736500,3120.16,3479,11057200,3178,1679300
2024-12-10,24.25 ( -0.61 %),3333,10835400,3250.95,2537,11042200,4352,-206800
2024-12-09,24.4 ( 0.21 %),2953,13532300,4582.56,3327,13012500,3911,519800
2024-12-06,24.35 ( -0.81 %),3315,12434700,3751.04,4389,15313200,3489,-2878500
2024-12-05,24.55 ( 2.94 %),4290,23472000,5471.33,5104,17942100,3515,5529900
2024-12-04,23.85 ( -0.42 %),3993,13127100,3287.53,2611,10903800,4176,2223300
2024-12-03,23.95 ( -0.83 %),3014,10552700,3501.23,2644,12993900,4914,-2441200
2024-12-02,24.15 ( 0 %),2799,7960400,2844.02,2846,11434100,4018,-3473700
2024-11-29,24.15 ( 0.62 %),2633,8904800,3382,2532,9508200,3755,-603400
2024-11-28,24 ( -0.41 %),2596,11524600,4439.37,3704,13340800,3602,-1816200
2024-11-27,24.1 ( 0 %),2686,8074600,3006.18,2554,10833100,4242,-2758500
2024-11-26,24.1 ( 0.63 %),2842,9527900,3352.53,3612,12764100,3534,-3236200
2024-11-25,23.95 ( -0.21 %),3057,10549500,3450.93,3451,11293000,3272,-743500
2024-11-22,24 ( 0 %),4376,22084600,5046.76,4849,17995000,3711,4089600
2024-11-21,24 ( 1.91 %),4029,20846200,5174.04,3044,11332200,3723,9514000
2024-11-20,23.55 ( 1.73 %),6409,23333400,3640.72,4554,15901400,3492,7432000
2024-11-19,23.15 ( -1.07 %),4866,15701300,3226.74,2745,13356500,4866,2344800
2024-11-18,23.4 ( -0.43 %),9245,29827000,3226.28,3617,23636800,6535,6190200
2024-11-14,23.8 ( -1.45 %),5666,15170800,2677.52,3007,18084700,6014,-2913900
2024-11-13,24.15 ( 0.21 %),7718,21761300,2819.55,3490,20662700,5921,1098600
2024-11-12,24.1 ( -0.82 %),5362,16721100,3118.44,3196,16192900,5067,528200
2024-11-11,24.3 ( -1.02 %),10811,32975000,3050.13,4241,27462200,6475,5512800
2024-11-08,24.55 ( -1.01 %),5258,16648600,3166.34,3194,18864800,5906,-2216200
2024-11-07,24.8 ( -0.2 %),2867,11960800,4171.89,3389,17403700,5135,-5442900
2024-11-06,24.85 ( 1.64 %),4245,19554300,4606.43,3530,15184300,4302,4370000
2024-11-05,0 ( 0 %),3857,16376500,4245.92,2143,16803200,7841,-426700
2024-11-04,24.45 ( -0.61 %),6374,22916500,3595.31,3230,24066700,7451,-1150200
2024-11-01,24.6 ( -1.8 %),5294,18176700,3433.45,3193,19351700,6061,-1175000
2024-10-31,25.05 ( 0.2 %),4082,15068800,3691.52,3510,15303700,4360,-234900
2024-10-30,25 ( 0 %),3802,11990000,3153.6,3373,15908000,4716,-3918000
2024-10-29,25 ( 0.81 %),3907,19404900,4966.7,3427,13993900,4083,5411000
2024-10-28,24.8 ( 0.61 %),4025,14633200,3635.58,2270,10231700,4507,4401500
2024-10-25,24.65 ( -0.2 %),7086,22807700,3218.7,3985,22382700,5617,425000
2024-10-24,24.7 ( -2.18 %),6185,25902800,4188,4104,31147600,7590,-5244800
2024-10-23,25.25 ( 0 %),5343,23974500,4487.09,3896,28356300,7278,-4381800
2024-10-22,25.25 ( -1.17 %),6511,31494500,4837.12,5138,33997600,6617,-2503100
2024-10-21,25.55 ( -0.78 %),4270,19732000,4621.08,3631,22909400,6309,-3177400
2024-10-18,25.75 ( -0.58 %),6787,32612100,4805.08,7417,39712900,5354,-7100800
2024-10-17,25.9 ( 1.57 %),5325,28617800,5374.23,4473,21451800,4796,7166000
2024-10-16,25.5 ( -0.58 %),5505,20092400,3649.85,3882,23047200,5937,-2954800
2024-10-15,25.65 ( -0.77 %),5684,34011500,5983.73,8150,37475300,4598,-3463800
2024-10-14,25.85 ( 1.17 %),5485,33091100,6033.02,7413,28861400,3893,4229700
2024-10-11,25.55 ( 0.2 %),4715,20850800,4422.23,3425,18536100,5412,2314700
2024-10-10,25.5 ( -0.39 %),4602,31444700,6832.83,8627,38562800,4470,-7118100
2024-10-09,25.6 ( 1.59 %),5532,34710100,6274.42,6309,30683900,4864,4026200
2024-10-08,25.2 ( 0 %),6461,33387800,5167.59,4691,25684500,5475,7703300
2024-10-07,25.2 ( 0.4 %),5586,25522500,4569.01,3922,21603100,5508,3919400
2024-10-04,25.1 ( -1.57 %),9700,36887300,3802.81,4845,38379600,7921,-1492300
2024-10-03,25.5 ( -0.78 %),8286,45672000,5511.95,9418,47192700,5011,-1520700
2024-10-02,25.7 ( 0.19 %),6935,37012900,5337.12,5951,30243500,5082,6769400
2024-10-01,25.65 ( -0.19 %),6089,43654300,7169.37,9523,38628000,4056,5026300
2024-09-30,25.7 ( 0 %),7982,44161100,5532.59,5975,27436700,4592,16724400
2024-09-27,25.7 ( 0 %),6250,35034600,5605.54,10758,40764600,3789,-5730000
2024-09-26,25.7 ( -0.19 %),11149,53708600,4817.35,11084,48952100,4416,4756500
2024-09-25,25.75 ( 1.98 %),10992,74098800,6741.16,15447,66494100,4305,7604700
2024-09-24,25.25 ( 1.81 %),5982,39394600,6585.52,8525,32389300,3799,7005300
2024-09-23,24.8 ( 0.2 %),7954,39194000,4927.58,11805,44302800,3753,-5108800
2024-09-20,24.75 ( 1.43 %),9396,55976900,5957.52,13833,54532400,3942,1444500
2024-09-19,24.4 ( 0 %),3341,12426600,3719.43,5036,21782800,4325,-9356200
2024-09-18,24.4 ( 0.62 %),5182,31465700,6072.12,6703,30211300,4507,1254400
2024-09-17,24.25 ( 1.46 %),4730,17499300,3699.64,3888,17320600,4455,178700
2024-09-16,23.9 ( 0 %),4399,15402200,3501.3,4979,22195700,4458,-6793500
2024-09-13,23.9 ( -0.42 %),4128,11724200,2840.16,2578,12444900,4827,-720700
2024-09-12,24 ( 0.42 %),3066,13588200,4431.9,3684,13998600,3800,-410400
2024-09-11,23.9 ( 0.63 %),7090,35428600,4996.98,3403,17724800,5209,17703800
2024-09-10,23.75 ( -0.84 %),6700,24299200,3626.75,4175,25270300,6053,-971100
2024-09-09,23.95 ( -0.21 %),6139,20355600,3315.78,2323,15804000,6803,4551600
2024-09-06,24 ( 0.21 %),9154,43358100,4736.52,3193,27418000,8587,15940100
2024-09-05,23.95 ( -1.84 %),8522,33824900,3969.13,4583,29899900,6524,3925000
2024-09-04,24.4 ( -1.81 %),7527,28123200,3736.31,4041,25169100,6228,2954100
2024-08-30,24.85 ( 0 %),3457,24072500,6963.41,5974,24891700,4167,-819200
2024-08-29,24.85 ( 0.81 %),7623,47440500,6223.34,13001,51782800,3983,-4342300
2024-08-28,24.65 ( 1.02 %),4621,35921400,7773.51,6012,24529500,4080,11391900
2024-08-27,24.4 ( -0.2 %),4948,27125300,5482.07,4459,22890100,5133,4235200
2024-08-26,24.45 ( -0.41 %),4495,24742200,5504.38,6320,27563900,4361,-2821700
2024-08-23,24.55 ( 0.61 %),5052,34500800,6829.14,6226,24929100,4004,9571700
2024-08-22,24.4 ( -1.41 %),6369,27776300,4361.17,7835,32592400,4160,-4816100
2024-08-21,24.75 ( 2.06 %),8118,43634700,5375.06,9260,38563300,4165,5071400
2024-08-20,24.25 ( 0.83 %),5498,35920600,6533.39,7917,30918400,3905,5002200
2024-08-19,24.05 ( 0 %),5041,22163100,4396.57,5711,19016500,3330,3146600
2024-08-16,24.05 ( 3.44 %),6752,39046800,5783,9906,36402700,3675,2644100
2024-08-15,23.25 ( -0.64 %),5125,15761600,3075.43,3580,15681900,4380,79700
2024-08-14,23.4 ( -0.85 %),3758,14338300,3815.41,3749,16565700,4419,-2227400
2024-08-13,23.6 ( -0.42 %),4173,15713400,3765.49,4051,15772800,3894,-59400
2024-08-12,23.7 ( 1.07 %),4632,30092000,6496.55,4091,16973900,4149,13118100
2024-08-08,0 ( 0 %),6763,21918000,3240.87,4102,21293300,5191,624700
2024-08-07,23.35 ( -0.21 %),5052,20883600,4133.73,3768,19333400,5131,1550200
2024-08-06,23.4 ( 1.96 %),6560,40568900,6184.28,6583,28521500,4333,12047400
2024-08-05,22.95 ( -3.57 %),13324,54230000,4070.1,7628,48433200,6349,5796800
2024-08-02,23.8 ( 1.71 %),14780,47830100,3236.14,5727,35225000,6151,12605100
2024-08-01,23.4 ( -4.1 %),13887,55456600,3993.42,8605,60111400,6986,-4654800
2024-07-31,24.4 ( -0.41 %),8169,43950500,5380.16,10927,44485800,4071,-535300
2024-07-30,24.5 ( 1.66 %),9726,42941300,4415.1,6035,29920200,4958,13021100
2024-07-29,24.1 ( -0.82 %),5104,19841100,3887.36,5118,22575000,4411,-2733900
2024-07-26,24.3 ( 1.46 %),6236,37190000,5963.76,6829,27012000,3955,10178000
2024-07-25,23.95 ( 0 %),9838,43979700,4470.39,5818,33942100,5834,10037600
2024-07-24,23.95 ( 0.21 %),10645,53739000,5048.29,9503,44989000,4734,8750000
2024-07-22,25.2 ( -0.79 %),13739,83227600,6057.76,15634,66559700,4257,16667900
2024-07-19,25.4 ( 2.01 %),16563,101165500,6107.92,21501,88302200,4107,12863300
2024-07-18,24.9 ( 1.63 %),10386,59709200,5749.01,15103,60674700,4017,-965500
2024-07-17,24.5 ( 4.03 %),19472,137079300,7039.82,32193,130809700,4063,6269600
2024-07-16,23.55 ( 2.17 %),8886,61147600,6881.34,16113,57572100,3573,3575500
2024-07-15,23.05 ( 0.22 %),3016,12125900,4020.52,3665,14061200,3837,-1935300
2024-07-12,23 ( -0.43 %),4209,17887400,4249.8,4388,18763600,4276,-876200
2024-07-11,23.1 ( -0.86 %),3419,15271500,4466.66,7024,24326800,3463,-9055300
2024-07-10,0 ( 0 %),7523,33899700,4506.14,12481,43772600,3507,-9872900
2024-07-09,23.15 ( 1.98 %),4940,32981200,6676.36,7913,26583200,3359,6398000
2024-07-08,22.7 ( -0.44 %),4841,11787600,2434.95,3834,16414900,4281,-4627300
2024-07-05,22.8 ( 0 %),4186,13190900,3151.19,3455,13869900,4014,-679000
2024-07-04,22.8 ( -0.44 %),3650,11082600,3036.33,4411,16697500,3785,-5614900
2024-07-03,22.9 ( 0.88 %),3728,14310100,3838.55,4797,17465800,3641,-3155700
2024-07-02,22.7 ( 1.11 %),4609,24104500,5229.88,4652,22272700,4788,1831800
2024-07-01,22.45 ( 1.13 %),4295,11225300,2613.57,2328,8515000,3658,2710300
2024-06-28,22.2 ( -1.33 %),6045,17288700,2860,3568,22552100,6321,-5263400
2024-06-27,22.5 ( 0 %),5662,16072200,2838.61,3048,11881500,3898,4190700
2024-06-26,22.5 ( -0.44 %),7486,25089000,3351.46,3388,22702800,6701,2386200
2024-06-25,22.6 ( -0.22 %),6428,22631400,3520.75,3399,17666500,5198,4964900
2024-06-24,22.65 ( -2.37 %),11465,41737100,3640.39,6308,42736900,6775,-999800
2024-06-21,23.2 ( -0.22 %),5812,21415300,3684.67,4350,21079200,4846,336100
2024-06-20,23.25 ( -0.21 %),6226,28558400,4586.96,7239,28115000,3884,443400
2024-06-19,23.3 ( 0.22 %),7714,32036700,4153.06,6192,26228800,4236,5807900
2024-06-18,23.25 ( 0 %),5411,27490300,5080.45,7733,29327800,3793,-1837500
2024-06-17,23.25 ( 0.65 %),8656,35696400,4123.89,7402,32630800,4408,3065600
2024-06-14,23.1 ( -1.91 %),11462,37727000,3291.48,13437,56851900,4231,-19124900
2024-06-13,23.55 ( 1.95 %),13120,79626000,6069.05,17460,64833300,3713,14792700
2024-06-12,23.1 ( 2.44 %),9404,46280800,4921.4,10232,40271400,3936,6009400
2024-06-11,22.55 ( -0.44 %),6589,18933100,2873.44,6309,24748600,3923,-5815500
2024-06-10,22.65 ( 0.89 %),7106,25207200,3547.31,9474,33524400,3539,-8317200
2024-06-07,22.45 ( 0.45 %),5590,19912700,3562.2,5906,21606300,3658,-1693600
2024-06-06,22.35 ( 0.68 %),6523,23559100,3611.7,5822,25746800,4422,-2187700
2024-06-05,22.2 ( -1.33 %),6999,20772800,2967.97,6431,30586800,4756,-9814000
2024-06-04,22.5 ( -0.44 %),7013,18301200,2609.61,8138,27121900,3333,-8820700
2024-06-03,22.6 ( 3.91 %),9280,45011200,4850.34,11228,42983300,3828,2027900
2024-05-31,21.75 ( -0.46 %),10815,28065200,2595.03,5269,25820900,4901,2244300
2024-05-30,21.85 ( -2.02 %),21967,52228600,2377.59,8782,42969700,4893,9258900
2024-05-29,22.3 ( -1.33 %),9160,26588300,2902.65,8063,32789300,4067,-6201000
2024-05-28,22.6 ( 0.67 %),6928,23453300,3385.29,5654,28369700,5018,-4916400
2024-05-27,22.45 ( 0 %),6790,17753600,2614.67,4061,20180900,4969,-2427300
2024-05-24,22.45 ( -1.54 %),16178,77953100,4818.46,9824,61944600,6305,16008500
2024-05-23,22.8 ( 0.44 %),11722,28777900,2455.03,4529,21834000,4821,6943900
2024-05-22,23.2 ( -1.69 %),8433,33521700,3975.06,7409,39340300,5310,-5818600
2024-05-21,23.6 ( 0.64 %),7737,37848000,4891.82,6264,27250400,4350,10597600
2024-05-20,23.45 ( 0.86 %),7747,41596100,5369.32,8499,35129300,4133,6466800
2024-05-17,23.25 ( -0.64 %),11049,31229700,2826.47,7162,30674900,4283,554800
2024-05-16,23.4 ( 2.18 %),11746,76129600,6481.32,12749,61234000,4803,14895600
2024-05-15,22.9 ( 0.22 %),7440,38307300,5148.83,7172,33789400,4711,4517900
2024-05-14,22.85 ( 0.88 %),8517,41054500,4820.3,8347,34299300,4109,6755200
2024-05-13,22.65 ( 0.22 %),8555,41247000,4821.39,7305,31190200,4270,10056800
2024-05-10,22.6 ( -0.22 %),7052,28577900,4052.45,6011,25004900,4160,3573000
2024-05-09,22.65 ( 0.44 %),10089,49017600,4858.52,5489,29790900,5427,19226700
2024-05-08,22.55 ( -0.88 %),17287,44046000,2547.93,4753,33561400,7061,10484600
2024-05-07,22.75 ( -0.66 %),8429,23078100,2737.94,5899,21299500,3611,1778600
2024-05-06,22.9 ( 2.23 %),7960,34342700,4314.41,8010,28393900,3545,5948800
2024-05-03,22.4 ( 0 %),7182,21632600,3012.06,5879,26244900,4464,-4612300
2024-05-02,22.4 ( 0.67 %),6490,28168900,4340.35,4254,20881500,4909,7287400
2024-04-26,22.25 ( 0 %),10900,37379700,3429.33,4750,24788400,5219,12591300
2024-04-25,22.25 ( -1.33 %),8640,26542500,3072.05,5143,24056200,4677,2486300
2024-04-24,22.55 ( 2.5 %),8751,39124100,4470.81,6487,28777100,4436,10347000
2024-04-23,22 ( -2.65 %),19155,50832500,2653.75,7031,49684900,7067,1147600
2024-04-22,22.6 ( -0.44 %),11313,34183400,3021.6,5249,33572400,6396,611000
2024-04-19,22.7 ( -1.73 %),14691,48889700,3327.87,8115,47445400,5847,1444300
2024-04-17,23.1 ( -3.35 %),11527,39743300,3447.84,6901,44887700,6505,-5144400
2024-04-16,23.9 ( 2.14 %),17603,67742900,3848.37,8563,48023700,5608,19719200
2024-04-15,23.4 ( -5.07 %),14957,70530600,4715.56,14903,83948100,5633,-13417500
2024-04-12,24.65 ( 3.79 %),8747,44850200,5127.5,10619,41612900,3919,3237300
2024-04-11,23.75 ( -0.21 %),8559,27512000,3214.39,3830,17954700,4688,9557300
2024-04-10,23.8 ( -0.83 %),10310,39767000,3857.13,6938,45853000,6609,-6086000
2024-04-09,24 ( 2.13 %),9208,41629500,4521.01,4372,26412100,6041,15217400
2024-04-08,23.5 ( 0.64 %),13154,55195000,4196.06,5905,48726200,8252,6468800
2024-04-05,23.35 ( -1.89 %),15351,50417400,3284.31,5891,48072200,8160,2345200
2024-04-04,23.8 ( -1.65 %),13936,43382200,3112.96,5496,56111200,10209,-12729000
2024-04-03,24.2 ( -2.42 %),12474,36664200,2939.25,4885,35235500,7213,1428700
2024-04-02,24.8 ( -0.4 %),18201,58190800,3197.12,5248,47961700,9139,10229100
2024-04-01,24.9 ( -1.97 %),11038,33924600,3073.44,5298,41046300,7748,-7121700
2024-03-29,25.4 ( -0.39 %),5637,23288100,4131.29,5231,33440900,6393,-10152800
2024-03-28,25.5 ( 0.79 %),5763,31409000,5450.11,8205,43205800,5266,-11796800
2024-03-27,25.3 ( 0.2 %),6698,27039700,4036.98,6277,34193600,5447,-7153900
2024-03-26,25.25 ( 2.23 %),6072,38568400,6351.84,6662,28341800,4254,10226600
2024-03-25,24.7 ( -1.4 %),9007,41262500,4581.16,8975,47545600,5298,-6283100
2024-03-22,25.05 ( 1.21 %),15845,74844300,4723.53,20042,80082300,3996,-5238000
2024-03-21,24.75 ( 2.48 %),9234,58260300,6309.32,13967,58259000,4171,1300
2024-03-20,24.15 ( 4.09 %),13890,80202000,5774.08,18226,70234200,3854,9967800
2024-03-19,23.2 ( 0 %),8120,30870300,3801.76,4676,22763200,4868,8107100
2024-03-18,23.2 ( -2.52 %),17541,57831200,3296.92,7098,55551100,7826,2280100
2024-03-15,23.8 ( 1.49 %),9845,49743900,5052.71,6692,34604600,5171,15139300
2024-03-14,23.45 ( -1.68 %),8498,35555500,4183.98,7909,39235400,4961,-3679900
2024-03-13,23.85 ( 3.25 %),8056,40280700,5000.09,6896,27431500,3978,12849200
2024-03-12,23.1 ( 0.65 %),13140,46022600,3502.48,9449,29469400,3119,16553200
2024-03-11,22.95 ( -2.75 %),18227,56745200,3113.25,8882,51672800,5818,5072400
2024-03-08,23.6 ( -3.28 %),20206,77498200,3835.41,10752,72570700,6750,4927500
2024-03-07,24.4 ( -0.81 %),8881,41363200,4657.49,6773,37308600,5508,4054600
2024-03-06,24.6 ( 0 %),11473,53876900,4695.97,10771,56843100,5277,-2966200
2024-03-05,24.6 ( 1.65 %),8284,53489700,6456.99,7466,35348500,4735,18141200
2024-03-04,24.2 ( 0.83 %),13838,64905500,4690.38,8981,54693200,6090,10212300
2024-03-01,24 ( -0.62 %),11578,40505300,3498.47,5650,36687700,6493,3817600
2024-02-29,24.15 ( -1.02 %),10168,45408200,4465.79,7194,43734300,6079,1673900
2024-02-28,24.4 ( 0.62 %),6840,36054900,5271.18,8913,38345200,4302,-2290300
2024-02-27,24.25 ( 1.04 %),7083,44990500,6351.9,7742,41893800,5411,3096700
2024-02-26,24 ( 0.42 %),9146,41187100,4503.29,6055,37832100,6248,3355000
2024-02-23,23.9 ( -0.21 %),14468,85480500,5908.25,13937,77344200,5550,8136300
2024-02-22,23.95 ( -0.21 %),6348,31808100,5010.73,5181,31233400,6028,574700
2024-02-21,24 ( 0.63 %),7536,49317300,6544.23,7861,47251700,6011,2065600
2024-02-20,23.85 ( -0.42 %),7622,42019500,5512.92,5991,38296600,6392,3722900
2024-02-19,23.95 ( -0.21 %),8761,46479900,5305.32,6576,39478000,6003,7001900
2024-02-16,24 ( -0.62 %),8174,33366600,4082.04,6467,30928400,4782,2438200
2024-02-15,24.15 ( 2.77 %),6985,44220800,6330.82,8510,40194000,4723,4026800
2024-02-07,23.5 ( 1.95 %),0,0,0,0,0,0,0
2024-02-06,23.05 ( 0.44 %),4199,21229500,5055.85,6245,22145900,3546,-916400
2024-02-05,22.95 ( 5.52 %),8772,62933900,7174.41,13901,58782600,4229,4151300
2024-02-02,21.75 ( -0.68 %),4746,29592600,6235.27,3943,25118900,6371,4473700
2024-02-01,21.9 ( 0.69 %),5671,36116400,6368.61,3762,19462300,5173,16654100
2024-01-31,21.75 ( -1.58 %),8308,40165700,4834.58,5859,42302700,7220,-2137000
2024-01-30,22.1 ( -0.23 %),4485,26221800,5846.56,4464,26411500,5917,-189700
2024-01-29,22.15 ( 0.68 %),3616,38585100,10670.66,7762,31583200,4069,7001900
2024-01-26,22 ( 0.46 %),3246,30094100,9271.13,5252,22340300,4254,7753800
2024-01-25,21.9 ( 0 %),6475,35131000,5425.64,4014,25555600,6367,9575400
2024-01-24,21.9 ( -0.23 %),4896,25168600,5140.65,5492,24411900,4445,756700
2024-01-23,21.95 ( -0.68 %),5568,31427900,5644.38,6424,29220300,4549,2207600
2024-01-22,22.1 ( 0.23 %),6807,75357900,11070.65,10320,50336600,4878,25021300
2024-01-19,22.05 ( 1.61 %),5410,73393000,13566.17,10267,37913800,3693,35479200
2024-01-18,21.7 ( 0.93 %),6538,63367300,9692.15,6162,43695500,7091,19671800
2024-01-17,21.5 ( 0 %),4534,57331300,12644.75,7437,40073300,5388,17258000
2024-01-16,21.5 ( 0.23 %),5822,45085700,7744.02,6714,29290500,4363,15795200
2024-01-15,21.45 ( 0.47 %),6132,64499900,10518.57,10018,44531500,4445,19968400
2024-01-12,21.35 ( 3.39 %),12940,111430900,8611.35,14746,68251400,4628,43179500
2024-01-11,20.65 ( -1.2 %),8586,49211800,5731.63,8787,47046000,5354,2165800
2024-01-10,20.9 ( 0.24 %),0,0,0,0,0,0,0
2024-01-09,20.85 ( 0.72 %),5952,44438800,7466.2,8867,35606900,4016,8831900
2024-01-08,20.7 ( 0.98 %),6011,39872700,6633.29,10894,36935800,3390,2936900
2024-01-05,20.5 ( 1.99 %),6732,48881400,7261.05,13092,41568000,3175,7313400
2024-01-04,20.1 ( 4.96 %),10975,89350600,8141.28,20640,77000700,3731,12349900
2024-01-03,19.15 ( 1.59 %),3550,31650200,8915.55,7198,23095900,3209,8554300
2024-01-02,18.85 ( 1.07 %),4353,27331400,6278.75,7608,26746400,3516,585000
2023-12-29,18.65 ( 0.54 %),0,0,0,0,0,0,0
2023-12-28,18.55 ( 0.82 %),2611,24742600,9476.29,4698,18112100,3855,6630500
2023-12-27,18.4 ( -0.27 %),3040,15138400,4979.74,3866,17668000,4570,-2529600
2023-12-26,18.45 ( 0.27 %),2095,12518600,5975.47,3470,14675600,4229,-2157000
2023-12-25,18.4 ( 0.55 %),2641,16163300,6120.14,5669,16169500,2852,-6200
2023-12-22,18.3 ( 0.83 %),4175,20670600,4951.04,5272,17010000,3226,3660600
2023-12-21,18.15 ( 0 %),2499,9741900,3898.32,2257,8990500,3983,751400
2023-12-20,18.15 ( 0 %),2090,11313100,5412.97,2611,8731900,3344,2581200
2023-12-19,18.15 ( 0.83 %),2579,12769800,4951.45,2908,11664400,4011,1105400
2023-12-18,18 ( -0.28 %),2767,9161200,3310.88,2869,11270000,3928,-2108800
2023-12-15,18.05 ( 0 %),2350,10859400,4621.02,2825,11967400,4236,-1108000
2023-12-14,18.05 ( 0 %),2240,12799700,5714.15,3032,15689100,5175,-2889400
2023-12-13,18.05 ( -1.1 %),3344,13741100,4109.18,3875,19008600,4905,-5267500
2023-12-12,18.25 ( 0.55 %),1978,9992000,5051.57,3253,11709600,3600,-1717600
2023-12-11,18.15 ( -0.27 %),2356,10469700,4443.85,2980,12560800,4215,-2091100
2023-12-08,18.2 ( -0.27 %),2422,13048300,5387.41,4215,18838900,4469,-5790600
2023-12-07,18.25 ( 0.83 %),5256,27263900,5187.2,6350,26581400,4186,682500
2023-12-06,18.1 ( 0.28 %),3525,14006500,3973.48,3893,16305000,4188,-2298500
2023-12-05,18.05 ( 0 %),3192,11940700,3740.82,3927,15007600,3822,-3066900
2023-12-04,18.05 ( 1.4 %),5440,30352400,5579.49,5520,26037100,4717,4315300
2023-12-01,17.8 ( 0 %),3634,11484700,3160.35,2314,8605900,3719,2878800
2023-11-30,17.8 ( -0.28 %),2768,12200100,4407.55,3125,12731300,4074,-531200
2023-11-29,17.85 ( 0 %),3881,10683700,2752.82,2482,12024400,4845,-1340700
2023-11-28,17.85 ( 1.42 %),4688,18259100,3894.86,2393,11240900,4697,7018200
2023-11-27,17.6 ( -1.4 %),6002,14178900,2362.36,2264,13873200,6128,305700
2023-11-24,17.85 ( -0.28 %),5678,14235600,2507.15,3105,15183000,4890,-947400
2023-11-23,17.9 ( -0.83 %),4152,14102900,3396.65,3284,15304500,4660,-1201600
2023-11-22,18.05 ( -0.28 %),4041,12519500,3098.12,2681,15045300,5612,-2525800
2023-11-21,18.1 ( 0.56 %),3951,13422100,3397.14,2469,12381000,5015,1041100
2023-11-20,18 ( -1.1 %),5883,19651300,3340.35,3077,17734000,5763,1917300
2023-11-17,18.2 ( -1.62 %),5424,24233200,4467.77,4545,27513200,6054,-3280000
2023-11-16,18.5 ( -0.27 %),2534,10206800,4027.94,3234,13528800,4183,-3322000
2023-11-15,18.55 ( 0.54 %),2992,22490400,7516.84,7268,32828700,4517,-10338300
2023-11-14,18.45 ( 1.93 %),3621,25560800,7059.04,6849,28983100,4232,-3422300
2023-11-13,18.1 ( 0.56 %),3657,12914100,3531.34,3072,12764200,4155,149900
2023-11-10,18 ( -1.91 %),5403,21442100,3968.55,3878,22654500,5842,-1212400
2023-11-09,18.35 ( 0 %),4323,19887900,4600.49,5059,21027300,4156,-1139400
2023-11-08,18.35 ( 3.09 %),4926,21385200,4341.29,4253,17112200,4024,4273000
2023-11-07,17.8 ( -0.84 %),3044,10493300,3447.21,2836,14214400,5012,-3721100
2023-11-06,17.95 ( 3.16 %),3689,20429600,5537.98,3903,16752100,4292,3677500
2023-11-03,17.4 ( -1.69 %),6120,36807600,6014.31,2920,17669500,6051,19138100
2023-11-01,17.2 ( 0.58 %),2659,9573000,3600.23,2015,10060100,4993,-487100
2023-10-31,17.1 ( 0.59 %),4012,12481800,3111.12,2537,10278000,4051,2203800
2023-10-30,17 ( -2.58 %),3199,5988000,1871.83,1393,6941900,4983,-953900
2023-10-27,17.45 ( 1.45 %),3949,14943700,3784.17,2817,13133500,4662,1810200
2023-10-26,17.2 ( -3.37 %),7763,21327900,2747.38,2804,19464800,6942,1863100
2023-10-25,17.8 ( -0.56 %),2552,8829300,3459.76,1997,9871200,4943,-1041900
2023-10-24,17.9 ( 0.56 %),2208,9162500,4149.68,2038,8666000,4252,496500
2023-10-23,17.8 ( -0.84 %),3299,9017600,2733.43,1761,7254600,4120,1763000
2023-10-20,17.95 ( 1.7 %),3537,11602000,3280.18,2395,8738100,3648,2863900
2023-10-19,17.65 ( -0.56 %),4286,11234700,2621.26,2361,10504100,4449,730600
2023-10-18,17.75 ( -1.93 %),6302,16432900,2607.57,2677,17376400,6491,-943500
2023-10-17,0 ( 0 %),2888,9321500,3227.67,2093,9506900,4542,-185400
2023-10-16,18.2 ( -1.36 %),3055,9966200,3262.26,2125,10678800,5025,-712600
2023-10-13,18.45 ( 0.54 %),3364,14613700,4344.14,2681,11267100,4203,3346600
2023-10-12,18.35 ( -0.81 %),2935,12236800,4169.27,2998,12563600,4191,-326800
2023-10-11,18.5 ( 0.27 %),2177,10650100,4892.1,2773,11023800,3975,-373700
2023-10-10,18.45 ( 0.82 %),2467,13848100,5613.34,3534,14270100,4038,-422000
2023-10-09,18.3 ( 0.83 %),4219,16218200,3844.09,2121,16245500,7659,-27300
2023-10-06,18.15 ( 0.55 %),3491,11236100,3218.59,2185,10145300,4643,1090800
2023-10-05,18.05 ( -0.55 %),3432,11626400,3387.65,2189,13267400,6061,-1641000
2023-10-04,18.15 ( 0.55 %),4159,15281900,3674.42,2322,13466700,5800,1815200
2023-10-03,18.05 ( -2.96 %),5806,17588000,3029.28,3008,17337300,5764,250700
2023-10-02,18.6 ( 0.54 %),2621,10747800,4100.65,2904,9925900,3418,821900
2023-09-29,18.5 ( 0 %),2575,10967500,4259.22,2897,10724700,3702,242800
2023-09-28,18.5 ( 0 %),4635,15748000,3397.63,2740,13771100,5026,1976900
2023-09-27,18.5 ( 1.37 %),4439,15405800,3470.56,4060,16364800,4031,-959000
2023-09-26,18.25 ( 0.83 %),5942,18921000,3184.28,4591,20018800,4360,-1097800
2023-09-25,18.1 ( -3.21 %),5337,18036600,3379.54,4063,21045700,5180,-3009100
2023-09-22,18.7 ( -1.32 %),10696,34321900,3208.85,4973,31141400,6262,3180500
2023-09-21,18.95 ( -1.3 %),5340,21755700,4074.1,4722,25572900,5416,-3817200
2023-09-20,19.2 ( 1.05 %),4925,26813400,5444.35,3965,19023600,4798,7789800
2023-09-19,19 ( -0.78 %),5310,21744600,4095.03,4546,23079200,5077,-1334600
2023-09-18,19.15 ( -1.29 %),5388,20204400,3749.89,4292,24219300,5643,-4014900
2023-09-15,19.4 ( 1.31 %),8674,50307500,5799.8,12815,49839000,3889,468500
2023-09-14,19.15 ( 0.52 %),6972,33030800,4737.64,7349,32412900,4411,617900
2023-09-13,19.05 ( -1.04 %),6393,26238800,4104.3,6033,32214300,5340,-5975500
2023-09-12,19.25 ( 2.67 %),5277,28721200,5442.71,4397,19093100,4342,9628100
2023-09-11,18.75 ( -1.83 %),7375,24402700,3308.84,5730,28312900,4941,-3910200
2023-09-08,19.1 ( -1.04 %),5293,23628200,4464.05,5653,21808100,3858,1820100
2023-09-07,19.3 ( 0.26 %),7678,48670400,6338.94,9344,39147900,4190,9522500
2023-09-06,19.25 ( 0.52 %),6413,35461800,5529.67,6254,27552900,4406,7908900
2023-09-05,19.15 ( 3.51 %),6798,46619500,6857.83,9485,38581700,4068,8037800
2023-08-31,18.5 ( 0.54 %),4074,15511600,3807.46,5049,15745500,3119,-233900
2023-08-30,18.4 ( 0.82 %),3608,18010300,4991.77,4921,14771800,3002,3238500
2023-08-29,18.25 ( 0.27 %),4802,23148000,4820.49,5089,17414600,3422,5733400
2023-08-28,18.2 ( 0.55 %),4460,16541200,3708.79,2730,11676400,4277,4864800
2023-08-25,18.1 ( -0.82 %),4015,12906400,3214.55,2166,9446500,4361,3459900
2023-08-24,18.25 ( 1.39 %),3861,22536300,5836.91,2902,12844300,4426,9692000
2023-08-23,18 ( -1.1 %),4617,15723600,3405.59,2345,12711100,5421,3012500
2023-08-22,18.2 ( 0 %),6124,19766900,3227.78,3220,15676000,4868,4090900
2023-08-21,18.15 ( 0.28 %),6648,22656400,3408,3680,16515100,4488,6141300
2023-08-18,18.1 ( -4.23 %),10424,31059300,2979.6,5462,38000700,6957,-6941400
2023-08-17,18.85 ( -0.79 %),6014,14610200,2429.36,3543,18953100,5349,-4342900
2023-08-16,19 ( 0 %),5002,18653100,3729.13,5100,24426100,4789,-5773000
2023-08-15,18.95 ( -0.26 %),4476,12540900,2801.81,2916,14236300,4882,-1695400
2023-08-14,18.95 ( 0.26 %),4974,16656400,3348.69,3518,16965900,4823,-309500
2023-08-11,18.9 ( 0 %),5811,19108300,3288.3,3443,17692400,5139,1415900
2023-08-10,18.9 ( -1.31 %),5112,16934700,3312.73,5363,18408500,3433,-1473800
2023-08-09,19.15 ( -0.26 %),4696,17709600,3771.21,4707,21405100,4548,-3695500
2023-08-08,19.2 ( -0.78 %),4666,18954500,4062.26,6035,21696500,3595,-2742000
2023-08-07,19.35 ( 1.84 %),5280,28492300,5396.27,6930,27509300,3970,983000
2023-08-04,19 ( 0.8 %),4016,22618400,5632.07,4752,24391500,5133,-1773100
2023-08-03,18.85 ( -0.26 %),3861,18244000,4725.2,5825,24184900,4152,-5940900
2023-08-02,18.9 ( 0 %),3541,12442200,3513.75,4386,15535600,3542,-3093400
2023-08-01,18.85 ( -0.26 %),5207,21437300,4117.02,7921,30625800,3866,-9188500
2023-07-31,18.85 ( 0.8 %),4331,18429400,4255.23,8367,20789300,2485,-2359900
2023-07-28,18.7 ( 0.54 %),4416,14979100,3392.01,3994,14307500,3582,671600
2023-07-27,18.6 ( -1.06 %),5653,19559100,3459.95,4178,17956900,4298,1602200
2023-07-26,18.75 ( -0.27 %),3464,11149400,3218.65,4845,17889700,3692,-6740300
2023-07-25,18.8 ( 0 %),4323,18957800,4385.33,6730,24267800,3606,-5310000
2023-07-24,18.75 ( 0.27 %),4489,17667100,3935.64,6278,17830600,2840,-163500
2023-07-21,18.65 ( 0.81 %),4247,17319700,4078.1,3789,14302000,3775,3017700
2023-07-20,18.45 ( 0.27 %),5729,15405700,2689.07,2997,14253100,4756,1152600
2023-07-19,18.4 ( -1.08 %),7268,19032700,2618.7,3535,22470800,6357,-3438100
2023-07-18,18.6 ( 0 %),7020,16700100,2378.93,2936,16150700,5501,549400
2023-07-17,18.6 ( -0.53 %),5910,17531400,2966.4,3325,19160500,5763,-1629100
2023-07-14,18.65 ( 1.91 %),12102,34180800,2824.39,4610,31465400,6825,2715400
2023-07-13,21.1 ( 0.48 %),5106,28782000,5636.9,6602,33586300,5087,-4804300
2023-07-12,21 ( -0.94 %),5208,23435400,4499.88,4785,26080900,5451,-2645500
2023-07-11,21.2 ( 1.92 %),5922,32167800,5431.91,7351,28227400,3840,3940400
2023-07-10,20.75 ( 1.22 %),4700,34539800,7348.89,6316,27032400,4280,7507400
2023-07-07,20.45 ( 1.24 %),5261,23567400,4479.64,3895,17558900,4508,6008500
2023-07-06,20.2 ( -0.98 %),5314,27918100,5253.69,4378,27307300,6237,610800
2023-07-05,20.4 ( 0 %),3975,23965600,6029.08,5501,26861200,4883,-2895600
2023-07-04,20.35 ( 0.74 %),3433,15829100,4610.87,3195,14192800,4442,1636300
2023-07-03,20.2 ( 0 %),3423,24211000,7073.04,2700,17149900,6352,7061100
2023-06-30,20.2 ( -0.49 %),3775,19145200,5071.58,3110,14513900,4667,4631300
2023-06-29,20.3 ( -1.93 %),5059,23493200,4643.84,4159,24722900,5944,-1229700
2023-06-28,20.7 ( 2.99 %),6056,47840300,7899.65,8373,35332400,4220,12507900
2023-06-27,20.1 ( -0.5 %),4702,18808000,4000,3540,20221000,5712,-1413000
2023-06-26,20.2 ( 0 %),4819,21889200,4542.27,5213,21648000,4153,241200
2023-06-23,20.2 ( 1.51 %),0,0,0,0,0,0,0
2023-06-22,19.9 ( 0.25 %),4551,37056800,8142.56,6900,30638500,4440,6418300
2023-06-21,19.85 ( 0.76 %),3639,13258300,3643.39,3345,11922300,3564,1336000
2023-06-20,19.65 ( 0.26 %),3750,15009500,4002.53,2943,11800500,4010,3209000
2023-06-19,19.55 ( -0.76 %),3340,13035400,3902.81,3321,14463900,4355,-1428500
2023-06-16,19.7 ( 0 %),4187,19565100,4672.82,6127,26210900,4278,-6645800
2023-06-15,19.7 ( -0.25 %),3567,15594000,4371.74,3267,18741200,5737,-3147200
2023-06-14,19.75 ( -2.71 %),6301,18476500,2932.31,4515,23604300,5228,-5127800
2023-06-13,20.3 ( -0.25 %),4804,18238200,3796.46,4338,22753400,5245,-4515200
2023-06-12,20.35 ( 0.49 %),4588,20085000,4377.72,4221,18578200,4401,1506800
2023-06-09,20.25 ( 1.25 %),4627,23415700,5060.67,4823,19732000,4091,3683700
2023-06-08,20 ( -1.72 %),5805,22260800,3834.76,6513,27340300,4198,-5079500
2023-06-07,20.35 ( -0.49 %),6629,26473100,3993.53,6624,24982800,3772,1490300
2023-06-06,20.45 ( 3.28 %),7177,49510400,6898.48,8713,34286100,3935,15224300
2023-06-05,19.8 ( 0.51 %),7853,32976200,4199.19,10047,40330400,4014,-7354200
2023-06-02,19.7 ( 4.79 %),13827,75390200,5452.39,13835,55636900,4021,19753300
2023-06-01,18.8 ( 1.08 %),3803,20540500,5401.13,3916,14975300,3824,5565200
2023-05-31,18.6 ( -0.8 %),4014,11527500,2871.82,3994,17951000,4494,-6423500
2023-05-30,18.75 ( 0 %),3985,12905700,3238.57,3841,16309500,4246,-3403800
2023-05-29,18.75 ( 1.63 %),2699,12555800,4652.02,3608,14595400,4045,-2039600
2023-05-26,18.45 ( 0 %),3210,9205600,2867.79,2356,10812400,4589,-1606800
2023-05-25,18.45 ( -0.81 %),3773,9116300,2416.19,2392,11299500,4724,-2183200
2023-05-24,18.6 ( -0.8 %),3018,9295700,3080.09,3460,15445500,4464,-6149800
2023-05-23,18.75 ( -0.53 %),2984,14753400,4944.17,5243,21560400,4112,-6807000
2023-05-22,18.85 ( 1.07 %),3307,18989600,5742.24,4845,18932500,3908,57100
2023-05-19,18.65 ( 0.27 %),2681,9182500,3425.03,3315,11094500,3347,-1912000
2023-05-18,18.6 ( 0.81 %),3518,13247600,3765.66,3095,14667200,4739,-1419600
2023-05-17,18.45 ( -1.86 %),4809,14587300,3033.33,3886,20132700,5181,-5545400
2023-05-16,18.8 ( -0.27 %),2868,12538800,4371.97,4031,17709700,4393,-5170900
2023-05-15,18.85 ( 1.07 %),6100,29266500,4797.79,9034,34730500,3844,-5464000
2023-05-12,18.65 ( 0.81 %),3521,14822500,4209.74,4478,15015000,3353,-192500
2023-05-11,18.5 ( 0 %),4148,13790300,3324.57,4630,18626300,4023,-4836000
2023-05-10,18.5 ( 1.09 %),3835,14694900,3831.79,3299,12705000,3851,1989900
2023-05-09,18.3 ( 0 %),2732,9119200,3337.92,2708,10091700,3727,-972500
2023-05-08,18.25 ( 0.83 %),3179,8105000,2549.54,2600,9352800,3597,-1247800
2023-05-05,18.1 ( -0.55 %),4106,7698700,1874.99,1675,8195200,4893,-496500
2023-05-04,18.2 ( -1.36 %),4159,9770100,2349.15,2321,12509600,5390,-2739500
2023-04-28,18.45 ( 0.27 %),0,0,0,0,0,0,0
2023-04-27,18.4 ( 0.27 %),2615,7453600,2850.33,2766,10347300,3741,-2893700
2023-04-26,18.35 ( 0.27 %),0,0,0,0,0,0,0
2023-04-25,18.25 ( -0.27 %),2705,9197200,3400.07,3366,12331800,3664,-3134600
2023-04-24,18.25 ( 0.83 %),3313,11120200,3356.53,2917,10111400,3466,1008800
2023-04-21,18.05 ( -0.82 %),3253,8327200,2559.85,2088,8921300,4273,-594100
2023-04-20,18.15 ( 0.28 %),2887,8063600,2793.07,1884,9088700,4824,-1025100
2023-04-19,18.1 ( -0.55 %),0,0,0,0,0,0,0
2023-04-18,18.15 ( -0.82 %),4769,11886800,2492.51,2050,14131600,6893,-2244800
2023-04-17,18.25 ( -0.27 %),4273,12365100,2893.77,2123,12253500,5772,111600
2023-04-14,18.3 ( -1.61 %),4076,12357900,3031.87,3978,20852400,5242,-8494500
2023-04-13,18.55 ( -0.8 %),3583,10338500,2885.43,3176,17808900,5607,-7470400
2023-04-12,18.7 ( -0.53 %),4123,15050000,3650.25,3676,22130600,6020,-7080600
2023-04-11,18.75 ( 0.81 %),3541,13261700,3745.18,3672,14760600,4020,-1498900
2023-04-10,18.6 ( 0 %),3551,21782200,6134.1,6911,26370800,3816,-4588600
2023-04-07,18.6 ( 0.54 %),4943,18233800,3688.81,3634,16426600,4520,1807200
2023-04-06,18.5 ( -1.6 %),5635,19834600,3519.89,6119,22465400,3671,-2630800
2023-04-05,18.8 ( 0 %),4219,19678200,4664.19,5744,20172500,3512,-494300
2023-04-04,18.75 ( 0.27 %),4039,22771800,5637.98,6409,22394100,3494,377700
2023-04-03,18.7 ( 2.19 %),5656,32760900,5792.24,8059,33840500,4199,-1079600
2023-03-31,18.25 ( -0.27 %),4121,18742600,4548.07,5277,22163700,4200,-3421100
2023-03-30,18.25 ( -0.27 %),3485,19083300,5475.84,6680,22253900,3331,-3170600
2023-03-29,18.3 ( 1.67 %),4506,25242400,5601.95,7824,21267900,2718,3974500
2023-03-28,18 ( 0 %),4330,23246200,5368.64,7293,26137200,3584,-2891000
2023-03-27,17.95 ( 0.84 %),4161,18567400,4462.24,4659,21601000,4636,-3033600
2023-03-24,17.75 ( 2.01 %),7207,33424300,4637.75,9074,36857100,4062,-3432800
2023-03-23,17.4 ( 0 %),4153,10409900,2506.6,2481,9352700,3770,1057200
2023-03-22,17.4 ( 0 %),3416,10890900,3188.2,3380,13951300,4128,-3060400
2023-03-21,17.35 ( 0.29 %),5548,16440400,2963.3,3702,14527300,3924,1913100
2023-03-20,17.3 ( -1.14 %),4859,14426500,2969.03,3276,15179100,4633,-752600
2023-03-17,17.45 ( -0.29 %),3359,11854600,3529.21,3198,12859000,4021,-1004400
2023-03-16,17.45 ( -1.97 %),4124,13396200,3248.35,3470,13557800,3907,-161600
2023-03-15,17.8 ( 3.49 %),3832,15524600,4051.3,4740,12855000,2712,2669600
2023-03-14,17.2 ( -1.71 %),6988,17143900,2453.33,2848,13922000,4888,3221900
2023-03-13,17.5 ( -1.69 %),5722,17998700,3145.53,3812,15300300,4014,2698400
2023-03-10,17.75 ( -0.28 %),4520,12534800,2773.19,3289,12433200,3780,101600
2023-03-09,17.8 ( 1.14 %),4193,17981000,4288.34,5344,16379300,3065,1601700
2023-03-08,17.6 ( 1.15 %),5354,16869900,3150.9,2617,13325900,5092,3544000
2023-03-07,17.4 ( 0.58 %),3082,13073900,4242.02,3113,12696500,4079,377400
2023-03-06,17.3 ( 0.58 %),2902,12051900,4152.96,3516,12983700,3693,-931800
2023-03-03,17.15 ( -1.44 %),5414,10396200,1920.24,1983,8685800,4380,1710400
2023-03-02,17.4 ( -1.69 %),4079,7898000,1936.26,2334,9319800,3993,-1421800
2023-03-01,17.65 ( 2.02 %),5379,17467800,3247.41,2613,10449900,3999,7017900
2023-02-28,17.25 ( -0.29 %),5438,13160600,2420.12,2569,13457400,5238,-296800
2023-02-27,17.25 ( -2.54 %),7227,15258700,2111.35,2865,12485900,4358,2772800
2023-02-24,17.7 ( -2.75 %),9037,18803900,2080.77,4141,18891300,4562,-87400
2023-02-23,18.15 ( -0.82 %),9501,28807900,3032.09,3238,27715400,8559,1092500
2023-02-22,18.25 ( -1.88 %),5713,17695800,3097.46,3238,28499000,8801,-10803200
2023-02-21,18.6 ( -1.59 %),6649,13364100,2009.94,5149,22894500,4446,-9530400
2023-02-20,18.9 ( 4.42 %),4785,18239200,3811.75,4184,17645900,4217,593300
2023-02-17,18.1 ( -1.09 %),3508,9488800,2704.9,2729,14396500,5275,-4907700
2023-02-16,18.25 ( 1.39 %),3235,10926100,3377.47,2633,10063300,3822,862800
2023-02-15,18 ( 0.56 %),4126,14978100,3630.17,3156,23459200,7433,-8481100
2023-02-14,17.85 ( -0.83 %),4964,14079400,2836.3,2557,21935700,8579,-7856300
2023-02-13,18 ( -1.64 %),6531,18194300,2785.84,3220,25225600,7834,-7031300
2023-02-10,18.3 ( -1.08 %),3883,11761700,3029.02,2686,18156500,6760,-6394800
2023-02-09,18.45 ( 0.27 %),4427,12021600,2715.52,2948,19460500,6601,-7438900
2023-02-08,18.4 ( 0 %),4511,13835000,3066.95,3104,16936800,5456,-3101800
2023-02-07,18.35 ( -1.87 %),5208,14506100,2785.35,3480,21959000,6310,-7452900
2023-02-06,18.7 ( 0.54 %),4571,13667100,2989.96,3118,12841600,4119,825500
2023-02-03,18.6 ( -2.11 %),6091,24848800,4079.59,3778,17851700,4725,6997100
2023-02-02,18.95 ( 0.26 %),7104,24281200,3417.96,4182,21318400,5098,2962800
2023-02-01,18.9 ( -3.57 %),7080,22694100,3205.38,6157,31201200,5068,-8507100
2023-01-31,19.55 ( 1.3 %),10485,26504300,2527.83,4893,26278200,5371,226100
2023-01-30,19.25 ( -2.28 %),6837,20243300,2960.85,4891,24580800,5026,-4337500
2023-01-27,19.7 ( 0.51 %),4349,13707700,3151.92,4981,15997700,3212,-2290000
2023-01-19,19.6 ( 0 %),4457,18848300,4228.92,5016,18959400,3780,-111100
2023-01-18,19.55 ( 0.77 %),4820,19438500,4032.88,5488,18004100,3281,1434400
2023-01-17,19.4 ( 4.86 %),6900,34862300,5052.51,8896,29854000,3356,5008300
2023-01-16,18.5 ( 1.09 %),3172,14266800,4497.73,3916,12402800,3167,1864000
2023-01-13,18.25 ( -0.27 %),2732,14327200,5244.22,5340,19744500,3697,-5417300
2023-01-12,18.25 ( -0.27 %),3034,12049600,3971.52,3016,14028300,4651,-1978700
2023-01-11,18.25 ( 0.27 %),2739,11229100,4099.71,4559,14944300,3278,-3715200
2023-01-10,18.2 ( -0.55 %),3304,12591700,3811.05,3567,12948900,3630,-357200
2023-01-09,18.25 ( -0.27 %),2653,9693800,3653.9,4557,15106400,3315,-5412600
2023-01-06,18.25 ( 0.27 %),5529,18196200,3291.05,7235,24103700,3332,-5907500
2023-01-05,18.2 ( 1.11 %),3204,17368900,5421,4504,13935800,3094,3433100
2023-01-04,17.95 ( -0.28 %),3336,11934800,3577.58,5296,19086900,3604,-7152100
2023-01-03,18 ( 5.26 %),3279,14831600,4523.21,4302,13321300,3097,1510300
2022-12-30,17.1 ( -1.72 %),2797,9981400,3568.61,2480,10686200,4309,-704800
2022-12-29,17.4 ( -0.57 %),2637,15711800,5958.21,2857,10512500,3680,5199300
2022-12-28,17.45 ( 0.87 %),4057,12444600,3067.44,2794,10470900,3748,1973700
2022-12-27,17.25 ( 2.68 %),5187,13933000,2686.14,2918,9697400,3323,4235600
2022-12-26,16.8 ( -5.62 %),6705,13585100,2026.11,3575,17096700,4782,-3511600
2022-12-23,17.75 ( -1.39 %),4435,11754400,2650.37,2851,11746600,4120,7800
2022-12-22,18 ( 1.69 %),3931,17662300,4493.08,4897,15918900,3251,1743400
2022-12-21,17.7 ( 0.57 %),6077,16557400,2724.6,3979,15846600,3983,710800
2022-12-20,17.6 ( -4.35 %),11717,31088100,2653.25,5422,30518000,5629,570100
2022-12-19,18.35 ( -2.39 %),4984,21488000,4311.4,6995,26716300,3819,-5228300
2022-12-16,18.8 ( -1.05 %),6472,23305700,3601,6762,25324300,3745,-2018600
2022-12-15,18.95 ( 4.12 %),8042,60003400,7461.25,13182,43237500,3280,16765900
2022-12-14,18.15 ( 0.83 %),4063,15170400,3733.79,6477,23995300,3705,-8824900
2022-12-13,18 ( 1.69 %),5031,20599600,4094.53,3848,14665100,3811,5934500
2022-12-12,17.7 ( -2.75 %),5330,19867100,3727.41,5691,23445900,4120,-3578800
2022-12-09,18.2 ( 0.55 %),5109,16854200,3298.92,5232,21609300,4130,-4755100
2022-12-08,18.1 ( 4.62 %),6037,23471300,3887.91,6377,22752100,3568,719200
2022-12-07,17.3 ( -2.26 %),7996,26314500,3290.96,5553,22242200,4005,4072300
2022-12-06,17.7 ( -6.84 %),11546,29575900,2561.57,8746,47300600,5408,-17724700
2022-12-05,19 ( 1.06 %),7693,36070200,4688.7,8162,36147300,4429,-77100
2022-12-02,18.8 ( 5.62 %),7284,32338600,4439.68,9052,28768100,3178,3570500
2022-12-01,17.8 ( 2.3 %),9008,43727000,4854.24,13274,43827300,3302,-100300
2022-11-30,17.4 ( 1.16 %),5140,22514600,4380.27,7600,25158800,3310,-2644200
2022-11-29,17.2 ( 0 %),7312,27995000,3828.64,8310,31191800,3754,-3196800
2022-11-28,17.2 ( 6.17 %),7059,31633900,4481.36,8016,27831500,3472,3802400
2022-11-25,16.2 ( 3.18 %),4213,24551300,5827.51,5155,19218000,3728,5333300
2022-11-24,15.7 ( 0 %),4638,12496700,2694.42,3456,13791700,3991,-1295000
2022-11-23,15.7 ( -0.63 %),3271,15860200,4848.73,4859,17102900,3520,-1242700
2022-11-22,15.8 ( 0.64 %),6305,31313900,4966.52,6895,24210600,3511,7103300
2022-11-21,15.7 ( 0 %),5462,22153200,4055.88,5049,20149500,3991,2003700
2022-11-18,15.7 ( 0 %),6999,23716200,3388.51,8104,25255600,3116,-1539400
2022-11-17,15.7 ( 3.97 %),7323,24858800,3394.62,6626,25417900,3836,-559100
2022-11-16,15.1 ( 6.34 %),10741,46000800,4282.73,6617,31947000,4828,14053800
2022-11-15,14.15 ( -6.91 %),11956,27847800,2329.19,6409,36746300,5734,-8898500
2022-11-14,15.2 ( -5 %),9128,21097800,2311.33,4681,19868000,4244,1229800
2022-11-11,16 ( 1.27 %),6202,20577000,3317.8,5940,20818500,3505,-241500
2022-11-10,15.8 ( -7.06 %),11784,24301500,2062.25,4976,30780400,6186,-6478900
2022-11-09,16.95 ( -1.45 %),5381,14652300,2722.97,5215,18398000,3528,-3745700
2022-11-08,17.2 ( 1.18 %),6918,16165000,2336.66,4929,17489400,3548,-1324400
2022-11-07,16.95 ( -5.31 %),6668,22497400,3373.94,4611,22489200,4877,8200
2022-11-04,17.9 ( 1.13 %),13956,41085500,2943.93,4933,32526000,6594,8559500
2022-11-03,17.65 ( -1.4 %),4820,16353200,3392.78,3724,16433600,4413,-80400
2022-11-02,17.9 ( -0.56 %),5008,25974000,5186.5,4993,18092500,3624,7881500
2022-11-01,18 ( 1.69 %),7453,37548300,5038.01,8621,34107100,3956,3441200
2022-10-31,17.7 ( 0 %),6601,20787600,3149.16,5116,20704100,4047,83500
2022-10-28,17.65 ( 0.86 %),5650,27129600,4801.7,7546,26877600,3562,252000
2022-10-27,17.5 ( 6.71 %),5350,22741800,4250.8,6271,20066000,3200,2675800
2022-10-26,16.4 ( 0 %),4205,12968200,3084,3667,12744800,3476,223400
2022-10-25,16.4 ( 5.13 %),6718,27966900,4162.98,5405,21306000,3942,6660900
2022-10-24,15.6 ( -3.11 %),8402,26962100,3209.01,4522,28583500,6321,-1621400
2022-10-21,16.1 ( -6.4 %),11118,22633100,2035.72,3676,29056300,7904,-6423200
2022-10-20,17.15 ( -2 %),6578,11306800,1718.88,2420,13325800,5507,-2019000
2022-10-19,17.5 ( -0.57 %),4721,12956200,2744.38,2576,12580300,4884,375900
2022-10-18,17.55 ( 0.29 %),5749,19807400,3445.36,4756,18520400,3894,1287000
2022-10-17,17.5 ( -1.69 %),6983,17838400,2554.55,3794,16011800,4220,1826600
2022-10-14,17.8 ( 2.3 %),6570,21643600,3294.31,6820,21826700,3200,-183100
2022-10-13,17.4 ( 1.16 %),5151,14677200,2849.39,4303,12986700,3018,1690500
2022-10-12,17.15 ( 6.52 %),5364,24726100,4609.64,5187,14473100,2790,10253000
2022-10-11,16.05 ( -7.23 %),9690,22555900,2327.75,3860,28032300,7262,-5476400
2022-10-10,17.25 ( 1.47 %),6910,24222500,3505.43,4210,17775000,4222,6447500
2022-10-07,16.95 ( -6.35 %),15728,49363300,3138.56,5009,49393700,9861,-30400
2022-10-06,18.1 ( -5.73 %),6626,10635000,1605.04,3120,12115300,3883,-1480300
2022-10-05,19.2 ( 2.13 %),3425,10081300,2943.45,2716,7890600,2905,2190700
2022-10-04,18.8 ( 0.53 %),5284,13450900,2545.59,3276,12622400,3853,828500
2022-10-03,18.7 ( -6.5 %),7547,13278600,1759.45,3514,13592000,3868,-313400
2022-09-30,20 ( 1.01 %),5128,12944600,2524.3,3261,10991400,3371,1953200
2022-09-29,19.8 ( -1 %),3890,7894000,2029.31,2080,7412100,3564,481900
2022-09-28,19.95 ( -1.24 %),4255,7542500,1772.62,1912,6074600,3177,1467900
2022-09-27,20.2 ( 0.5 %),3696,10343400,2798.54,2328,6790700,2917,3552700
2022-09-26,20.1 ( -4.29 %),8720,17157400,1967.59,3560,17010600,4778,146800
2022-09-23,21 ( -1.41 %),3931,5773300,1468.66,2032,7433400,3658,-1660100
2022-09-22,21.25 ( 0.24 %),5977,10898900,1823.47,1999,8860800,4433,2038100
2022-09-21,21.2 ( -0.93 %),5003,9291000,1857.09,1790,6825700,3813,2465300
2022-09-20,21.35 ( 1.67 %),5296,10814100,2041.94,2258,8329600,3689,2484500
2022-09-19,21 ( -3.67 %),6994,13829700,1977.37,3342,14613800,4373,-784100
2022-09-16,21.8 ( -1.8 %),6108,12446200,2037.69,2525,12993300,5146,-547100
2022-09-15,22.15 ( -1.12 %),4335,9353800,2157.74,2325,7614000,3275,1739800
2022-09-14,22.4 ( -0.88 %),7748,19086100,2463.36,2627,11827600,4502,7258500
2022-09-13,22.55 ( -0.22 %),3585,9103800,2539.41,2849,9273100,3255,-169300
2022-09-12,22.6 ( -0.44 %),3524,5245400,1488.48,2575,6793900,2638,-1548500
2022-09-09,22.7 ( -0.44 %),7861,13154800,1673.43,3050,15155400,4969,-2000600
2022-09-08,22.8 ( -0.87 %),6823,12128400,1777.58,3177,14234600,4481,-2106200
2022-09-07,23 ( -2.95 %),6975,24852200,3563.04,4503,29260900,6498,-4408700
2022-09-06,23.65 ( 0.21 %),3772,12983900,3442.18,5353,14175700,2648,-1191800
2022-09-05,23.6 ( -0.84 %),3805,13292700,3493.48,4407,13255800,3008,36900
2022-08-31,23.75 ( 0.21 %),3404,15414300,4528.29,4454,14806500,3324,607800
2022-08-30,23.65 ( 1.07 %),4318,18909400,4379.2,6035,18121700,3003,787700
2022-08-29,23.4 ( -0.85 %),8709,26205600,3009.03,4440,18596100,4188,7609500
2022-08-26,23.6 ( -0.42 %),5151,15925400,3091.71,6020,19299700,3206,-3374300
2022-08-25,23.65 ( 1.5 %),6158,22025400,3576.71,6951,18456200,2655,3569200
2022-08-24,23.3 ( 0.43 %),4842,15549200,3211.32,4188,13103300,3129,2445900
2022-08-23,23.2 ( 0.43 %),6546,13340700,2037.99,2686,9444300,3516,3896400
2022-08-22,23.1 ( 0.43 %),9533,19751900,2071.95,4452,20780100,4668,-1028200
2022-08-19,27.6 ( -0.36 %),5194,15261000,2938.2,6547,19500200,2978,-4239200
2022-08-18,27.65 ( -0.54 %),6152,14017500,2278.53,6220,17358000,2791,-3340500
2022-08-17,27.75 ( 1.65 %),8302,25834500,3111.84,9589,26411400,2754,-576900
2022-08-16,27.25 ( -0.55 %),5079,13553800,2668.6,3550,15266600,4300,-1712800
2022-08-15,27.35 ( 0.92 %),4510,15213100,3373.19,5759,17902400,3109,-2689300
2022-08-12,27.05 ( 0.93 %),4384,10991200,2507.12,3411,10675400,3130,315800
2022-08-11,26.8 ( -1.47 %),6067,15393300,2537.22,5215,19847300,3806,-4454000
2022-08-10,27.2 ( -0.73 %),4815,11638600,2417.15,4547,14051400,3090,-2412800
2022-08-09,27.35 ( 0.92 %),5969,19009800,3184.75,6328,18620700,2943,389100
2022-08-08,27.1 ( 0.37 %),4443,20519500,4618.39,5248,15610400,2975,4909100
2022-08-05,26.95 ( -0.19 %),5256,13377300,2545.15,4080,13169800,3228,207500
2022-08-04,26.95 ( 0.19 %),4352,16620300,3819,6664,21198000,3181,-4577700
2022-08-03,26.9 ( 0.75 %),5020,17734900,3532.85,5613,16533800,2946,1201100
2022-08-02,26.7 ( 0.75 %),3713,17836200,4803.72,6363,19141100,3008,-1304900
2022-08-01,26.5 ( 3.11 %),4549,20814400,4575.6,6817,18706600,2744,2107800
2022-07-29,25.65 ( 0.2 %),3029,16997700,5611.65,4107,14534200,3539,2463500
2022-07-28,25.55 ( 2.61 %),3475,20069800,5775.48,4150,15847300,3819,4222500
2022-07-27,24.9 ( -1.19 %),4551,11499000,2526.7,2067,9488900,4591,2010100
2022-07-26,25.15 ( -0.59 %),2216,7321600,3303.97,2240,6947800,3102,373800
2022-07-25,25.25 ( -1.37 %),2790,8115000,2908.6,2238,6791200,3034,1323800
2022-07-22,25.55 ( -0.2 %),2731,12193800,4464.96,4330,13348600,3083,-1154800
2022-07-21,25.6 ( 0 %),3474,13284400,3823.95,4347,12093900,2782,1190500
2022-07-20,25.55 ( 1.39 %),3449,12353500,3581.76,4369,13061000,2989,-707500
2022-07-19,25.2 ( -0.79 %),3683,10529800,2859.03,2515,9202300,3659,1327500
2022-07-18,25.4 ( -0.39 %),2394,9974800,4166.58,3888,11682900,3005,-1708100
2022-07-15,25.45 ( -0.2 %),4987,13865700,2780.37,4865,15482900,3183,-1617200
2022-07-14,25.5 ( 0.79 %),2857,17938400,6278.75,3837,12843100,3347,5095300
2022-07-13,25.3 ( 0.8 %),3994,25661400,6424.99,5214,16283300,3123,9378100
2022-07-12,25.05 ( 2.66 %),2724,23229300,8527.64,2639,8652900,3279,14576400
2022-07-11,24.4 ( -2.79 %),4725,11623900,2460.08,2840,13594800,4787,-1970900
2022-07-08,25.05 ( -0.2 %),3144,12615300,4012.5,3267,11222600,3435,1392700
2022-07-07,25.1 ( 0.8 %),3239,16870800,5208.64,4184,12682400,3031,4188400
2022-07-06,24.9 ( -2.35 %),3905,15628000,4002.05,4555,13019400,2858,2608600
2022-07-05,25.45 ( 3.46 %),5115,44022200,8606.49,9844,25544800,2595,18477400
2022-07-04,24.6 ( 1.65 %),2920,11386500,3899.49,3766,10593700,2813,792800
2022-07-01,24.2 ( 0 %),5526,13276800,2402.61,3204,11377800,3551,1899000
2022-06-30,24.2 ( -2.02 %),3397,10414300,3065.73,3351,12686000,3786,-2271700
2022-06-29,24.7 ( 0 %),4435,14327500,3230.55,3623,14790200,4082,-462700
2022-06-28,24.7 ( 2.49 %),6354,25499500,4013.14,5939,18708900,3150,6790600
2022-06-27,24.1 ( 1.69 %),2943,10977000,3729.87,3572,8771800,2456,2205200
2022-06-24,23.7 ( -1.66 %),3375,7295100,2161.51,3219,8217200,2553,-922100
2022-06-23,24.05 ( 2.34 %),2855,10436800,3655.62,3422,8543800,2497,1893000
2022-06-22,23.45 ( 4.22 %),5290,17711200,3348.05,4342,14607000,3364,3104200
2022-06-21,22.45 ( -0.22 %),4679,12521500,2676.11,3467,10391800,2997,2129700
2022-06-20,22.5 ( -3.43 %),6220,15692300,2522.88,4438,15244600,3435,447700
2022-06-17,23.3 ( -6.43 %),12408,28643500,2308.47,4461,27380700,6138,1262800
2022-06-16,24.9 ( 0 %),4971,12691800,2553.17,3207,11693200,3646,998600
2022-06-15,24.9 ( -2.35 %),9475,23194600,2447.98,3473,22852300,6580,342300
2022-06-14,25.5 ( -0.78 %),7499,16184700,2158.25,3624,12353800,3409,3830900
2022-06-13,25.65 ( -6.73 %),11431,21860700,1912.4,5141,23976100,4664,-2115400
2022-06-10,27.5 ( -1.08 %),3817,10015000,2623.79,4746,11811400,2489,-1796400
2022-06-09,27.8 ( -0.71 %),4241,12808800,3020.23,4019,11981700,2981,827100
2022-06-08,27.95 ( 3.52 %),5546,28554500,5148.67,7411,19062400,2572,9492100
2022-06-07,26.95 ( -1.28 %),5717,9647400,1687.49,3513,10001200,2847,-353800
2022-06-06,27.25 ( -0.55 %),3949,12028900,3046.06,3552,12530200,3528,-501300
2022-06-03,27.4 ( 0.74 %),5784,9729400,1682.12,3414,9539500,2794,189900
2022-06-02,27.2 ( -1.45 %),4994,9941900,1990.77,3412,12284700,3600,-2342800
2022-06-01,27.6 ( -0.72 %),4489,9081200,2022.99,3630,9307000,2564,-225800
2022-05-31,27.75 ( -1.25 %),6615,11438600,1729.19,3113,10914300,3506,524300
2022-05-30,28.1 ( 0.36 %),4647,11529200,2481,4326,14360300,3320,-2831100
2022-05-27,28 ( 1.08 %),5164,13079800,2532.88,5109,15324800,3000,-2245000
2022-05-26,27.65 ( -1.6 %),5791,12557900,2168.52,4935,15361200,3113,-2803300
2022-05-25,28.05 ( 4.28 %),5205,19320900,3711.99,7867,17746800,2256,1574100
2022-05-24,26.85 ( 2.09 %),3818,11851000,3103.98,3920,11376800,2902,474200
2022-05-23,26.3 ( -2.59 %),6528,9989200,1530.21,3086,10510600,3406,-521400
2022-05-20,27 ( 0.75 %),4223,10725500,2539.78,4268,10437800,2446,287700
2022-05-19,26.75 ( 0.19 %),5537,12351800,2230.77,4180,12761600,3053,-409800
2022-05-18,26.65 ( 1.33 %),7011,18398300,2624.2,5295,15270000,2884,3128300
2022-05-17,26.3 ( 6.91 %),5106,16551600,3241.6,4329,10371000,2396,6180600
2022-05-16,24.6 ( 2.07 %),0,0,0,0,0,0,0
2022-05-13,24.1 ( -6.04 %),9840,24069200,2446.06,7204,25117200,3487,-1048000
2022-05-12,25.65 ( -6.73 %),10644,15311600,1438.52,3671,15093700,4112,217900
2022-05-11,27.5 ( 1.66 %),5662,10351100,1828.17,3324,9145100,2751,1206000
2022-05-10,27.05 ( 3.24 %),9377,21113100,2251.58,4506,15319100,3400,5794000
2022-05-09,26.2 ( -6.43 %),13298,24831300,1867.3,5634,23092900,4099,1738400
2022-05-06,28 ( -3.45 %),10343,14588700,1410.49,2681,13401500,4999,1187200
2022-05-05,29 ( 0.35 %),7776,11282200,1450.9,3170,11372300,3587,-90100
2022-05-04,28.9 ( -3.02 %),8812,11806700,1339.84,3243,14160600,4367,-2353900
2022-04-29,29.8 ( 1.02 %),6858,15227000,2220.33,4356,13430900,3083,1796100
2022-04-28,29.45 ( -0.84 %),6738,10329000,1532.95,4099,12557600,3064,-2228600
2022-04-27,29.7 ( 1.02 %),9588,17831300,1859.75,2952,11838300,4010,5993000
2022-04-26,29.35 ( 4.45 %),0,0,0,0,0,0,0
2022-04-25,28.1 ( -6.33 %),13111,27152800,2070.99,5737,26699500,4654,453300
2022-04-22,30 ( 0 %),9051,17795700,1966.16,4204,18623300,4430,-827600
2022-04-21,30 ( 1.69 %),9525,22154300,2325.91,5912,18856500,3190,3297800
2022-04-20,29.5 ( 0.68 %),9859,22751800,2307.72,5814,19337400,3326,3414400
2022-04-18,30.3 ( -3.5 %),13990,26280200,1878.5,6525,26793500,4106,-513300
2022-04-15,31.4 ( -2.79 %),12361,21146100,1710.71,5074,23215800,4575,-2069700
2022-04-14,32.3 ( -0.92 %),7238,13637300,1884.13,4465,16142300,3615,-2505000
2022-04-13,32.6 ( 0.93 %),7811,21524800,2755.7,5096,19900100,3905,1624700
2022-04-12,32.25 ( -2.86 %),11042,23983200,2172,5067,24598300,4855,-615100
2022-04-08,0 ( 0 %),8835,18322600,2073.87,6943,23827000,3432,-5504400
2022-04-07,33.7 ( 0.9 %),12926,36939900,2857.8,18919,49450100,2614,-12510200
2022-04-06,33.35 ( 1.99 %),9883,28389700,2872.58,9876,30733500,3112,-2343800
2022-04-05,32.65 ( -1.06 %),7080,17001700,2401.37,6209,19578600,3153,-2576900
2022-04-04,33 ( -0.9 %),7804,18100200,2319.35,9262,26914500,2906,-8814300
2022-04-01,33.3 ( 0.91 %),8207,29104700,3546.33,13669,34310400,2510,-5205700
2022-03-31,32.95 ( 0.76 %),4519,20248100,4480.66,10288,28909400,2810,-8661300
2022-03-30,32.65 ( 2.03 %),11144,46003600,4128.1,18874,50196900,2660,-4193300
2022-03-29,32 ( 1.59 %),5556,14402800,2592.3,3823,12354100,3232,2048700
2022-03-28,31.5 ( -0.94 %),10661,19645300,1842.73,4467,19698100,4410,-52800
2022-03-25,31.8 ( -0.93 %),6056,12049400,1989.66,4405,15209000,3453,-3159600
2022-03-24,32.05 ( -0.47 %),5263,15351600,2916.89,4692,15215800,3243,135800
2022-03-23,32.15 ( -1.08 %),5569,16643600,2988.62,6258,19004900,3037,-2361300
2022-03-22,32.45 ( 0.78 %),4596,16473900,3584.4,9383,21611400,2303,-5137500
2022-03-21,32.2 ( 0.31 %),7516,19569800,2603.75,6268,20819200,3322,-1249400
2022-03-18,32.1 ( -0.62 %),5888,16570000,2814.2,6456,22572600,3496,-6002600
2022-03-17,32.25 ( 0.47 %),5129,19759900,3852.58,8747,23709300,2711,-3949400
2022-03-16,32.1 ( 1.58 %),6582,22096500,3357.11,7808,22014000,2819,82500
2022-03-15,31.6 ( -0.32 %),7271,17289300,2377.84,4912,17154700,3492,134600
2022-03-14,31.65 ( 0.48 %),0,0,0,0,0,0,0
2022-03-11,31.45 ( 1.13 %),6920,19428900,2807.64,6965,20623000,2961,-1194100
2022-03-10,31.05 ( 0.81 %),8302,19957800,2403.97,5899,20176400,3420,-218600
2022-03-09,30.75 ( -0.81 %),16864,40502500,2401.71,9574,34740900,3629,5761600
2022-03-08,31 ( -3.73 %),20632,36868200,1786.94,8769,39837500,4543,-2969300
2022-03-07,32.2 ( -2.13 %),15517,31792400,2048.88,7629,29911200,3921,1881200
2022-03-04,32.9 ( -0.6 %),8534,19587700,2295.25,6163,21715000,3523,-2127300
2022-03-03,33.1 ( 1.85 %),22428,50576300,2255.05,12264,46464600,3789,4111700
2022-03-02,32.5 ( -4.41 %),36713,79137000,2155.56,14982,77355200,5163,1781800
2022-03-01,34 ( -1.16 %),7989,24691100,3090.64,10830,31875800,2943,-7184700
2022-02-28,34.4 ( 0.88 %),7647,22109000,2891.2,9984,25677600,2572,-3568600
2022-02-25,34.1 ( 0.29 %),9218,29852300,3238.48,13168,34437400,2615,-4585100
2022-02-24,34 ( -1.16 %),15628,50313600,3219.45,16656,54289900,3259,-3976300
2022-02-23,34.35 ( -0.15 %),8701,27213900,3127.67,17365,43812000,2523,-16598100
2022-02-22,34.4 ( 5.2 %),17957,61136100,3404.58,17177,53816600,3133,7319500
2022-02-21,32.65 ( -0.15 %),15862,32891500,2073.6,9264,30449700,3287,2441800
2022-02-18,32.65 ( -1.66 %),12482,24866900,1992.22,5761,22696200,3940,2170700
2022-02-17,33.2 ( 1.53 %),6212,16515500,2658.64,6357,17163400,2700,-647900
2022-02-16,32.65 ( -0.15 %),9169,16797300,1831.97,5628,17317400,3077,-520100
2022-02-15,32.7 ( 2.19 %),14897,38866000,2608.98,7776,31495700,4050,7370300
2022-02-14,32 ( -5.88 %),18412,36196200,1965.9,7875,39781000,5052,-3584800
2022-02-11,33.95 ( 0.44 %),7696,24391800,3169.41,10412,29659200,2849,-5267400
2022-02-10,33.75 ( 1.35 %),13893,45430600,3270.04,13110,42239900,3222,3190700
2022-02-09,33.3 ( -1.48 %),11463,35054000,3058.01,11861,37959500,3200,-2905500
2022-02-08,33.8 ( 0 %),10844,31663600,2919.92,10569,33147200,3136,-1483600
2022-02-07,33.8 ( 0.3 %),8484,23313000,2747.88,11908,30224600,2538,-6911600
2022-01-28,33.7 ( 2.12 %),10563,41139400,3894.67,16074,44399100,2762,-3259700
2022-01-27,33 ( -0.9 %),12507,29517900,2360.11,10247,32162900,3139,-2645000
2022-01-26,33.3 ( 2.15 %),13516,44352700,3281.5,17274,48867000,2829,-4514300
2022-01-25,32.6 ( 1.56 %),0,0,0,0,0,0,0
2022-01-24,32.1 ( 0.94 %),12996,49684300,3823.05,21678,59510600,2745,-9826300
2022-01-21,31.8 ( 5.3 %),21267,84826000,3988.62,30346,83460800,2750,1365200
2022-01-20,29.95 ( 1.18 %),6003,29410600,4899.32,9189,29798000,3243,-387400
2022-01-19,29.7 ( -0.67 %),6285,20717100,3296.28,12496,31724600,2539,-11007500
2022-01-18,29.9 ( 1.36 %),6655,25839700,3882.75,12050,30991300,2572,-5151600
2022-01-17,29.5 ( -0.51 %),10804,43772600,4051.52,22995,57628200,2506,-13855600
2022-01-14,29.65 ( -0.17 %),4908,15641900,3187.02,12537,27174700,2168,-11532800
2022-01-13,29.7 ( 1.71 %),13934,56615500,4063.12,30936,64702000,2091,-8086500
2022-01-12,29.2 ( 4.66 %),5177,31785400,6139.73,11059,24565900,2221,7219500
2022-01-11,27.9 ( -0.71 %),4444,12147800,2733.53,4857,12580000,2590,-432200
2022-01-10,28.1 ( -1.75 %),4952,12916200,2608.28,6297,16061800,2551,-3145600
2022-01-07,28.6 ( 0.7 %),4210,16884600,4010.59,6854,16690900,2435,193700
2022-01-06,28.35 ( -1.22 %),7404,16922200,2285.55,5319,18206600,3423,-1284400
2022-01-05,28.7 ( -1.37 %),6076,13348400,2196.91,7050,17333500,2459,-3985100
2022-01-04,29.1 ( 0.69 %),4437,14713600,3316.11,9278,20157200,2173,-5443600
2021-12-31,28.9 ( 1.4 %),5907,19328600,3272.15,13296,30198100,2271,-10869500
2021-12-30,28.45 ( 0.53 %),2922,9120300,3121.25,6124,21099300,3445,-11979000
2021-12-29,28.3 ( 0 %),5221,13368600,2560.54,8884,27078000,3048,-13709400
2021-12-28,28.3 ( 0.35 %),4259,12396600,2910.68,7122,15068000,2116,-2671400
2021-12-27,28.15 ( -0.18 %),3491,7965400,2281.7,5008,9751100,1947,-1785700
2021-12-24,28.15 ( 3.11 %),6168,12221500,1981.44,5063,10775300,2128,1446200
2021-12-23,27.3 ( -1.44 %),9981,16962900,1699.52,5825,16771200,2879,191700
2021-12-22,27.65 ( -1.25 %),8837,13357800,1511.58,5803,15156500,2612,-1798700
2021-12-21,27.95 ( 0.18 %),6080,11194000,1841.12,5090,14158600,2782,-2964600
2021-12-20,27.9 ( -1.06 %),9197,12783900,1390.01,3964,12599900,3179,184000
2021-12-17,28.2 ( -0.18 %),6771,11970300,1767.88,4839,13331100,2755,-1360800
2021-12-16,28.25 ( -0.88 %),5573,10071200,1807.14,4830,12669600,2623,-2598400
2021-12-15,28.5 ( 0.88 %),5514,14719400,2669.46,5302,13327800,2514,1391600
2021-12-14,28.25 ( -0.53 %),5929,10857300,1831.22,5006,14200200,2837,-3342900
2021-12-13,28.4 ( 0.18 %),5977,15062700,2520.11,5028,14530200,2890,532500
2021-12-10,28.35 ( -0.7 %),6463,10223100,1581.79,5200,13409400,2579,-3186300
2021-12-09,28.55 ( 0.53 %),5380,10812000,2009.67,4298,10706500,2491,105500
2021-12-08,28.4 ( 0.89 %),5065,13165800,2599.37,5145,13067100,2540,98700
2021-12-07,28.15 ( 2.36 %),7898,16391300,2075.37,4698,11974200,2549,4417100
2021-12-06,27.5 ( -2.83 %),15046,24127500,1603.58,6627,28082500,4238,-3955000
2021-12-03,28.3 ( -2.75 %),8537,18665700,2186.45,6885,22386900,3252,-3721200
2021-12-02,29.1 ( -1.36 %),5598,13058300,2332.67,5699,15677700,2751,-2619400
2021-12-01,29.5 ( 1.72 %),7975,19512500,2446.71,6938,18114500,2611,1398000
2021-11-30,29 ( -2.68 %),14029,30444800,2170.13,9606,35508900,3697,-5064100
2021-11-29,29.8 ( -1.65 %),13568,29710300,2189.73,8341,27099800,3249,2610500
2021-11-26,30.3 ( -1.94 %),11475,27834400,2425.66,14602,36143500,2475,-8309100
2021-11-25,30.9 ( 0 %),13900,31715400,2281.68,20976,49755900,2372,-18040500
2021-11-24,30.9 ( 6.92 %),21890,70271400,3210.21,31293,61142900,1954,9128500
2021-11-23,28.9 ( -1.03 %),6400,15013600,2345.88,11213,24373000,2174,-9359400
2021-11-22,29.2 ( 3.18 %),11432,38251500,3346,19261,43483400,2258,-5231900
2021-11-19,28.3 ( 0 %),11537,27599100,2392.23,15375,36626200,2382,-9027100
2021-11-18,28.3 ( -1.39 %),8470,15213100,1796.12,7715,19953200,2586,-4740100
2021-11-17,28.7 ( 0.17 %),5833,12159900,2084.67,7219,15487900,2145,-3328000
2021-11-16,28.65 ( 0.17 %),6539,23101600,3532.89,14979,33440100,2232,-10338500
2021-11-15,28.6 ( 0.18 %),5892,21386000,3629.67,13815,31218400,2260,-9832400
2021-11-12,28.55 ( 1.6 %),11281,20388700,1807.35,7620,18768500,2463,1620200
2021-11-11,28.1 ( -1.75 %),14067,21933900,1559.25,8654,24827900,2869,-2894000
2021-11-10,28.6 ( 0 %),0,0,0,0,0,0,0
2021-11-09,28.6 ( 0.35 %),7633,22655600,2968.11,12092,26141900,2162,-3486300
2021-11-08,28.5 ( -0.52 %),13565,23511300,1733.23,8779,26438200,3012,-2926900
2021-11-05,28.65 ( -0.87 %),7725,14223800,1841.27,7516,19472300,2591,-5248500
2021-11-04,28.9 ( -0.86 %),7839,18472200,2356.45,10540,28660200,2719,-10188000
2021-11-03,29.15 ( 2.64 %),14559,42874000,2944.85,20190,49063200,2430,-6189200
2021-11-02,28.4 ( 0 %),7701,14583500,1893.72,9609,19994100,2081,-5410600
2021-11-01,28.4 ( -0.35 %),7119,17187300,2414.29,11090,23049800,2078,-5862500
2021-10-29,28.5 ( 0 %),6450,19128500,2965.66,10459,22397700,2141,-3269200
2021-10-28,28.5 ( 0.35 %),6327,15646600,2472.99,12144,23291800,1918,-7645200
2021-10-27,28.4 ( 1.61 %),6224,16271300,2614.28,10350,20064900,1939,-3793600
2021-10-26,27.95 ( 1.27 %),7253,14295700,1971.01,6166,14449600,2343,-153900
2021-10-25,27.6 ( -1.08 %),10674,16043300,1503.03,6890,18832000,2733,-2788700
2021-10-22,27.9 ( 0 %),7824,13962900,1784.62,7336,18579200,2533,-4616300
2021-10-21,27.9 ( -1.06 %),7966,18049700,2265.84,7321,21666500,2960,-3616800
2021-10-20,28.2 ( 0 %),7150,16216500,2268.04,8054,20351000,2527,-4134500
2021-10-19,28.2 ( -0.7 %),7484,14040100,1876.02,7105,23551800,3315,-9511700
2021-10-18,28.4 ( 0 %),7188,13784300,1917.68,9558,22086300,2311,-8302000
2021-10-15,28.4 ( -0.35 %),6937,14454500,2083.68,9776,20867300,2135,-6412800
2021-10-14,28.5 ( -0.35 %),8107,17030600,2100.73,10206,24129600,2364,-7099000
2021-10-13,28.6 ( -0.52 %),7548,18334300,2429.03,13337,28884300,2166,-10550000
2021-10-12,28.75 ( -0.17 %),10885,23429700,2152.48,16965,33828500,1994,-10398800
2021-10-11,28.8 ( 3.97 %),12276,39998400,3258.26,20073,39477000,1967,521400
2021-10-08,27.7 ( 0.18 %),5800,12098100,2085.88,8218,16156700,1966,-4058600
2021-10-07,27.65 ( 0.55 %),5357,11570800,2159.94,7821,14670900,1876,-3100100
2021-10-06,27.5 ( 0.36 %),11973,18035600,1506.36,6612,17680900,2674,354700
2021-10-05,27.4 ( 1.11 %),9997,17317800,1732.3,6515,15312500,2350,2005300
2021-10-04,27.1 ( -1.28 %),15338,20628900,1344.95,10089,21336400,2115,-707500
2021-10-01,27.45 ( -1.44 %),17500,20740000,1185.14,7609,22872400,3006,-2132400
2021-09-30,27.85 ( 0.18 %),6385,12214000,1912.92,7409,15811200,2134,-3597200
2021-09-29,27.8 ( -0.71 %),12712,18407000,1448,7212,24650200,3418,-6243200
2021-09-28,28 ( 0 %),9153,14294100,1561.68,6042,16041400,2655,-1747300
2021-09-27,28 ( -2.44 %),9581,13976300,1458.75,9686,22453000,2318,-8476700
2021-09-24,28.7 ( 2.87 %),17971,47193800,2626.11,20266,48246500,2381,-1052700
2021-09-23,27.9 ( -0.36 %),10138,19085900,1882.61,9017,22078200,2449,-2992300
2021-09-22,28 ( 0 %),9608,17147700,1784.73,7697,17553200,2281,-405500
2021-09-21,28 ( -0.88 %),12140,18135600,1493.87,7150,19836000,2774,-1700400
2021-09-20,28.25 ( 1.44 %),11981,27385600,2285.75,13037,29958900,2298,-2573300
2021-09-17,27.85 ( 0.18 %),10969,16366200,1492.04,8490,19532400,2301,-3166200
2021-09-16,27.8 ( 1.28 %),9604,16435200,1711.29,7665,18687600,2438,-2252400
2021-09-15,27.45 ( -0.54 %),15670,22161500,1414.26,7505,20089900,2677,2071600
2021-09-14,27.6 ( -1.08 %),11438,16283600,1423.64,7835,20152600,2572,-3869000
2021-09-13,27.9 ( -1.06 %),13922,21043600,1511.54,8880,24966500,2812,-3922900
2021-09-10,28.2 ( -0.7 %),9874,14409500,1459.34,8065,18635200,2311,-4225700
2021-09-09,28.4 ( 0.35 %),11107,19608900,1765.45,7523,19402700,2579,206200
2021-09-08,28.3 ( -1.05 %),8960,15249200,1701.92,8195,21784500,2658,-6535300
2021-09-07,28.6 ( 1.06 %),15783,31583700,2001.12,13404,32146100,2398,-562400
2021-09-06,28.3 ( 1.43 %),17152,29609100,1726.28,11897,28474400,2393,1134700
2021-09-01,27.9 ( 0 %),14174,23900300,1686.21,9840,24155300,2455,-255000
2021-08-31,27.9 ( -1.76 %),13086,16921600,1293.11,9053,22652700,2502,-5731100
2021-08-30,28.4 ( 1.43 %),14568,29140900,2000.34,11791,26174300,2220,2966600
2021-08-27,28 ( -0.36 %),21031,33867000,1610.34,12331,29299100,2376,4567900
2021-08-26,28.1 ( -1.75 %),14739,22377000,1518.22,9518,22155200,2328,221800
2021-08-25,28.6 ( 0.18 %),23217,34620300,1491.16,10797,26724900,2475,7895400
2021-08-24,28.55 ( -0.17 %),14996,25665500,1711.49,11498,26093400,2269,-427900
2021-08-23,28.6 ( -4.35 %),19129,34113200,1783.32,16715,39433500,2359,-5320300
2021-08-20,29.9 ( -3.86 %),26877,46901200,1745.03,16984,52792000,3108,-5890800
2021-08-19,31.1 ( 0 %),21267,39046300,1836,11007,32311700,2936,6734600
2021-08-18,31.1 ( -0.32 %),10232,24281900,2373.13,13963,25342800,1815,-1060900
2021-08-17,31.2 ( 0.65 %),14151,33725000,2383.22,18206,41979600,2306,-8254600
2021-08-16,31 ( 4.73 %),24080,55239200,2293.99,23376,49989200,2138,5250000
2021-08-13,29.6 ( 0.34 %),13306,21001200,1578.33,8604,20700200,2406,301000
2021-08-12,29.5 ( -0.67 %),11832,18777000,1586.97,9833,23632600,2403,-4855600
2021-08-11,29.7 ( 0.17 %),17142,34358200,2004.33,17357,35152600,2025,-794400
2021-08-10,29.65 ( -0.84 %),15611,27032000,1731.6,11707,28000000,2392,-968000
2021-08-09,29.9 ( 0.84 %),15205,28159000,1851.96,10596,22860600,2157,5298400
2021-08-06,29.65 ( -1.17 %),14630,32728500,2237.08,11966,27816000,2325,4912500
2021-08-05,30 ( 1.01 %),13186,30995900,2350.67,11326,26833100,2369,4162800
2021-08-04,29.7 ( 1.37 %),14053,30158100,2146.03,13397,30398800,2269,-240700
2021-08-03,29.3 ( 1.74 %),13840,30607700,2211.54,14820,34199800,2308,-3592100
2021-08-02,28.8 ( -0.35 %),12682,24389900,1923.19,10659,22369200,2099,2020700
2021-07-30,28.9 ( 1.76 %),16275,33937600,2085.26,14223,31726700,2231,2210900
2021-07-29,28.4 ( 2.9 %),11958,28364800,2372.04,11794,25396300,2153,2968500
2021-07-28,27.6 ( 0.73 %),9044,13149700,1453.97,6340,12834400,2024,315300
2021-07-27,27.4 ( 0.74 %),10911,20727100,1899.65,8197,19037800,2323,1689300
2021-07-26,27.2 ( -1.98 %),18971,28650400,1510.22,7668,25091200,3272,3559200
2021-07-23,27.75 ( -2.12 %),15641,20621100,1318.4,8456,23426900,2770,-2805800
2021-07-22,28.35 ( 1.25 %),10080,20746500,2058.18,8596,20089300,2337,657200
2021-07-21,28 ( 0.36 %),12432,21859700,1758.34,9016,25701100,2851,-3841400
2021-07-20,27.9 ( 2.76 %),15976,33843600,2118.4,10672,26867900,2518,6975700
2021-07-19,27.15 ( -6.7 %),23548,36745900,1560.47,11199,38249700,3415,-1503800
2021-07-16,29.1 ( -0.68 %),14142,21485000,1519.23,7488,25870000,3455,-4385000
2021-07-15,29.3 ( 1.56 %),18805,31098300,1653.73,8570,25717200,3001,5381100
2021-07-14,28.85 ( -3.19 %),24735,36501100,1475.69,8539,36263100,4247,238000
2021-07-13,29.8 ( 0 %),18007,22384300,1243.09,7164,26847700,3748,-4463400
2021-07-12,29.8 ( -28.79 %),30707,53965800,1757.44,13775,71585500,5197,-17619700
2021-07-09,41.85 ( -0.59 %),20573,57112600,2776.09,32299,75588400,2340,-18475800
2021-07-08,42.1 ( 0 %),0,0,0,0,0,0,0
2021-07-07,42.1 ( 4.99 %),26373,55968300,2122.18,15648,48427000,3095,7541300
2021-07-06,40.1 ( -6.96 %),0,0,0,0,0,0,0
2021-07-02,43.45 ( 0 %),0,0,0,0,0,0,0
2021-07-01,43.45 ( 0.23 %),18947,42903600,2264.4,13819,43345200,3137,-441600
2021-06-30,43.35 ( -0.23 %),19619,37893200,1931.45,17275,52053800,3013,-14160600
2021-06-29,43.45 ( 0.81 %),13300,33699700,2533.81,14570,33637100,2309,62600
2021-06-28,43.1 ( 2.38 %),0,0,0,0,0,0,0
2021-06-25,42.1 ( 0.24 %),17762,33083200,1862.58,10884,29163600,2679,3919600
2021-06-24,42 ( 0.24 %),14642,39635200,2706.95,16635,43235100,2599,-3599900
2021-06-23,41.9 ( -0.24 %),15903,40067400,2519.49,13959,43202800,3095,-3135400
2021-06-22,42 ( 3.32 %),19680,69551300,3534.11,23532,57390100,2439,12161200
2021-06-21,0 ( 0 %),12233,36597100,2991.67,13555,32560400,2402,4036700
2021-06-18,40.55 ( 1.63 %),15906,39763500,2499.91,18408,46693000,2537,-6929500
2021-06-17,39.9 ( 3.1 %),19534,46254900,2367.92,11261,36363300,3229,9891600
2021-06-16,38.7 ( -1.53 %),15704,32250700,2053.66,9587,33574800,3502,-1324100
2021-06-15,39.3 ( 0 %),19366,38918900,2009.65,12030,42366800,3522,-3447900
2021-06-14,39.3 ( -0.25 %),16948,33478300,1975.35,12087,41397800,3425,-7919500
2021-06-11,39.4 ( 3.96 %),14446,38413500,2659.11,13985,40529100,2898,-2115600
2021-06-10,37.9 ( -1.69 %),14086,24305900,1725.54,7769,28167400,3626,-3861500
2021-06-09,38.55 ( 3.35 %),21796,52248500,2397.16,14292,40269200,2818,11979300
2021-06-08,37.3 ( -6.16 %),20783,33978600,1634.92,15294,50964000,3332,-16985400
2021-06-07,39.75 ( -4.33 %),21935,40687600,1854.92,15932,47616400,2989,-6928800
2021-06-04,41.55 ( 0.97 %),16727,47718300,2852.77,13173,48690200,3696,-971900
2021-06-03,41.15 ( 6.88 %),0,0,0,0,0,0,0
2021-06-02,38.5 ( 0.79 %),20696,47103400,2275.97,13280,35612400,2682,11491000
2021-06-01,38.2 ( 0.53 %),11289,30806600,2728.9,12314,35659000,2896,-4852400
2021-05-31,38 ( 0.8 %),25349,60218700,2375.58,14030,49283600,3513,10935100
2021-05-28,37.7 ( 3.29 %),18734,57416600,3064.83,19089,46068000,2413,11348600
2021-05-27,36.5 ( -2.67 %),20517,48120100,2345.38,20954,59405100,2835,-11285000
2021-05-26,37.5 ( 4.75 %),21038,72419600,3442.32,24727,61303500,2479,11116100
2021-05-25,35.8 ( 3.02 %),16231,49342300,3040,13536,38404800,2837,10937500
2021-05-24,34.75 ( 0.29 %),16117,38195300,2369.88,13217,37448400,2833,746900
2021-05-21,34.65 ( 0.43 %),17685,41241700,2332.02,13214,38754900,2933,2486800
2021-05-20,34.5 ( 0 %),20049,38967400,1943.61,11007,33408000,3035,5559400
2021-05-19,34.5 ( 3.6 %),21515,60661700,2819.51,15660,48597900,3103,12063800
2021-05-18,33.3 ( 1.22 %),20032,44115700,2202.26,11788,40545400,3440,3570300
2021-05-17,32.9 ( -0.3 %),15721,30387400,1932.92,10428,36849800,3534,-6462400
2021-05-14,33 ( 0.15 %),16820,39615900,2355.29,13946,43385800,3111,-3769900
2021-05-13,32.95 ( -0.75 %),23714,49970700,2107.22,15040,46804300,3112,3166400
2021-05-12,33.2 ( 1.53 %),16437,38764200,2358.35,10048,34112000,3395,4652200
2021-05-11,32.7 ( -1.51 %),16978,30957700,1823.4,13090,40115000,3065,-9157300
2021-05-10,33.2 ( 5.06 %),27930,67375100,2412.28,16451,57122100,3472,10253000
2021-05-07,31.6 ( 0 %),22246,45775000,2057.67,13597,41518400,3053,4256600
2021-05-06,31.6 ( -0.32 %),12987,32904300,2533.63,12825,40837200,3184,-7932900
2021-05-05,31.7 ( 1.44 %),15666,41477700,2647.63,16482,49248300,2988,-7770600
2021-05-04,31.25 ( 2.97 %),16707,48174600,2883.5,12004,40843300,3402,7331300
2021-04-29,30.35 ( 0.33 %),10820,35702500,3299.68,9363,37757200,4033,-2054700
2021-04-28,30.25 ( 2.2 %),9763,29911400,3063.75,9415,32984400,3503,-3073000
2021-04-27,29.6 ( 0 %),8908,17378100,1950.84,5086,19759200,3885,-2381100
2021-04-23,30.3 ( 3.77 %),13144,33925100,2581.03,7509,27933500,3720,5991600
2021-04-22,29.2 ( -4.26 %),10275,19090200,1857.93,5747,28989900,5044,-9899700
2021-04-20,0 ( 0 %),9214,19907500,2160.57,8570,28586500,3336,-8679000
2021-04-19,30.5 ( 0.99 %),10354,26980400,2605.79,5320,22740000,4274,4240400
2021-04-16,30.2 ( -1.31 %),15392,30108500,1956.11,5818,30244100,5198,-135600
2021-04-15,30.6 ( -2.08 %),15525,28845500,1858,5618,31234400,5560,-2388900
2021-04-14,31.25 ( 0.48 %),15498,34150900,2203.57,5997,27785200,4633,6365700
2021-04-13,31.1 ( -1.74 %),12097,30688200,2536.84,8564,41389900,4833,-10701700
2021-04-12,31.65 ( 0.96 %),8308,29759600,3582.04,8945,28799300,3220,960300
2021-04-09,31.35 ( 0.48 %),11603,38386900,3308.36,7301,28965700,3967,9421200
2021-04-08,31.2 ( -1.89 %),12715,39309100,3091.55,13913,53758800,3864,-14449700
2021-04-07,31.8 ( 1.27 %),9975,49062900,4918.59,12112,46603700,3848,2459200
2021-04-06,31.4 ( 3.29 %),14391,76554400,5319.6,14661,56801600,3874,19752800
2021-04-05,30.4 ( 2.7 %),10705,57586800,5379.43,14955,49435300,3306,8151500
2021-04-02,29.6 ( 1.37 %),5682,39439300,6941.09,11932,37267600,3123,2171700
2021-04-01,29.2 ( 3.73 %),6104,40142600,6576.44,9979,34973900,3505,5168700
2021-03-31,28.15 ( -0.53 %),4742,16792000,3541.12,5842,22452100,3843,-5660100
2021-03-30,28.3 ( 0.18 %),5691,23185800,4074.12,6483,24624600,3798,-1438800
2021-03-29,28.25 ( 2.73 %),7290,30234200,4147.35,5115,26244800,5131,3989400
2021-03-26,27.5 ( -0.18 %),10295,24960500,2424.53,5787,24668800,4263,291700
2021-03-25,27.55 ( -0.18 %),8709,25663600,2946.79,5983,25201600,4212,462000
2021-03-24,27.6 ( -2.65 %),11608,25742400,2217.64,4866,27871000,5728,-2128600
2021-03-23,28.35 ( -1.05 %),9919,27052500,2727.34,5098,26913600,5279,138900
2021-03-22,28.65 ( -1.88 %),11906,28053700,2356.27,5908,31991100,5415,-3937400
2021-03-19,29.2 ( 0 %),6823,17993900,2637.24,6067,19904700,3281,-1910800
2021-03-18,29.2 ( 0.69 %),5458,21252700,3893.86,8199,27685700,3377,-6433000
2021-03-17,29 ( 1.22 %),6353,2731190,429.91,7327,2760060,377,-28870
2021-03-16,28.65 ( -0.87 %),7908,22776900,2880.24,8099,30064100,3712,-7287200
2021-03-15,28.9 ( 2.3 %),7075,3880480,548.48,11633,3862920,332,17560
2021-03-12,28.25 ( 0 %),5123,22734300,4437.69,10219,33680600,3296,-10946300
2021-03-11,28.25 ( 1.07 %),6992,26304300,3762.06,10699,39927300,3732,-13623000
2021-03-10,27.95 ( 2.38 %),9359,36901800,3942.92,9267,37532600,4050,-630800
2021-03-09,27.3 ( -1.09 %),0,0,0,0,0,0,0
2021-03-08,27.6 ( 0.91 %),7216,2312160,320.42,5772,2636780,457,-324620
2021-03-05,27.35 ( 0.74 %),14360,41218200,2870.35,5970,28986400,4855,12231800
2021-03-04,27.15 ( -3.04 %),14176,32119700,2265.78,7905,44560600,5637,-12440900
2021-03-03,28 ( -0.36 %),11059,27750800,2509.34,6930,31054400,4481,-3303600
2021-03-02,28.1 ( -0.88 %),10042,2370970,236.11,8867,3194650,360,-823680
2021-03-01,28.35 ( 2.53 %),9306,37209200,3998.41,8619,34973300,4058,2235900
2021-02-26,27.65 ( 1.28 %),16356,47367700,2896.04,8934,41855700,4685,5512000
2021-02-25,27.3 ( 1.11 %),11354,37172600,3273.97,8373,33691600,4024,3481000
2021-02-24,27 ( -1.46 %),11125,33556300,3016.3,9930,38226500,3850,-4670200
2021-02-23,27.4 ( 2.62 %),11518,57097200,4957.21,15666,52509400,3352,4587800
2021-02-22,26.7 ( -0.56 %),8910,29845600,3349.67,11680,44125400,3778,-14279800
2021-02-19,26.85 ( 2.48 %),11505,54291200,4718.92,16778,61341300,3656,-7050100
2021-02-18,26.2 ( 1.55 %),7614,47757700,6272.35,12295,39996600,3253,7761100
2021-02-17,25.8 ( 4.24 %),6373,38516500,6043.7,8739,31451900,3599,7064600
2021-02-09,24.75 ( 3.56 %),5173,3771770,729.13,6638,2644260,398,1127510
2021-02-08,23.9 ( -3.43 %),6632,3424660,516.38,8478,4044450,477,-619790
2021-02-05,24.75 ( 2.91 %),4949,21460800,4336.39,6257,22625300,3616,-1164500
2021-02-04,24.05 ( -0.82 %),7464,21588900,2892.4,5379,25191300,4683,-3602400
2021-02-03,24.25 ( 3.85 %),7222,37881200,5245.25,5896,31591700,5358,6289500
2021-02-02,23.35 ( 6.14 %),5407,31199900,5770.28,6327,24912100,3937,6287800
2021-02-01,22 ( -6.18 %),10229,33537500,3278.67,4697,29760500,6336,3777000
2021-01-29,23.45 ( 4.92 %),9481,52239300,5509.89,5881,31096500,5288,21142800
2021-01-28,22.35 ( -6.87 %),6008,27189100,4525.48,9139,50365600,5511,-23176500
2021-01-27,24 ( -6.25 %),10929,44690900,4089.2,5802,43353600,7472,1337300
2021-01-26,25.6 ( 1.59 %),8464,3997410,472.28,4730,3269670,691,727740
2021-01-25,25.2 ( -1.56 %),5006,3236550,646.53,5237,2194330,419,1042220
2021-01-22,25.6 ( -0.78 %),7130,2499780,350.6,5923,2824770,477,-324990
2021-01-21,25.8 ( 5.74 %),8429,36766300,4361.88,4675,24726900,5289,12039400
2021-01-20,24.4 ( 0 %),9803,48707200,4968.6,7216,50114600,6945,-1407400
2021-01-19,24.4 ( -6.87 %),10727,26202800,2442.7,6835,47389800,6933,-21187000
2021-01-18,26.2 ( -2.06 %),7834,19200800,2450.96,4894,25645300,5240,-6444500
2021-01-15,26.75 ( 1.33 %),7350,30217600,4111.24,7234,38716600,5352,-8499000
2021-01-14,26.4 ( 1.54 %),7462,35637400,4775.85,5654,35860900,6343,-223500
2021-01-13,26 ( -0.57 %),7780,29025200,3730.75,5623,38954100,6928,-9928900
2021-01-12,26.15 ( -0.76 %),9121,30615900,3356.64,7203,37700400,5234,-7084500
2021-01-11,26.35 ( -0.94 %),9666,31623600,3271.63,6794,47134800,6938,-15511200
2021-01-08,26.6 ( 2.7 %),8976,43174200,4809.96,7709,43082900,5589,91300
2021-01-07,25.9 ( 2.37 %),7756,32563500,4198.49,7029,37771900,5374,-5208400
2021-01-06,25.3 ( 0.6 %),9238,39603900,4287.06,7456,46977900,6301,-7374000
2021-01-05,25.15 ( 5.01 %),11413,59093400,5177.73,8036,55095000,6856,3998400
2021-01-04,23.95 ( 4.13 %),0,0,0,0,0,0,0
2020-12-31,23 ( 0.44 %),0,0,0,0,0,0,0
2020-12-30,22.9 ( -0.22 %),5286,21746510,4113.98,5097,24343190,4776,-2596680
2020-12-29,22.95 ( -0.43 %),5325,18431820,3461.37,4298,19945250,4641,-1513430
2020-12-28,23.05 ( -0.22 %),7996,24717880,3091.28,5202,32136160,6178,-7418280
2020-12-25,23.1 ( 1.32 %),6911,26098210,3776.33,5294,25141620,4749,956590
2020-12-24,22.8 ( -0.44 %),7891,28769480,3645.86,6056,36731980,6065,-7962500
2020-12-23,22.9 ( -1.29 %),6990,19825240,2836.23,4055,24801900,6116,-4976660
2020-12-22,23.2 ( -0.22 %),0,0,0,0,0,0,0
2020-12-21,23.25 ( 0.65 %),10942,50249550,4592.36,5238,41528790,7928,8720760
2020-12-18,23.1 ( 4.52 %),6420,51935570,8089.65,6337,28214420,4452,23721150
2020-12-17,22.1 ( -0.67 %),6567,31264850,4760.9,3453,26301650,7617,4963200
2020-12-16,22.25 ( 3.49 %),5276,61994050,11750.2,6716,30380320,4524,31613730
2020-12-15,21.5 ( -1.6 %),5009,22847180,4561.23,3815,23880880,6260,-1033700
2020-12-14,21.85 ( 1.63 %),3472,30406390,8757.6,4732,23227460,4909,7178930
2020-12-11,21.5 ( 2.14 %),4776,27561600,5770.85,3404,16219550,4765,11342050
2020-12-10,21.05 ( -1.64 %),4983,22288790,4472.97,3792,24925270,6573,-2636480
2020-12-09,21.4 ( 0.23 %),3491,19496670,5584.84,5008,27076860,5407,-7580190
2020-12-08,21.35 ( 2.15 %),0,0,0,0,0,0,0
2020-12-07,20.9 ( -0.24 %),4890,17493430,3577.39,4337,17790510,4102,-297080
2020-12-04,20.95 ( -0.24 %),6231,37758220,6059.74,4382,30067310,6862,7690910
2020-12-03,21 ( -1.64 %),9213,60112740,6524.77,4886,40761640,8343,19351100
2020-12-02,21.35 ( 2.4 %),5504,47864990,8696.4,6049,31398460,5191,16466530
2020-12-01,20.85 ( 2.46 %),6906,66152790,9579.03,6912,31249100,4521,34903690
2020-11-30,20.35 ( 1.75 %),5050,37622650,7450.03,9043,34647940,3831,2974710
2020-11-27,20 ( 2.56 %),4066,41932910,10313.06,6996,23944960,3423,17987950
2020-11-26,19.5 ( 0.26 %),3579,31355830,8761.06,5185,20690490,3990,10665340
2020-11-25,19.45 ( 0.52 %),2622,18713990,7137.3,3203,15990720,4992,2723270
2020-11-23,19.2 ( -0.52 %),4479,19919420,4447.29,2688,15712700,5845,4206720
2020-11-20,0 ( 0 %),4154,13664680,3289.52,2638,13079410,4958,585270
2020-11-19,19.5 ( -0.76 %),4680,23640360,5051.36,3846,22544400,5862,1095960
2020-11-18,19.65 ( 0.51 %),3702,20179020,5450.84,5710,21187670,3711,-1008650
2020-11-17,19.55 ( 2.62 %),3298,22649500,6867.65,3741,16131610,4312,6517890
2020-11-16,19.05 ( -1.3 %),5121,33665410,6573.99,5959,32658930,5481,1006480
2020-11-13,19.3 ( 3.21 %),4819,37486030,7778.8,8069,25941470,3215,11544560
2020-11-12,18.7 ( 2.47 %),2632,16655770,6328.18,5471,17918940,3275,-1263170
2020-11-11,18.25 ( 0.83 %),2624,13403250,5107.95,3002,16401910,5464,-2998660
2020-11-10,18.1 ( -0.82 %),2273,10280540,4522.89,3291,15724080,4778,-5443540
2020-11-09,18.25 ( 1.39 %),1923,7842800,4078.42,2142,7793340,3638,49460
2020-11-06,18 ( -1.64 %),3008,8617890,2864.99,1766,9075990,5139,-458100
2020-11-05,18.3 ( -0.81 %),2510,9275120,3695.27,3403,15885310,4668,-6610190
2020-11-04,18.45 ( 1.1 %),1629,11999230,7366.01,3282,12018250,3662,-19020
2020-11-03,18.25 ( 1.39 %),1575,7252060,4604.48,2383,6930640,2908,321420
2020-11-02,18 ( 1.12 %),1576,6215920,3944.11,1790,8270180,4620,-2054260
2020-10-30,17.8 ( 0 %),2157,14304010,6631.44,1636,10854140,6635,3449870
2020-10-29,17.8 ( 1.42 %),3427,16462630,4803.8,2556,10236420,4005,6226210
2020-10-28,17.55 ( -1.96 %),0,0,0,0,0,0,0
2020-10-27,17.9 ( -2.72 %),0,0,0,0,0,0,0
2020-10-26,18.4 ( -2.39 %),3343,13044130,3901.92,3206,16941290,5284,-3897160
2020-10-23,18.85 ( 0.27 %),2777,10612200,3821.46,4403,16139300,3666,-5527100
2020-10-22,18.8 ( 1.35 %),2952,13010060,4407.2,3215,13661120,4249,-651060
2020-10-21,18.55 ( -0.8 %),3611,13983590,3872.5,4830,19239290,3983,-5255700
2020-10-20,18.7 ( 2.47 %),4111,17662800,4296.47,5105,16845160,3300,817640
2020-10-19,18.25 ( 2.24 %),4529,21061060,4650.27,4997,17978060,3598,3083000
2020-10-16,17.85 ( 1.42 %),3773,16732250,4434.73,4722,17667790,3742,-935540
2020-10-15,17.6 ( -0.28 %),2493,6843570,2745.11,2892,9835720,3401,-2992150
2020-10-14,17.65 ( 0.86 %),3025,9631950,3184.12,3309,12763400,3857,-3131450
2020-10-13,17.5 ( -0.28 %),2896,7823180,2701.37,2319,8966530,3867,-1143350
2020-10-12,17.55 ( 0 %),2767,7482190,2704.08,2894,13232440,4572,-5750250
2020-10-09,17.55 ( -0.57 %),3027,7480080,2471.12,2132,10165520,4768,-2685440
2020-10-08,17.65 ( 0.28 %),3231,11958480,3701.17,3485,15778180,4527,-3819700
2020-10-07,17.6 ( -1.4 %),4631,11586870,2502.02,2420,13716670,5668,-2129800
2020-10-06,17.85 ( 0.85 %),4610,18390190,3989.2,2132,13334490,6254,5055700
2020-10-05,17.7 ( -10.83 %),8390,23948310,2854.39,2157,17493580,8110,6454730
2020-10-02,19.85 ( 0 %),2973,19400060,6525.42,4130,21650070,5242,-2250010
2020-10-01,19.85 ( 0.51 %),2488,11960440,4807.25,3221,17118410,5315,-5157970
2020-09-30,19.75 ( 0.51 %),2163,9057230,4187.35,2864,9847510,3438,-790280
2020-09-29,19.65 ( -1.75 %),3114,14048380,4511.36,3566,17499900,4907,-3451520
2020-09-28,20 ( 2.04 %),2899,17931280,6185.33,3849,16090030,4180,1841250
2020-09-25,19.6 ( 0 %),2471,26335030,10657.64,3348,16727130,4996,9607900
2020-09-24,19.6 ( 2.08 %),4344,33951760,7815.78,4569,23445780,5131,10505980
2020-09-23,19.2 ( 0 %),3649,12835610,3517.57,3599,13840550,3846,-1004940
2020-09-22,19.2 ( 0.79 %),0,0,0,0,0,0,0
2020-09-21,19.05 ( 1.6 %),3901,20053490,5140.6,4431,19314690,4359,738800
2020-09-18,18.75 ( 3.59 %),3946,30206410,7654.94,5682,18361680,3232,11844730
2020-09-17,18.1 ( 0 %),2012,15263480,7586.22,4502,15152600,3366,110880
2020-09-16,18.1 ( 0 %),1517,5842100,3851.09,2265,7085100,3128,-1243000
2020-09-15,18.1 ( -0.28 %),1521,7586510,4987.84,3015,9734500,3229,-2147990
2020-09-14,18.15 ( 1.68 %),1430,8033530,5617.85,3633,11452740,3152,-3419210
2020-09-11,17.85 ( 0.28 %),1776,5907630,3326.37,1545,5871410,3800,36220
2020-09-10,17.8 ( 0.28 %),1311,5991820,4570.42,1986,7934850,3995,-1943030
2020-09-09,17.75 ( -0.28 %),2505,7538820,3009.51,1482,6468140,4364,1070680
2020-09-08,17.8 ( 0.56 %),2657,8839880,3327.02,1607,6604120,4110,2235760
2020-09-07,17.7 ( -1.94 %),2220,11291130,5086.09,2628,14049320,5346,-2758190
2020-09-04,18.05 ( -0.82 %),3013,12247110,4064.76,2309,10250650,4439,1996460
2020-09-03,18.2 ( 0.55 %),2042,9877380,4837.11,3685,13081120,3550,-3203740
2020-09-01,18.1 ( 0.84 %),1980,10325670,5214.98,2549,9659400,3789,666270
2020-08-31,17.95 ( 0.28 %),1771,7776190,4390.85,3388,11189770,3303,-3413580
2020-08-28,17.9 ( 0 %),1691,10932730,6465.25,3589,13823870,3852,-2891140
2020-08-27,17.9 ( 0 %),1940,6934430,3574.45,2190,9122130,4165,-2187700
2020-08-26,17.9 ( -0.83 %),2142,10673300,4982.87,3149,11519550,3658,-846250
2020-08-25,18.05 ( 1.4 %),2517,24807630,9856.03,6155,22799570,3704,2008060
2020-08-24,17.8 ( 2.89 %),2653,17774970,6699.95,4405,15345370,3484,2429600
2020-08-21,17.3 ( 1.47 %),1554,11920900,7671.11,2730,9442430,3459,2478470
2020-08-20,17.05 ( 0 %),1515,8015260,5290.6,2431,9543520,3926,-1528260
2020-08-19,17.05 ( 0.29 %),1848,10440700,5649.73,1584,8311160,5247,2129540
2020-08-18,17 ( -0.58 %),1260,6512350,5168.53,1689,6371350,3772,141000
2020-08-17,17.1 ( -0.29 %),1661,7569200,4557.01,2776,8574650,3089,-1005450
2020-08-14,17.15 ( 1.18 %),1892,11936200,6308.77,3576,10551610,2951,1384590
2020-08-13,16.95 ( 0.59 %),1584,7226670,4562.29,2290,6971300,3044,255370
2020-08-12,16.85 ( 2.12 %),2196,12457570,5672.85,2922,10262280,3512,2195290
2020-08-11,16.5 ( 0.3 %),1407,7158580,5087.83,2000,8364450,4182,-1205870
2020-08-10,16.45 ( 0.92 %),1790,9419950,5262.54,1689,7223000,4276,2196950
2020-08-07,16.3 ( -0.31 %),2211,6834460,3091.12,1358,7131560,5252,-297100
2020-08-06,16.35 ( -1.21 %),2263,7221060,3190.92,1773,7989180,4506,-768120
2020-08-05,16.55 ( 0.91 %),2108,9738780,4619.91,1872,6306260,3369,3432520
2020-08-04,16.4 ( 1.23 %),2001,5592090,2794.65,1795,7316780,4076,-1724690
2020-08-03,16.2 ( 2.86 %),2303,11072770,4807.98,1674,7485260,4471,3587510
2020-07-31,15.75 ( -0.63 %),2508,9672370,3856.61,1371,8259250,6024,1413120
2020-07-30,15.85 ( 1.28 %),2340,7061420,3017.7,1422,8388410,5899,-1326990
2020-07-29,15.65 ( -3.99 %),3722,10629950,2855.98,1679,10802980,6434,-173030
2020-07-28,16.3 ( 6.19 %),3963,20354980,5136.26,2228,11459140,5143,8895840
2020-07-27,15.35 ( -6.97 %),4279,12787110,2988.34,3253,17555380,5397,-4768270
2020-07-24,16.5 ( -3.23 %),4150,12416930,2992.03,2593,13898750,5360,-1481820
2020-07-23,17.05 ( -0.58 %),2311,6838640,2959.17,1412,7176990,5083,-338350
2020-07-22,17.15 ( -0.87 %),1603,5946380,3709.53,1636,6758650,4131,-812270
2020-07-21,17.3 ( 0.58 %),1888,9101350,4820.63,1351,6411050,4745,2690300
2020-07-20,17.2 ( -1.71 %),0,0,0,0,0,0,0
2020-07-17,17.5 ( 0 %),1889,10574330,5597.85,2691,11481650,4267,-907320
2020-07-16,17.5 ( 1.16 %),1378,11782710,8550.59,2918,9286320,3182,2496390
2020-07-15,17.3 ( 0.87 %),1339,6997640,5226.02,2342,7638330,3261,-640690
2020-07-14,17.15 ( -0.29 %),2434,9951550,4088.56,1408,7505150,5330,2446400
2020-07-13,17.2 ( -0.29 %),1699,4969140,2924.74,1607,6369280,3963,-1400140
2020-07-10,17.25 ( -1.15 %),2012,7634610,3794.54,1762,6814560,3868,820050
2020-07-09,17.45 ( 1.75 %),0,0,0,0,0,0,0
2020-07-08,17.15 ( 0.29 %),1545,5338040,3455.04,1749,4993030,2855,345010
2020-07-07,17.1 ( 0.59 %),2236,7723250,3454.05,2032,7269180,3577,454070
2020-07-06,17 ( 0.89 %),2038,6571080,3224.28,1694,6048770,3571,522310
2020-07-03,16.85 ( 0 %),1599,3582460,2240.44,1178,3554030,3017,28430
2020-07-02,16.85 ( -0.3 %),1910,4369280,2287.58,1256,4221030,3361,148250
2020-07-01,16.9 ( 1.81 %),2393,5716440,2388.82,1315,4074860,3099,1641580
2020-06-30,16.6 ( -1.48 %),2785,6466310,2321.83,1852,8050810,4347,-1584500
2020-06-29,16.85 ( -2.88 %),4160,13649970,3281.24,2248,12105980,5385,1543990
2020-06-26,17.35 ( 0 %),2190,6397360,2921.17,1700,5582520,3284,814840
2020-06-25,17.35 ( -1.14 %),2508,7446710,2969.18,1458,5732340,3932,1714370
2020-06-24,17.55 ( 0.29 %),2898,10744700,3707.63,3257,12917640,3966,-2172940
2020-06-23,17.5 ( 0 %),2281,8242920,3613.73,2070,8235880,3979,7040
2020-06-22,17.5 ( 0 %),2087,7017500,3362.48,2219,7589030,3420,-571530
2020-06-19,17.5 ( 1.16 %),2338,8135500,3479.68,1466,6305540,4301,1829960
2020-06-18,17.3 ( 0 %),2348,7341170,3126.56,1405,5550070,3950,1791100
2020-06-17,17.3 ( -0.57 %),2141,6229060,2909.42,1718,6008960,3498,220100
2020-06-16,17.4 ( 2.35 %),2523,10820970,4288.93,2423,9595180,3960,1225790
2020-06-15,17 ( -3.68 %),4337,13772420,3175.56,2751,16563110,6021,-2790690
2020-06-12,17.65 ( 0.86 %),6431,22411460,3484.91,3487,18319930,5254,4091530
2020-06-11,17.5 ( -5.91 %),3800,17317340,4557.19,4904,21723920,4430,-4406580
2020-06-10,18.6 ( 2.76 %),5232,19505170,3728.05,4967,18221170,3668,1284000
2020-06-09,18.1 ( 0 %),3503,12698900,3625.15,3689,13725840,3721,-1026940
2020-06-08,18.1 ( 1.12 %),0,0,0,0,0,0,0
2020-06-05,17.9 ( -0.56 %),7833,23627100,3016.35,5732,26264380,4582,-2637280
2020-06-04,18 ( -0.28 %),3749,18364690,4898.56,4004,18021100,4501,343590
2020-06-03,18.05 ( 0.84 %),2592,12710350,4903.68,3657,12699540,3473,10810
2020-06-02,17.9 ( 0.28 %),5193,31106500,5990.08,6340,28716350,4529,2390150
2020-06-01,17.85 ( 3.78 %),4436,35649080,8036.31,5576,29693010,5325,5956070
2020-05-29,17.2 ( -0.58 %),3422,12461190,3641.49,2009,14313280,7125,-1852090
2020-05-28,17.3 ( 0 %),2771,8284230,2989.62,2536,14949770,5895,-6665540
2020-05-27,17.3 ( -1.7 %),5336,21052500,3945.37,3952,25405720,6429,-4353220
2020-05-26,17.6 ( 1.73 %),3411,16630000,4875.4,3870,21991080,5682,-5361080
2020-05-25,17.3 ( 0.29 %),2638,9321880,3533.69,2719,15035470,5530,-5713590
2020-05-22,17.25 ( -1.99 %),4171,14316810,3432.46,3409,24742650,7258,-10425840
2020-05-21,17.6 ( 1.73 %),3457,14427180,4173.32,4540,22324950,4917,-7897770
2020-05-20,17.3 ( -0.57 %),3020,8991280,2977.25,2618,9911340,3786,-920060
2020-05-19,17.4 ( 2.05 %),3611,17480290,4840.84,4527,17945010,3964,-464720
2020-05-18,17.05 ( 0.59 %),3883,12966270,3339.24,2668,9791790,3670,3174480
2020-05-15,16.95 ( -2.02 %),4547,13420350,2951.47,3544,16313040,4603,-2892690
2020-05-14,17.3 ( -1.14 %),4971,14885910,2994.55,3783,18396930,4863,-3511020
2020-05-13,17.5 ( 1.74 %),5682,20856360,3670.6,4635,18965110,4092,1891250
2020-05-12,17.2 ( 2.38 %),5777,23681640,4099.3,4897,20411790,4168,3269850
2020-05-11,16.8 ( 1.2 %),0,0,0,0,0,0,0
2020-05-08,16.6 ( 1.84 %),4704,18930220,4024.28,6122,22626670,3696,-3696450
2020-05-07,16.3 ( 2.19 %),3369,11623120,3450.02,3248,11728250,3611,-105130
2020-05-06,15.95 ( 0.95 %),2832,9669470,3414.36,2323,7715110,3321,1954360
2020-05-05,15.8 ( -0.32 %),2411,6337070,2628.4,1694,5271360,3112,1065710
2020-05-04,15.85 ( -0.63 %),2058,5358150,2603.57,1689,4961630,2938,396520
2020-04-29,15.95 ( 0.95 %),2257,7746380,3432.16,1936,6090560,3146,1655820
2020-04-28,15.8 ( 0.64 %),3015,9255690,3069.88,1449,5501000,3796,3754690
2020-04-27,15.7 ( -2.18 %),4194,9005540,2147.24,2094,9140530,4365,-134990
2020-04-24,16.05 ( -0.62 %),3056,7950980,2601.76,1471,5965520,4055,1985460
2020-04-23,16.15 ( 0.31 %),2765,12676180,4584.51,1912,8140660,4258,4535520
2020-04-22,16.1 ( 2.88 %),4479,16149220,3605.54,1841,8386670,4555,7762550
2020-04-21,15.65 ( -6.01 %),6238,15358460,2462.08,3206,18479670,5764,-3121210
2020-04-20,16.65 ( -2.06 %),6281,22620960,3601.49,3132,18920770,6041,3700190
2020-04-17,17 ( 3.03 %),4009,21307180,5314.84,4151,18072430,4354,3234750
2020-04-16,16.5 ( 0.92 %),4024,17503460,4349.77,2342,11986270,5118,5517190
2020-04-15,16.35 ( 2.83 %),4544,25886200,5696.79,4164,17514780,4206,8371420
2020-04-14,15.9 ( 0.95 %),3894,17930340,4604.61,2626,14227570,5418,3702770
2020-04-13,15.75 ( 1.29 %),3093,15685650,5071.34,2525,12653810,5011,3031840
2020-04-10,15.55 ( -1.58 %),3776,15524200,4111.28,2045,15514690,7587,9510
2020-04-09,15.8 ( 0.64 %),3288,13405760,4077.18,2550,14617740,5732,-1211980
2020-04-08,15.7 ( -1.57 %),3299,11704300,3547.83,1871,9277490,4959,2426810
2020-04-07,15.95 ( 1.27 %),3954,28701340,7258.81,3690,19774750,5359,8926590
2020-04-06,15.75 ( 6.78 %),3480,19306390,5547.81,2437,11261550,4621,8044840
2020-04-03,14.75 ( 3.51 %),3046,11996110,3938.32,2217,8658770,3906,3337340
2020-04-01,14.25 ( 5.17 %),2629,16751320,6371.75,2161,10099360,4673,6651960
2020-03-31,13.55 ( -0.37 %),2970,12486200,4204.11,2527,12313240,4873,172960
2020-03-30,13.6 ( -6.85 %),3724,11155350,2995.53,1826,12657640,6932,-1502290
2020-03-27,14.6 ( -2.99 %),3244,9955420,3068.87,1719,10870180,6324,-914760
2020-03-26,15.05 ( -3.83 %),2754,8093160,2938.69,1853,9422870,5085,-1329710
2020-03-25,15.65 ( 5.74 %),3119,13427680,4305.12,2569,12834760,4996,592920
2020-03-24,14.8 ( -0.67 %),3110,13277830,4269.4,2264,12473640,5510,804190
2020-03-23,14.9 ( -6.87 %),3595,11410570,3174.01,2171,20409680,9401,-8999110
2020-03-20,16 ( -0.62 %),2764,9162740,3315.03,1544,8513610,5514,649130
2020-03-19,16.1 ( -2.42 %),3199,11229570,3510.34,1410,6986100,4955,4243470
2020-03-18,16.5 ( -1.2 %),3465,12408740,3581.17,1944,10773370,5542,1635370
2020-03-17,16.7 ( 1.52 %),4311,22666030,5257.72,1904,12574760,6604,10091270
2020-03-16,16.45 ( -3.8 %),3082,8585280,2785.62,1847,8673300,4696,-88020
2020-03-13,17.1 ( 0.88 %),4723,25696730,5440.76,3556,19381050,5450,6315680
2020-03-12,16.95 ( -6.87 %),4231,20327030,4804.31,3415,23461920,6870,-3134890
2020-03-11,18.2 ( -4.96 %),4954,17934730,3620.25,2253,14125730,6270,3809000
2020-03-10,19.15 ( -0.52 %),4726,18572090,3929.77,2301,11494570,4995,7077520
2020-03-09,19.25 ( -6.78 %),5243,17108390,3263.09,3275,23094430,7052,-5986040
2020-03-06,20.65 ( 0 %),2763,9214100,3334.82,1444,7679710,5318,1534390
2020-03-05,20.65 ( -0.48 %),2153,9484640,4405.31,2368,11253050,4752,-1768410
2020-03-04,20.75 ( -0.72 %),2356,8347740,3543.18,1729,7697700,4452,650040
2020-03-03,20.9 ( 0.97 %),2332,10155640,4354.91,2859,12330380,4313,-2174740
2020-03-02,20.7 ( 1.47 %),0,0,0,0,0,0,0
2020-02-28,20.4 ( -2.39 %),4392,13455230,3063.58,2304,12667480,5498,787750
2020-02-27,20.9 ( 1.95 %),2289,8180200,3573.7,2214,8831260,3989,-651060
2020-02-26,20.5 ( -1.44 %),2968,10810350,3642.3,1868,9680900,5182,1129450
2020-02-25,20.8 ( 3.48 %),6373,22324380,3502.96,2373,15287300,6442,7037080
2020-02-24,20.1 ( -5.19 %),0,0,0,0,0,0,0
2020-02-21,21.2 ( -2.08 %),0,0,0,0,0,0,0
2020-02-20,21.65 ( 0.23 %),2089,13757230,6585.56,2180,12486870,5728,1270360
2020-02-19,21.6 ( -0.69 %),2803,12866560,4590.28,1749,9795070,5600,3071490
2020-02-18,21.75 ( -0.91 %),2505,10489930,4187.6,2461,12580520,5112,-2090590
2020-02-17,21.95 ( 0.92 %),3750,26648950,7106.39,3508,19409330,5533,7239620
2020-02-14,21.75 ( 1.64 %),3290,20898020,6351.98,3595,18694720,5200,2203300
2020-02-13,21.4 ( -1.15 %),2754,15734890,5713.47,2269,14145930,6234,1588960
2020-02-12,21.65 ( 2.12 %),3287,35402180,10770.36,4241,19819270,4673,15582910
2020-02-11,21.2 ( 0.95 %),2340,12455640,5322.92,2158,9061110,4199,3394530
2020-02-10,21 ( -1.87 %),3219,12183910,3785,1382,9864850,7138,2319060
2020-02-07,21.4 ( -1.83 %),3862,19653930,5089.05,2461,14288010,5806,5365920
2020-02-06,21.8 ( 3.07 %),4040,28198430,6979.81,3356,20904280,6229,7294150
2020-02-05,21.15 ( 0 %),3260,16703100,5123.65,2484,13299720,5354,3403380
2020-02-04,21.15 ( 3.93 %),4724,27160290,5749.43,2286,14774240,6463,12386050
2020-02-03,20.35 ( -2.16 %),4948,26382940,5332.04,2673,21417830,8013,4965110
2020-01-31,20.8 ( -2.12 %),3366,17372990,5161.32,1897,12855000,6776,4517990
2020-01-30,21.25 ( -5.13 %),3436,15820940,4604.46,2066,16054980,7771,-234040
2020-01-22,22.4 ( -0.67 %),1947,13688000,7030.3,1722,9543180,5542,4144820
2020-01-21,22.55 ( 2.5 %),1905,14991360,7869.48,2414,8845610,3664,6145750
2020-01-20,22 ( 0 %),1565,11571000,7393.61,1599,8155110,5100,3415890
2020-01-17,22 ( 0 %),2107,13789220,6544.48,2173,9783020,4502,4006200
2020-01-16,22 ( 2.56 %),2911,20852210,7163.25,3186,13778580,4325,7073630
2020-01-15,21.45 ( -0.23 %),1372,6410430,4672.33,1555,7407410,4764,-996980
2020-01-14,21.5 ( 0.94 %),1582,8517580,5384.06,1764,7996580,4533,521000
2020-01-13,21.3 ( -0.47 %),1436,4711590,3281.05,1445,6125670,4239,-1414080
2020-01-10,21.4 ( 1.66 %),2674,16574060,6198.23,2800,14106480,5038,2467580
2020-01-09,21.05 ( 1.69 %),1627,8809930,5414.83,1626,6125570,3767,2684360
2020-01-08,20.7 ( -1.43 %),2105,7143750,3393.71,1364,7027660,5152,116090
2020-01-07,21 ( 0.24 %),1354,5573110,4116.03,1129,4700840,4164,872270
2020-01-06,20.95 ( -1.41 %),1300,4479590,3445.84,1238,4690790,3789,-211200
2020-01-03,21.25 ( 0.24 %),1638,9521030,5812.59,1973,7736280,3921,1784750
2020-01-02,21.2 ( 1.92 %),1668,6340250,3801.11,1646,4679250,2843,1661000
2019-12-31,20.8 ( -0.72 %),1548,4221350,2726.97,1008,5384330,5342,-1162980
2019-12-30,20.95 ( 0.24 %),1540,6877420,4465.86,1579,7167390,4539,-289970
2019-12-27,20.9 ( 0.24 %),1449,4975800,3433.95,954,4780880,5011,194920
2019-12-26,20.85 ( -0.71 %),1382,3079920,2228.6,952,4297500,4514,-1217580
2019-12-25,21 ( 1.2 %),1398,6035860,4317.5,1231,5429380,4411,606480
2019-12-24,20.75 ( -1.43 %),1641,4032340,2457.25,992,5030860,5071,-998520
2019-12-23,21.05 ( 0.24 %),0,0,0,0,0,0,0
2019-12-20,21 ( 1.45 %),1582,6043890,3820.41,1002,4478350,4469,1565540
2019-12-19,20.7 ( -1.43 %),2632,8735680,3319.03,1246,6852450,5500,1883230
2019-12-18,21 ( -0.24 %),1716,6533940,3807.66,1094,5518410,5044,1015530
2019-12-17,21.05 ( -1.64 %),3249,11500140,3539.59,1123,8850940,7882,2649200
2019-12-16,21.4 ( -1.83 %),3064,9757100,3184.43,1094,9462170,8649,294930
2019-12-13,21.8 ( 0 %),1436,6280140,4373.36,1274,6421120,5040,-140980
2019-12-12,21.8 ( 0 %),1560,8966070,5747.48,1478,6666710,4511,2299360
2019-12-11,21.8 ( 3.32 %),2199,12469100,5670.35,1153,4934650,4280,7534450
2019-12-10,21.1 ( -1.63 %),2526,7242030,2867,1100,6685690,6078,556340
2019-12-09,21.45 ( -1.83 %),2545,7757410,3048.1,1311,7759890,5919,-2480
2019-12-06,21.85 ( 0 %),1040,5354550,5148.61,788,3607040,4577,1747510
2019-12-05,21.85 ( -1.58 %),1352,3923850,2902.26,918,4267110,4648,-343260
2019-12-04,22.2 ( 3.02 %),0,0,0,0,0,0,0
2019-12-03,21.55 ( 0.7 %),2063,7981080,3868.68,1515,6197020,4090,1784060
2019-12-02,21.4 ( -3.39 %),1800,5473190,3040.66,1330,7711400,5798,-2238210
2019-11-29,22.15 ( 0.23 %),1688,7361910,4361.32,1054,3946390,3744,3415520
2019-11-28,22.1 ( -2.21 %),1866,5032520,2696.96,1258,6080610,4834,-1048090
2019-11-27,22.6 ( -0.22 %),1188,4630280,3897.54,1162,5296260,4558,-665980
2019-11-26,22.65 ( 1.12 %),1098,9498710,8650.92,1348,6192350,4594,3306360
2019-11-25,22.4 ( 0.22 %),1359,9562700,7036.57,1300,6373710,4903,3188990
2019-11-22,22.35 ( -0.22 %),1566,8506930,5432.27,1728,9298540,5381,-791610
2019-11-21,22.4 ( -0.88 %),3060,11905020,3890.53,1526,9010810,5905,2894210
2019-11-20,22.6 ( -0.66 %),1653,3802560,2300.4,944,4333420,4590,-530860
2019-11-19,22.75 ( 0.66 %),2179,5074700,2328.91,1388,5369130,3868,-294430
2019-11-18,22.6 ( -0.66 %),1841,5445710,2958.02,1212,6757220,5575,-1311510
2019-11-15,22.75 ( -0.87 %),2906,10376870,3570.84,1522,10477700,6884,-100830
2019-11-14,22.95 ( -1.29 %),3487,13325730,3821.55,2498,12343390,4941,982340
2019-11-13,23.25 ( -0.21 %),2460,11006600,4474.23,1843,8161690,4428,2844910
2019-11-12,23.3 ( -0.64 %),1941,7732970,3984.01,1705,9520960,5584,-1787990
2019-11-11,23.45 ( 0.21 %),4219,21479630,5091.17,2850,22157570,7775,-677940
2019-11-08,23.4 ( -0.43 %),2459,13127460,5338.54,1779,11433860,6427,1693600
2019-11-07,23.5 ( -0.21 %),2580,11033270,4276.46,1884,11461150,6083,-427880
2019-11-06,23.55 ( 1.29 %),3770,19864190,5269.02,3987,18137390,4549,1726800
2019-11-05,23.25 ( -0.21 %),1885,6583780,3492.72,2187,7672900,3508,-1089120
2019-11-04,23.3 ( 1.53 %),2793,13240350,4740.55,3590,13462970,3750,-222620
2019-11-01,22.95 ( -0.22 %),1579,7076470,4481.61,1459,7987020,5474,-910550
2019-10-31,23 ( -0.22 %),1137,3671670,3229.26,1275,5402690,4237,-1731020
2019-10-30,23.05 ( 0.88 %),1438,6759200,4700.42,1249,7160160,5733,-400960
2019-10-29,22.85 ( -0.65 %),1464,5058790,3455.46,1140,7169060,6289,-2110270
2019-10-28,23 ( -0.86 %),1205,3559570,2954,1534,6435590,4195,-2876020
2019-10-25,23.2 ( 1.09 %),1651,7361420,4458.76,1686,7016450,4162,344970
2019-10-24,22.95 ( 0.22 %),1169,6568510,5618.91,1423,10431700,7331,-3863190
2019-10-23,22.9 ( 0.22 %),881,2851950,3237.17,822,3753830,4567,-901880
2019-10-22,22.85 ( 0.88 %),1604,6691990,4172.06,1093,4148980,3796,2543010
2019-10-21,22.65 ( -1.52 %),2157,8358920,3875.25,1241,9344220,7530,-985300
2019-10-18,23 ( -0.86 %),1644,6135770,3732.22,1138,8144020,7156,-2008250
2019-10-17,23.2 ( -0.43 %),2065,11244720,5445.38,981,8764910,8935,2479810
2019-10-16,23.3 ( -0.21 %),1300,5024780,3865.22,1445,8253070,5711,-3228290
2019-10-15,23.35 ( -0.43 %),1837,9195490,5005.71,1609,11408850,7091,-2213360
2019-10-14,23.45 ( 3.08 %),4325,21156500,4891.68,3769,18627700,4942,2528800
2019-10-11,22.75 ( 0 %),879,7011160,7976.29,1242,6728740,5418,282420
2019-10-10,22.75 ( -0.66 %),789,4148350,5257.73,1170,7798770,6666,-3650420
2019-10-09,22.9 ( 0.88 %),1244,8005210,6435.06,1284,7397090,5761,608120
2019-10-08,22.7 ( 1.34 %),1510,9336400,6183.05,1052,7581730,7207,1754670
2019-10-07,22.4 ( -1.1 %),1513,8676210,5734.44,1325,11054460,8343,-2378250
2019-10-04,22.65 ( -1.31 %),1726,7435390,4307.87,1384,10078880,7282,-2643490
2019-10-03,22.95 ( -0.22 %),2053,12145570,5916.01,1375,12963270,9428,-817700
2019-10-02,23 ( -0.22 %),1671,9102130,5447.12,1758,9800550,5575,-698420
2019-10-01,23.05 ( 1.1 %),1160,7843280,6761.45,1695,7433760,4386,409520
2019-09-30,22.8 ( 0.44 %),1633,9809420,6006.99,2550,11591850,4546,-1782430
2019-09-27,22.7 ( 0.44 %),1499,10314370,6880.83,1968,9083720,4616,1230650
2019-09-26,22.6 ( 2.03 %),1535,11502470,7493.47,1728,7181860,4156,4320610
2019-09-25,22.15 ( 0 %),1185,7861680,6634.33,1251,7209850,5763,651830
2019-09-24,22.15 ( 0.45 %),1310,10260560,7832.49,1585,7600410,4795,2660150
2019-09-23,22.05 ( 0 %),1397,6115370,4377.5,1775,7317780,4123,-1202410
2019-09-20,22.05 ( 0.23 %),1856,9789550,5274.54,1638,7915470,4832,1874080
2019-09-19,22 ( 0.69 %),1741,6095330,3501.05,947,5892220,6222,203110
2019-09-18,21.85 ( -6.22 %),3960,12718520,3211.75,1696,12451130,7341,267390
2019-09-17,23.3 ( -0.43 %),2080,8586800,4128.27,1837,9154400,4983,-567600
2019-09-16,23.4 ( 0.43 %),1913,9499360,4965.69,2081,9174370,4409,324990
2019-09-13,23.3 ( 0.87 %),2384,14673080,6154.82,2169,14018640,6463,654440
2019-09-12,23.1 ( 1.99 %),1828,15085290,8252.35,1521,8069930,5306,7015360
2019-09-11,22.65 ( 0.44 %),1033,4932310,4774.74,723,5027210,6953,-94900
2019-09-10,22.55 ( -0.22 %),1796,12608320,7020.22,1149,8718850,7588,3889470
2019-09-09,22.6 ( 0 %),1021,5022040,4918.75,668,4772230,7144,249810
2019-09-06,22.6 ( 0 %),1388,7066060,5090.82,925,6813950,7366,252110
2019-09-05,22.6 ( -1.74 %),1445,6332150,4382.11,1208,8282010,6856,-1949860
2019-09-04,23 ( 0.88 %),1604,8254370,5146.12,1191,5981220,5022,2273150
2019-09-03,22.8 ( -1.3 %),2132,12168300,5707.46,1356,13384620,9871,-1216320
2019-08-30,23.1 ( -1.07 %),1426,9176520,6435.15,1533,9468390,6176,-291870
2019-08-29,23.35 ( 0 %),1590,12197130,7671.15,1481,11327730,7649,869400
2019-08-28,23.35 ( 0.21 %),1735,12503190,7206.45,1696,13009520,7671,-506330
2019-08-27,23.3 ( 0 %),2969,18760840,6318.91,3378,27073460,8015,-8312620
2019-08-26,23.3 ( 2.87 %),2898,25298610,8729.68,3455,21487130,6219,3811480
2019-08-23,22.65 ( 0.44 %),1048,5963260,5690.13,1885,8017180,4253,-2053920
2019-08-22,22.55 ( 0.22 %),1761,11119140,6314.11,2337,14110460,6038,-2991320
2019-08-21,22.5 ( 1.58 %),1885,11262500,5974.8,2446,13504340,5521,-2241840
2019-08-20,22.15 ( 0.45 %),1111,6162600,5546.89,1089,8673640,7965,-2511040
2019-08-19,22.05 ( -1.56 %),1336,3800870,2844.96,1254,7320300,5838,-3519430
2019-08-16,22.4 ( 0.45 %),1630,7675060,4708.63,1933,9561050,4946,-1885990
2019-08-15,22.3 ( 0 %),1521,7749600,5095.07,1177,5962860,5066,1786740
2019-08-14,22.3 ( 0.45 %),1255,7386440,5885.61,1983,7608330,3837,-221890
2019-08-13,22.2 ( 1.37 %),1764,9590420,5436.75,1566,7147730,4564,2442690
2019-08-12,21.9 ( 2.1 %),1359,10581760,7786.43,1172,6774180,5780,3807580
2019-08-09,21.45 ( -0.69 %),985,2605100,2644.77,840,3913600,4659,-1308500
2019-08-08,21.6 ( 1.41 %),1151,5699780,4952.02,1137,5667470,4985,32310
2019-08-07,21.3 ( -0.23 %),1140,5229320,4587.12,770,3972000,5158,1257320
2019-08-06,21.35 ( -2.06 %),1789,6943380,3881.15,1103,6318590,5729,624790
2019-08-05,21.8 ( -0.68 %),1297,5523260,4258.49,961,5276290,5490,246970
2019-08-02,21.95 ( -0.23 %),1609,8442820,5247.25,1117,5856710,5243,2586110
2019-08-01,22 ( -0.9 %),1095,3282020,2997.28,812,4150580,5112,-868560
2019-07-31,22.2 ( 1.6 %),1348,7414870,5500.65,1178,6222770,5282,1192100
2019-07-30,21.85 ( -2.67 %),1515,5937120,3918.89,1374,8730400,6354,-2793280
2019-07-29,22.45 ( 0.45 %),1198,7257660,6058.15,1289,7886240,6118,-628580
2019-07-26,22.35 ( -0.22 %),1690,8550340,5059.37,1290,8576300,6648,-25960
2019-07-25,22.4 ( -0.88 %),1519,8081540,5320.3,1830,11373170,6215,-3291630
2019-07-24,22.6 ( -0.44 %),1691,7542790,4460.55,2660,11848630,4454,-4305840
2019-07-23,22.7 ( 2.25 %),1453,12405840,8538.09,2705,10709890,3959,1695950
2019-07-22,22.2 ( 0 %),1611,8526480,5292.66,2417,11494590,4756,-2968110
2019-07-19,22.2 ( 0 %),1340,8036310,5997.25,2399,9248690,3855,-1212380
2019-07-18,22.2 ( 0.45 %),1642,11868310,7227.96,2051,10354880,5049,1513430
2019-07-17,22.1 ( 1.61 %),1764,11831390,6707.14,2960,12483570,4217,-652180
2019-07-16,21.75 ( 1.4 %),1898,8902140,4690.27,2303,9884240,4292,-982100
2019-07-15,21.45 ( 0.47 %),1300,7425940,5712.26,1148,6398680,5574,1027260
2019-07-12,21.35 ( -0.23 %),1761,9860140,5599.17,2319,9845270,4245,14870
2019-07-11,21.4 ( 1.42 %),1073,7960520,7418.94,1277,5955010,4663,2005510
2019-07-10,21.1 ( -0.47 %),1136,4227210,3721.14,1296,7215530,5568,-2988320
2019-07-09,21.2 ( 0.47 %),1039,6155600,5924.54,825,5452700,6609,702900
2019-07-08,21.1 ( -0.94 %),1244,3941960,3168.78,1126,5021960,4460,-1080000
2019-07-05,21.3 ( 0.71 %),1045,7225280,6914.14,1356,6249180,4609,976100
2019-07-04,21.15 ( 0.71 %),0,0,0,0,0,0,0
2019-07-03,21 ( -0.71 %),1033,7173140,6943.99,1307,5187050,3969,1986090
2019-07-02,21.15 ( 0 %),1033,7173140,6943.99,1307,5187050,3969,1986090
2019-07-01,21.15 ( 1.2 %),991,3914990,3950.54,948,5182630,5467,-1267640
2019-06-28,20.9 ( 1.46 %),0,0,0,0,0,0,0
2019-06-27,20.6 ( -1.2 %),1046,4035910,3858.42,637,4043550,6348,-7640
2019-06-26,20.85 ( -1.18 %),1011,5022290,4967.65,639,4559690,7136,462600
2019-06-25,21.1 ( -0.94 %),663,3000320,4525.37,653,2790320,4273,210000
2019-06-24,21.3 ( 0 %),635,3233860,5092.69,902,3217320,3567,16540
2019-06-21,21.3 ( 0 %),741,4329310,5842.52,1288,4787310,3717,-458000
2019-06-20,21.3 ( 3.15 %),1033,7173140,6943.99,1307,5187050,3969,1986090
2019-06-19,20.65 ( 0.24 %),554,2685270,4847.06,587,2678110,4562,7160
2019-06-18,20.6 ( -0.48 %),482,1853970,3846.41,536,1535530,2865,318440
2019-06-17,20.7 ( 0 %),613,3111910,5076.53,809,4098670,5066,-986760
2019-06-14,20.7 ( 0.49 %),675,4224760,6258.9,774,3161370,4084,1063390
2019-06-13,20.6 ( 0 %),574,1675930,2919.74,491,2100640,4278,-424710
2019-06-12,20.6 ( -0.48 %),521,2022120,3881.23,505,1901650,3766,120470
2019-06-11,20.7 ( 0.49 %),505,2694000,5334.65,622,2315890,3723,378110
2019-06-10,20.6 ( 0.24 %),891,3805800,4271.38,753,3571260,4743,234540
2019-06-07,20.55 ( 1.73 %),791,2464620,3115.83,567,2184720,3853,279900
2019-06-06,20.2 ( -0.25 %),998,4527060,4536.13,609,3552200,5833,974860
2019-06-05,20.25 ( -0.49 %),872,5170280,5929.22,627,4115670,6564,1054610
2019-06-04,20.35 ( 0 %),915,4359240,4764.2,570,3303310,5795,1055930
2019-06-03,20.35 ( -2.4 %),0,0,0,0,0,0,0
2019-05-31,20.85 ( -1.42 %),1085,3619950,3336.36,758,5041260,6651,-1421310
2019-05-30,21.15 ( -0.24 %),698,4033930,5779.27,604,3015840,4993,1018090
2019-05-29,21.2 ( -0.7 %),842,3667010,4355.12,624,3444690,5520,222320
2019-05-28,21.35 ( 0.23 %),721,4144840,5748.74,775,3827070,4938,317770
2019-05-27,21.3 ( -0.23 %),772,3028010,3922.29,693,3547150,5119,-519140
2019-05-24,21.35 ( -1.39 %),750,3954980,5273.31,967,6839670,7073,-2884690
2019-05-23,21.65 ( 0.46 %),884,5670060,6414.1,1088,5746940,5282,-76880
2019-05-22,21.55 ( 1.17 %),1497,13903440,9287.54,1945,10135710,5211,3767730
2019-05-21,21.3 ( 0.71 %),904,5123310,5667.38,992,5755240,5802,-631930
2019-05-20,21.15 ( -0.24 %),1073,4328310,4033.84,834,5962010,7149,-1633700
2019-05-17,21.2 ( -0.47 %),846,3830150,4527.36,637,3370670,5291,459480
2019-05-16,21.3 ( -0.7 %),933,5771570,6186.03,815,3874640,4754,1896930
2019-05-15,21.45 ( 0.7 %),885,5945780,6718.4,981,4798260,4891,1147520
2019-05-14,21.3 ( 0.24 %),869,4938620,5683.11,578,3116820,5392,1821800
2019-05-13,21.25 ( 1.67 %),951,8662080,9108.39,889,6160800,6930,2501280
2019-05-10,20.9 ( -0.48 %),1338,6033890,4509.63,753,6867500,9120,-833610
2019-05-09,21 ( -1.41 %),1572,7934150,5047.17,762,9484040,12446,-1549890
2019-05-08,21.3 ( -0.7 %),1177,5200240,4418.22,743,4636020,6240,564220
2019-05-07,21.45 ( -0.23 %),853,4214920,4941.29,729,4063370,5574,151550
2019-05-06,21.5 ( -2.71 %),1659,7353880,4432.72,884,6766710,7655,587170
2019-05-03,22.1 ( 0.91 %),1012,7572720,7482.92,1360,7885090,5798,-312370
2019-05-02,21.9 ( 0.46 %),1106,4632650,4188.65,1291,7741460,5996,-3108810
2019-04-26,21.8 ( 1.4 %),965,7991910,8281.77,836,4620200,5527,3371710
2019-04-25,21.5 ( 0 %),563,2852010,5065.74,611,3709020,6070,-857010
2019-04-24,21.5 ( 0.94 %),740,3455110,4669.07,647,3076550,4755,378560
2019-04-23,21.3 ( -0.47 %),819,3567650,4356.11,680,4136530,6083,-568880
2019-04-22,21.4 ( -0.93 %),960,4862460,5065.06,842,6410280,7613,-1547820
2019-04-19,21.6 ( 0.23 %),698,3228730,4625.69,747,4347450,5820,-1118720
2019-04-18,21.55 ( 0.23 %),969,7462170,7700.9,1116,7087290,6351,374880
2019-04-17,21.5 ( 0 %),911,5104990,5603.72,832,5435100,6533,-330110
2019-04-16,21.5 ( -1.83 %),0,0,0,0,0,0,0
2019-04-12,21.9 ( -0.45 %),738,2838310,3845.95,736,4213360,5725,-1375050
2019-04-11,22 ( 0.23 %),651,4208100,6464.06,813,4220290,5191,-12190
2019-04-10,21.95 ( -1.35 %),1146,4572540,3990,919,5806680,6318,-1234140
2019-04-09,22.25 ( -0.45 %),983,4800350,4883.37,1170,7209290,6162,-2408940
2019-04-08,22.35 ( 0.9 %),1208,6419610,5314.25,890,6371950,7159,47660
2019-04-05,22.15 ( -2.21 %),1286,5350550,4160.61,910,7197600,7909,-1847050
2019-04-04,22.65 ( 0.67 %),949,7925570,8351.5,1430,6192910,4331,1732660
2019-04-03,22.5 ( 0.22 %),859,7140020,8312.01,1123,7703160,6859,-563140
2019-04-02,22.45 ( 0.22 %),843,4952400,5874.73,1127,7072640,6276,-2120240
2019-04-01,22.4 ( 0 %),871,3807520,4371.44,902,5307430,5884,-1499910
2019-03-29,22.4 ( 0 %),797,5777130,7248.59,1015,6266240,6174,-489110
2019-03-28,22.4 ( 0 %),1003,5416360,5400.16,842,4314550,5124,1101810
2019-03-27,22.4 ( 1.13 %),1039,6822870,6566.77,944,5099740,5402,1723130
2019-03-26,22.15 ( 0 %),1301,7955860,6115.19,1195,8503310,7116,-547450
2019-03-25,22.15 ( -3.28 %),1853,10072910,5436,1708,12340450,7225,-2267540
2019-03-22,22.9 ( 0.44 %),1060,10621500,10020.28,2000,9286790,4643,1334710
2019-03-21,22.8 ( -0.65 %),1959,11109320,5670.91,3096,14161280,4574,-3051960
2019-03-20,22.95 ( 1.32 %),1707,15193820,8900.89,2543,12376700,4867,2817120
2019-03-19,22.65 ( -0.44 %),1777,13878710,7810.19,2880,12520210,4347,1358500
2019-03-18,22.75 ( 1.11 %),1322,9742690,7369.66,2151,9483780,4409,258910
2019-03-15,22.5 ( 0 %),1089,7080970,6502.27,1913,8334480,4357,-1253510
2019-03-14,22.5 ( -0.44 %),1066,8030220,7533.04,2011,8026090,3991,4130
2019-03-13,22.6 ( 0.22 %),1813,13049260,7197.61,3345,13183080,3941,-133820
2019-03-12,22.55 ( 3.44 %),1527,15590730,10210.04,1870,11396440,6094,4194290
2019-03-11,21.8 ( -0.23 %),798,3661070,4587.81,831,4730290,5692,-1069220
2019-03-08,21.85 ( -1.58 %),1317,6413320,4869.64,1164,7998020,6871,-1584700
2019-03-07,22.2 ( 0.23 %),940,5934460,6313.26,1736,7838150,4515,-1903690
2019-03-06,22.15 ( 0 %),854,4992870,5846.45,1245,5799710,4658,-806840
2019-03-05,22.15 ( 0 %),1178,9532410,8092.03,2100,10503320,5002,-970910
2019-03-04,22.15 ( 1.61 %),1263,10194770,8071.87,1439,6240050,4336,3954720
2019-03-01,21.8 ( 1.4 %),1152,7616630,6611.66,970,5375160,5541,2241470
2019-02-28,21.5 ( -2.49 %),1839,9094260,4945.22,1541,11432480,7419,-2338220
2019-02-27,22.05 ( 0 %),1509,18866950,12502.95,1357,20972570,15455,-2105620
2019-02-26,22.05 ( -1.78 %),1724,12170640,7059.54,1680,15372470,9150,-3201830
2019-02-25,22.45 ( -0.22 %),1288,11338700,8803.34,2022,11672080,5773,-333380
2019-02-22,22.5 ( 1.81 %),2015,18194200,9029.38,2844,15225890,5354,2968310
2019-02-21,22.1 ( 0.23 %),814,13016920,15991.3,1353,13060030,9653,-43110
2019-02-20,22.05 ( 0.46 %),795,14796640,18612.13,1648,13714960,8322,1081680
2019-02-19,21.95 ( -0.68 %),1070,18868010,17633.65,1995,22823670,11440,-3955660
2019-02-18,22.1 ( 0.23 %),1129,16513490,14626.65,1668,12494160,7491,4019330
2019-02-15,22.05 ( -0.23 %),956,11477430,12005.68,1523,10158710,6670,1318720
2019-02-14,22.1 ( 0.45 %),882,14656400,16617.23,1853,9373350,5058,5283050
2019-02-13,22 ( 0 %),1271,13501390,10622.65,1824,13470710,7385,30680
2019-02-12,22 ( -0.23 %),1569,16047030,10227.55,2150,15116450,7031,930580
2019-02-11,22.05 ( 0.92 %),1147,12977060,11313.91,1570,7007150,4463,5969910
2019-02-01,21.85 ( -0.23 %),1008,12246920,12149.72,1251,9967820,7968,2279100
2019-01-31,21.9 ( 0.46 %),1299,15181000,11686.68,2613,14451850,5531,729150
2019-01-30,21.8 ( 2.35 %),1451,18436660,12706.18,2822,11782560,4175,6654100
2019-01-29,21.3 ( 1.19 %),1220,15925800,13053.93,1507,7683960,5099,8241840
2019-01-28,21.05 ( -0.47 %),748,5639560,7539.52,1498,6278810,4191,-639250
2019-01-25,21.15 ( -0.24 %),930,7129730,7666.38,1997,8759970,4387,-1630240
2019-01-24,21.2 ( 2.42 %),1164,13752000,11814.43,2240,10047380,4485,3704620
2019-01-23,20.7 ( 0.49 %),1099,7239340,6587.21,1508,5034760,3339,2204580
2019-01-22,20.6 ( -1.9 %),1707,8458060,4954.93,2060,11485950,5576,-3027890
2019-01-21,21 ( 6.33 %),2541,18979360,7469.25,3894,16520350,4243,2459010
2019-01-18,19.75 ( 0 %),848,5461410,6440.34,1480,6673030,4509,-1211620
2019-01-17,19.75 ( 1.54 %),1337,12363610,9247.28,2990,13322740,4456,-959130
2019-01-16,19.45 ( -0.26 %),949,4748850,5004.06,1439,5888980,4092,-1140130
2019-01-15,19.5 ( 2.63 %),1299,13297030,10236.36,1919,10282300,5358,3014730
2019-01-14,19 ( -1.3 %),1632,7897900,4839.4,1048,10442220,9964,-2544320
2019-01-11,19.25 ( -0.52 %),1046,9436760,9021.76,1234,7600330,6159,1836430
2019-01-10,19.35 ( 0 %),1134,5801850,5116.27,1144,6365500,5564,-563650
2019-01-09,19.35 ( 2.65 %),1316,12978010,9861.71,1996,11245480,5634,1732530
2019-01-08,18.85 ( -0.53 %),1289,7151780,5548.32,1039,6131790,5902,1019990
2019-01-07,18.95 ( 1.88 %),1417,7842290,5534.43,1514,7310860,4829,531430
2019-01-04,18.6 ( 0.54 %),2277,15847020,6959.6,1677,9400930,5606,6446090
2019-01-03,18.5 ( -4.39 %),2571,13166100,5121,1809,13595240,7515,-429140
2019-01-02,19.35 ( -0.51 %),1485,5871350,3953.77,1188,6290810,5295,-419460
2018-12-28,19.45 ( -1.27 %),1594,8792040,5515.71,1264,9191560,7272,-399520
2018-12-27,19.7 ( 0.51 %),2001,10061100,5028.04,1883,13928020,7397,-3866920
2018-12-26,19.6 ( -0.51 %),1492,5079730,3404.64,983,7893980,8030,-2814250
2018-12-25,19.7 ( -3.67 %),3833,17266430,4504.68,1836,16787560,9144,478870
2018-12-24,20.45 ( -2.39 %),1857,7262340,3910.79,932,8451360,9068,-1189020
2018-12-21,20.95 ( 0 %),2129,10951780,5144.1,955,8615010,9021,2336770
2018-12-20,20.95 ( -0.95 %),1423,7869720,5530.37,985,9947800,10099,-2078080
2018-12-19,21.15 ( -0.7 %),1754,13211300,7532.1,1087,11030440,10148,2180860
2018-12-18,21.3 ( 0.24 %),2594,16483700,6354.55,1601,13184450,8235,3299250
2018-12-17,21.25 ( -2.52 %),2262,14372560,6353.92,1511,16469470,10900,-2096910
2018-12-14,21.8 ( -1.8 %),2905,13151040,4527.04,1362,15371380,11286,-2220340
2018-12-13,22.2 ( -1.33 %),2015,9989620,4957.63,2018,18131910,8985,-8142290
2018-12-12,22.5 ( 1.12 %),1677,11654180,6949.42,2221,12894370,5806,-1240190
2018-12-11,22.25 ( 0.68 %),2024,14354240,7092.02,1689,14977420,8868,-623180
2018-12-10,22.1 ( -1.78 %),2422,13469500,5561.31,1952,14872910,7619,-1403410
2018-12-07,22.5 ( 0 %),2044,22262620,10891.69,3345,21681750,6482,580870
2018-12-06,22.5 ( 1.35 %),3035,38019350,12526.97,3665,25366140,6921,12653210
2018-12-05,22.2 ( 0.91 %),3157,33921100,10744.73,3320,19130520,5762,14790580
2018-12-04,22 ( -0.68 %),2206,12965870,5877.55,2383,12783780,5365,182090
2018-12-03,22.15 ( 2.78 %),3154,23505850,7452.71,3130,16545110,5286,6960740
2018-11-30,21.55 ( 3.11 %),3561,39042570,10963.93,4274,28513080,6671,10529490
2018-11-29,20.9 ( 0.24 %),1427,6812410,4773.94,1433,8096360,5650,-1283950
2018-11-28,20.85 ( 0.97 %),1021,4316200,4227.42,871,3772830,4332,543370
2018-11-27,20.65 ( -0.72 %),1644,6563400,3992.34,1173,7848870,6691,-1285470
2018-11-26,20.8 ( -0.72 %),1288,5463920,4242.17,930,5450300,5861,13620
2018-11-23,20.95 ( -1.18 %),1485,8943980,6022.88,955,6918940,7245,2025040
2018-11-22,21.2 ( -0.7 %),1461,9741560,6667.73,1238,7400330,5978,2341230
2018-11-21,21.35 ( 1.18 %),1707,10809490,6332.45,1204,6906470,5736,3903020
2018-11-20,21.1 ( -0.94 %),1712,7649670,4468.27,916,5499240,6004,2150430
2018-11-19,21.3 ( 0.24 %),1637,5963050,3642.67,1128,5248380,4653,714670
2018-11-16,21.25 ( 3.91 %),1381,10130920,7335.93,2248,7795460,3468,2335460
2018-11-15,20.45 ( 0.99 %),1313,9429670,7181.77,1687,5703160,3381,3726510
2018-11-14,20.25 ( -1.46 %),1491,5848640,3922.63,1285,6915640,5382,-1067000
2018-11-13,20.55 ( -1.2 %),1419,5000720,3524.12,1083,4703730,4343,296990
2018-11-12,20.8 ( -0.48 %),1336,3869320,2896.2,896,3413810,3810,455510
2018-11-09,20.9 ( -2.34 %),1976,7202570,3645.03,1335,9030010,6764,-1827440
2018-11-08,21.4 ( -0.47 %),1062,3402780,3204.12,1302,6211250,4771,-2808470
2018-11-07,21.5 ( 0 %),1362,5727700,4205.36,1062,5191580,4888,536120
2018-11-06,21.5 ( -1.6 %),1243,6021690,4844.48,1590,8265500,5198,-2243810
2018-11-05,21.85 ( 0.23 %),1189,6353140,5343.26,1272,6269100,4929,84040
2018-11-02,21.8 ( 1.4 %),1287,8818450,6851.94,2320,8727920,3762,90530
2018-11-01,21.5 ( -1.83 %),1085,5208560,4800.52,1370,6687040,4881,-1478480
2018-10-31,21.9 ( 2.58 %),1640,9284200,5661.1,1994,9379350,4704,-95150
2018-10-30,21.35 ( 0.47 %),1061,6001300,5656.27,1251,5514190,4408,487110
2018-10-29,21.25 ( 0.95 %),1120,7364670,6575.6,1833,7106590,3877,258080
2018-10-26,21.05 ( 0.24 %),1447,8147440,5630.57,2127,9453210,4444,-1305770
2018-10-25,21 ( -0.24 %),2325,11627410,5001.04,1804,8558210,4744,3069200
2018-10-24,21.05 ( -1.64 %),1271,6089930,4791.45,1787,7015140,3926,-925210
2018-10-23,21.4 ( 1.42 %),2515,18526840,7366.54,3074,12207570,3971,6319270
2018-10-22,21.1 ( 0.48 %),1491,6221960,4173.01,1615,7097510,4395,-875550
2018-10-19,21 ( -0.71 %),2647,9227520,3486.03,1251,5816690,4650,3410830
2018-10-18,21.15 ( -2.31 %),2568,10775650,4196.13,1223,6596860,5394,4178790
2018-10-17,21.65 ( -0.46 %),2445,15586570,6374.88,1757,10892720,6200,4693850
2018-10-16,21.75 ( 2.11 %),1790,9579710,5351.79,1442,6057420,4201,3522290
2018-10-15,21.3 ( -2.29 %),2815,9080190,3225.64,1368,7755210,5669,1324980
2018-10-12,21.8 ( 2.59 %),4385,17327110,3951.45,2435,11681320,4797,5645790
2018-10-11,21.25 ( -6.59 %),5563,17255480,3101.83,2710,18069290,6668,-813810
2018-10-10,22.75 ( -1.3 %),5758,21065240,3658.43,2675,18472960,6906,2592280
2018-10-09,23.05 ( -2.95 %),5904,22158460,3753.13,3081,21529230,6988,629230
2018-10-08,23.75 ( 0.21 %),2396,10056040,4197.01,2357,10033160,4257,22880
2018-10-05,23.7 ( -1.25 %),3031,12164960,4013.51,4158,17164870,4128,-4999910
2018-10-04,24 ( 3.9 %),5815,33946550,5837.76,8131,36227650,4455,-2281100
2018-10-03,23.1 ( 0.87 %),1533,6277250,4094.75,1921,7067450,3679,-790200
2018-10-02,22.9 ( -0.87 %),2478,9726600,3925.18,1955,9315430,4765,411170
2018-10-01,23.1 ( 0 %),2070,8022820,3875.76,2963,11579810,3908,-3556990
2018-09-28,23.1 ( 0.43 %),2492,12905660,5178.84,3592,15367270,4278,-2461610
2018-09-27,23 ( 0 %),2218,8550670,3855.13,2356,10151360,4309,-1600690
2018-09-26,23 ( 0.44 %),2205,11780170,5342.48,2956,11662260,3945,117910
2018-09-25,22.9 ( -1.29 %),2660,10421070,3917.7,2877,12819070,4456,-2398000
2018-09-24,23.2 ( 1.09 %),2505,13666330,5455.62,3854,13674140,3548,-7810
2018-09-20,22.6 ( 0.89 %),2479,8444360,3406.36,2327,8072480,3469,371880
2018-09-19,22.4 ( 1.36 %),3160,10017340,3170.04,2597,9869620,3800,147720
2018-09-18,22.1 ( 0 %),4333,12992070,2998.4,1988,8314680,4182,4677390
2018-09-17,22.1 ( -2.21 %),5498,12649790,2300.8,2628,14968330,5696,-2318540
2018-09-14,22.6 ( -0.88 %),6877,19105990,2778.24,3421,20148400,5890,-1042410
2018-09-13,22.8 ( 0.22 %),1612,5819250,3609.96,2244,7730490,3445,-1911240
2018-09-12,22.75 ( -1.09 %),1661,5167330,3110.98,2481,8347930,3365,-3180600
2018-09-11,23 ( 1.55 %),2110,7069390,3350.42,2011,8240200,4098,-1170810
2018-09-10,22.65 ( -0.88 %),1775,5104550,2875.8,1650,6433360,3899,-1328810
2018-09-07,22.85 ( 1.78 %),2664,7627740,2863.27,1917,6756460,3524,871280
2018-09-06,22.45 ( -1.32 %),3040,7201530,2368.92,2030,9851520,4853,-2649990
2018-09-05,22.75 ( -1.52 %),4599,11111790,2416.13,2336,15215660,6514,-4103870
2018-09-04,23.1 ( -2.53 %),3937,10620900,2697.71,2349,13728500,5844,-3107600
2018-08-31,23.7 ( -1.66 %),3386,10125040,2990.27,4041,16405000,4060,-6279960
2018-08-30,24.1 ( 1.47 %),2690,11858090,4408.21,3396,13153620,3873,-1295530
2018-08-29,23.75 ( -0.63 %),2515,8054440,3202.56,2508,9846300,3926,-1791860
2018-08-28,23.9 ( 0 %),2706,9766110,3609.06,3895,13567430,3483,-3801320
2018-08-27,0 ( 0 %),4191,17292390,4126.08,5398,19875780,3682,-2583390
2018-08-24,23.5 ( 0.21 %),2836,11384860,4014.41,3160,11737990,3715,-353130
2018-08-23,23.45 ( 0.21 %),1953,6975550,3571.71,2412,7937780,3291,-962230
2018-08-22,23.4 ( -0.21 %),1988,7667990,3857.14,3257,14453870,4438,-6785880
2018-08-21,23.45 ( 2.4 %),3140,12262300,3905.19,2520,8664120,3438,3598180
2018-08-20,22.9 ( -2.14 %),3110,7655450,2461.56,2437,10201940,4186,-2546490
2018-08-17,23.4 ( -1.27 %),2930,8902730,3038.47,3241,13795650,4257,-4892920
2018-08-16,23.7 ( 1.72 %),4784,14707920,3074.4,3414,13127930,3845,1579990
2018-08-15,23.3 ( -2.31 %),5465,18239430,3337.5,5111,22175580,4339,-3936150
2018-08-14,23.85 ( -2.05 %),4398,9770310,2221.53,3154,13167170,4175,-3396860
2018-08-13,24.35 ( 4.73 %),6097,21098980,3460.55,5517,19448050,3525,1650930
2018-08-10,23.25 ( 0.43 %),2862,8705600,3041.79,1958,11730110,5991,-3024510
2018-08-09,23.15 ( -0.64 %),3319,9509790,2865.26,3719,15539940,4179,-6030150
2018-08-08,23.3 ( 2.19 %),2292,8597730,3751.19,2758,9777550,3545,-1179820
2018-08-07,22.8 ( -0.22 %),2545,8025930,3153.61,2114,8328850,3940,-302920
2018-08-06,22.85 ( -1.08 %),2377,6638300,2792.72,1630,6747620,4140,-109320
2018-08-03,23.1 ( 0.65 %),1981,7864040,3969.73,2568,8641860,3365,-777820
2018-08-02,22.95 ( -0.65 %),4338,9522510,2195.14,1681,8239730,4902,1282780
2018-08-01,23.1 ( -1.49 %),3220,8310460,2580.89,2564,9926460,3871,-1616000
2018-07-31,23.45 ( -0.21 %),3257,11129000,3416.95,3739,12551490,3357,-1422490
2018-07-30,23.5 ( 2.17 %),2002,6842150,3417.66,3156,8187060,2594,-1344910
2018-07-27,23 ( 2.22 %),2566,10979350,4278.78,3749,12417040,3312,-1437690
2018-07-26,22.5 ( 2.27 %),2940,9285460,3158.32,2163,7203960,3331,2081500
2018-07-25,22 ( -2.65 %),2373,7233670,3048.32,2083,9213720,4423,-1980050
2018-07-24,22.6 ( -1.09 %),3260,8984820,2756.08,2450,8686060,3545,298760
2018-07-23,22.85 ( -1.93 %),3161,9129080,2888.04,3190,11151950,3496,-2022870
2018-07-20,23.3 ( 3.1 %),4697,13834060,2945.3,2662,12114340,4551,1719720
2018-07-19,22.6 ( -2.16 %),4189,12696890,3031.01,2909,12985420,4464,-288530
2018-07-18,23.1 ( 3.36 %),3630,12970000,3573,3028,9807850,3239,3162150
2018-07-17,22.35 ( 4.44 %),3162,13597270,4300.21,2715,8231400,3032,5365870
2018-07-16,21.4 ( 2.88 %),2755,11679520,4239.39,2845,9950520,3498,1729000
2018-07-13,20.8 ( 2.97 %),2125,10675330,5023.68,2440,8756250,3589,1919080
2018-07-12,20.2 ( 4.12 %),1542,6341140,4112.28,2209,5948230,2693,392910
2018-07-11,19.4 ( -5.83 %),3366,7780120,2311.38,1576,8990750,5705,-1210630
2018-07-10,20.6 ( 0.98 %),1393,5675230,4074.11,1356,5198920,3834,476310
2018-07-09,20.4 ( 0.74 %),2639,7555550,2863.04,1627,6691370,4113,864180
2018-07-06,20.25 ( 6.87 %),3258,13122180,4027.68,2178,6802000,3123,6320180
2018-07-05,22.55 ( -5.65 %),2451,6619740,2700.83,2033,8047060,3958,-1427320
2018-07-04,23.9 ( 1.92 %),2140,6846300,3199.21,2147,5082680,2367,1763620
2018-07-03,23.45 ( -5.63 %),3178,9372110,2949.06,2417,9798050,4054,-425940
2018-07-02,24.85 ( -5.15 %),3428,8758810,2555.08,2077,8875510,4273,-116700
2018-06-29,26.2 ( -1.13 %),2630,6423990,2442.58,1384,6445290,4657,-21300
2018-06-28,26.5 ( -2.93 %),3649,8430350,2310.32,1564,8871650,5672,-441300
2018-06-27,27.3 ( -2.15 %),1641,3624280,2208.58,1073,4323060,4029,-698780
2018-06-26,27.9 ( -1.06 %),1953,5162030,2643.13,1145,4679940,4087,482090
2018-06-25,28.2 ( 1.08 %),1883,7125610,3784.18,1843,6210580,3370,915030
2018-06-22,27.9 ( 2.95 %),2523,7504500,2974.44,1441,5446120,3779,2058380
2018-06-21,27.1 ( -2.87 %),2567,4289270,1670.93,1228,5381730,4383,-1092460
2018-06-20,27.9 ( 1.45 %),2986,8118090,2718.72,1778,7735680,4351,382410
2018-06-19,27.5 ( -1.79 %),5385,13218920,2454.77,2226,11739690,5274,1479230
2018-06-18,28 ( -4.76 %),3652,9302520,2547.24,1850,9296940,5025,5580
2018-06-14,28.6 ( -3.05 %),2446,4613380,1886.09,1150,5405420,4700,-792040
2018-06-13,29.5 ( 0.17 %),3461,7696570,2223.8,1327,7391430,5570,305140
2018-06-12,29.45 ( -2.81 %),5948,17941420,3016.38,2553,17756240,6955,185180
2018-06-11,30.3 ( -1.46 %),2403,10353750,4308.68,2067,9002100,4355,1351650
2018-06-08,30.75 ( -0.49 %),2613,10479350,4010.47,1901,8680950,4567,1798400
2018-06-07,30.9 ( 1.15 %),3067,16397180,5346.33,3945,16639350,4218,-242170
2018-06-06,30.55 ( 0.33 %),3608,14520920,4024.65,2190,11637320,5314,2883600
2018-06-05,30.45 ( 0 %),3009,10573410,3513.93,2454,8866040,3613,1707370
2018-06-04,30.45 ( 4.1 %),2838,13902840,4898.82,2628,10094120,3841,3808720
2018-06-01,0 ( 0 %),3275,14025820,4282.69,2612,10350760,3963,3675060
2018-05-31,29.1 ( 5.63 %),2304,12531540,5439.04,2452,7326090,2988,5205450
2018-05-30,27.55 ( -1.96 %),2681,7968890,2972.36,1733,7008470,4044,960420
2018-05-29,28.1 ( 6.84 %),2762,11239650,4069.39,2493,9001730,3611,2237920
2018-05-28,26.3 ( -6.74 %),3037,13063880,4301.57,2734,13566200,4962,-502320
2018-05-25,28.2 ( -3.59 %),1695,7949290,4689.85,1782,6678900,3748,1270390
2018-05-24,29.25 ( -0.17 %),1704,9417020,5526.42,1979,7506960,3793,1910060
2018-05-23,29.3 ( 1.74 %),1845,7355920,3986.95,1866,5744220,3078,1611700
2018-05-22,28.8 ( -2.7 %),3447,10440790,3028.95,2314,8288900,3582,2151890
2018-05-21,29.6 ( -2.31 %),1309,4902470,3745.2,1538,4937030,3210,-34560
2018-05-18,30.3 ( 1.34 %),2887,8337390,2887.91,1595,5633700,3532,2703690
2018-05-17,29.9 ( -1.32 %),2145,6198920,2889.94,1171,5718050,4883,480870
2018-05-15,31 ( 0 %),1861,6304100,3387.48,2513,8060120,3207,-1756020
2018-05-11,30.55 ( 3.38 %),2666,6855250,2571.36,2100,5317300,2532,1537950
2018-05-10,29.55 ( -5.29 %),3049,8300400,2722.34,1664,8413190,5056,-112790
2018-05-09,31.2 ( -0.95 %),2482,7205630,2903.15,1726,6850510,3969,355120
2018-05-08,31.5 ( -2.17 %),3680,10748770,2920.86,1992,9082630,4560,1666140
2018-05-07,32.2 ( 4.89 %),3243,9121110,2812.55,2344,7124440,3039,1996670
2018-05-04,30.7 ( 1.49 %),2430,9651970,3972,2238,7065510,3157,2586460
2018-05-03,0 ( 0 %),2445,13296610,5438.29,2957,9301040,3145,3995570
2018-05-02,0 ( 0 %),2251,8190350,3638.54,1641,7203470,4390,986880
2018-04-27,29.9 ( 4.91 %),2926,11775210,4024.34,2934,7748590,2641,4026620
2018-04-26,28.5 ( -6.71 %),2946,9946710,3376.34,2769,12545860,4531,-2599150
2018-04-24,30.55 ( -0.16 %),3122,11713260,3751.84,3203,10053650,3139,1659610
2018-04-23,30.6 ( -6.85 %),3825,10524990,2751.63,2449,13377530,5462,-2852540
2018-04-20,32.85 ( 2.98 %),3100,11420480,3684.03,2494,9386550,3764,2033930
2018-04-19,31.9 ( -5.2 %),4951,12414090,2507.39,3123,13725010,4395,-1310920
2018-04-18,33.65 ( -2.46 %),2560,4672710,1825.28,1748,7826420,4477,-3153710
2018-04-17,34.5 ( 2.68 %),2343,7875550,3361.31,1939,7741200,3992,134350
2018-04-16,33.6 ( 1.51 %),3684,11464340,3111.93,2989,10674380,3571,789960
2018-04-13,33.1 ( -4.89 %),5659,10593250,1871.93,2559,12300010,4807,-1706760
2018-04-12,34.8 ( -1.14 %),6809,13582520,1994.79,2010,12601920,6270,980600
2018-04-11,35.2 ( -3.69 %),7200,12944380,1797.83,2530,15401230,6087,-2456850
2018-04-10,36.55 ( -0.68 %),4968,11817680,2378.76,3411,15568110,4564,-3750430
2018-04-09,36.8 ( 0.55 %),4639,12284030,2647.99,3520,13125460,3729,-841430
2018-04-06,36.6 ( -0.27 %),2540,6576550,2589.19,3168,10956430,3458,-4379880
2018-04-05,36.7 ( 0.55 %),2505,8046730,3212.27,2763,9221500,3337,-1174770
2018-04-04,36.5 ( -0.54 %),3743,9758680,2607.18,5281,14510230,2748,-4751550
2018-04-03,36.7 ( 2.51 %),3531,15295110,4331.67,4318,14816660,3431,478450
2018-04-02,35.8 ( 3.17 %),3186,8457610,2654.62,2457,8255340,3360,202270
2018-03-30,34.7 ( -1.42 %),4990,8243890,1652.08,1971,8678180,4403,-434290
2018-03-29,35.2 ( -0.56 %),3442,6579700,1911.59,1554,6649030,4279,-69330
2018-03-28,35.4 ( -1.12 %),3420,6812940,1992.09,1595,7751450,4860,-938510
2018-03-27,35.8 ( 0 %),3024,7165910,2369.68,2396,10870330,4537,-3704420
2018-03-26,35.8 ( 0.85 %),3173,8703790,2743.08,1742,7833450,4497,870340
2018-03-23,35.5 ( -1.39 %),8394,18723410,2230.57,2688,15369520,5718,3353890
2018-03-22,36 ( -2.17 %),4971,12390420,2492.54,2590,12923710,4990,-533290
2018-03-21,36.8 ( 1.1 %),3118,11121020,3566.72,2978,10639690,3573,481330
2018-03-20,36.4 ( 1.39 %),4719,17358520,3678.43,3410,13665230,4007,3693290
2018-03-19,35.9 ( -0.28 %),4740,14510820,3061.35,3293,16424550,4988,-1913730
2018-03-16,36 ( 0.14 %),4259,10200930,2395.15,2834,11967410,4223,-1766480
2018-03-15,35.95 ( 3.3 %),3667,13572510,3701.26,3422,12612970,3686,959540
2018-03-14,34.8 ( 0.29 %),4333,11975790,2763.86,3302,14715040,4456,-2739250
2018-03-13,34.7 ( 2.66 %),2613,9494130,3633.42,2084,8906310,4274,587820
2018-03-12,33.8 ( 0.9 %),2347,9485770,4041.66,2651,11051410,4169,-1565640
2018-03-09,33.5 ( 1.36 %),1777,6655920,3745.59,1949,7635720,3918,-979800
2018-03-08,33.05 ( 0.15 %),2032,6232250,3067.05,1597,6846120,4287,-613870
2018-03-07,33 ( -2.94 %),4918,12233690,2487.53,2342,12836410,5481,-602720
2018-03-06,34 ( 4.62 %),3768,13672970,3628.71,2527,11005460,4355,2667510
2018-03-05,32.5 ( -4.97 %),3010,7904090,2625.94,2745,11268730,4105,-3364640
2018-03-02,34.2 ( 0.88 %),3946,10523610,2666.91,2037,7477510,3671,3046100
2018-03-01,33.9 ( -1.45 %),5680,12090100,2128.54,3240,14441600,4457,-2351500
2018-02-28,34.4 ( 4.88 %),5231,21853340,4177.66,4445,18721380,4212,3131960
2018-02-27,32.8 ( 0.77 %),2513,7727370,3074.96,2425,9014700,3717,-1287330
2018-02-26,32.55 ( -1.36 %),3703,11619720,3137.92,3410,15218970,4463,-3599250
2018-02-23,33 ( 4.6 %),2762,13565030,4911.31,2143,11074140,5168,2490890
2018-02-22,31.55 ( -0.47 %),2971,9584540,3226.03,2181,10355150,4748,-770610
2018-02-21,31.7 ( 0.63 %),2150,6340500,2949.07,1777,7305170,4111,-964670
2018-02-13,31.5 ( 1.94 %),2047,8181510,3996.83,1656,8239250,4975,-57740
2018-02-12,30.9 ( 6.92 %),1853,7577570,4089.35,1322,5311970,4018,2265600
2018-02-09,28.9 ( 2.12 %),2565,9795550,3818.93,1542,6079750,3943,3715800
2018-02-08,28.3 ( -3.08 %),1317,3116980,2366.73,959,3812670,3976,-695690
2018-02-07,29.2 ( 5.04 %),2540,8915140,3509.9,1142,7849750,6874,1065390
2018-02-06,27.8 ( -4.14 %),2994,14668320,4899.24,2495,16222020,6502,-1553700
2018-02-05,29 ( -6.45 %),2707,8684480,3208.16,1602,9150820,5712,-466340
2018-02-02,31 ( 0.98 %),2428,9008150,3710.11,1478,8638410,5845,369740
2018-02-01,30.7 ( -3.76 %),3022,9366740,3099.52,2008,10302210,5131,-935470
2018-01-31,31.9 ( -2.74 %),3742,12205250,3261.69,2614,13006030,4976,-800780
2018-01-30,32.8 ( -0.91 %),3185,12863140,4038.66,2464,11609820,4712,1253320
2018-01-29,33.1 ( 5.08 %),3152,13935180,4421.06,2895,12872980,4447,1062200
2018-01-26,31.5 ( 6.06 %),3434,16092190,4686.14,3629,13933250,3839,2158940
2018-01-25,29.7 ( 6.07 %),3964,27014150,6814.87,5053,24858390,4920,2155760
2018-01-22,28 ( 0.72 %),1484,7825400,5273.18,2074,9173850,4423,-1348450
2018-01-19,27.8 ( -0.71 %),2269,8875710,3911.73,1942,11429750,5886,-2554040
2018-01-18,28 ( 2.19 %),2138,12795490,5984.79,2067,8906630,4309,3888860
2018-01-17,27.4 ( -1.97 %),2837,16816910,5927.71,1876,14258180,7600,2558730
2018-01-16,28.55 ( 0.88 %),2601,11720290,4506.07,1866,9618520,5155,2101770
2018-01-15,28.3 ( 2.91 %),2291,11642560,5081.87,2199,10250810,4662,1391750
2018-01-12,27.5 ( -2.31 %),3764,15849160,4210.72,2491,15888740,6378,-39580
2018-01-11,28.15 ( 1.44 %),2707,17344770,6407.38,2958,14826280,5012,2518490
2018-01-10,27.75 ( 0.18 %),2697,11630610,4312.42,2604,11747900,4511,-117290
2018-01-09,27.7 ( 0.91 %),2711,17560560,6477.52,3229,14500630,4491,3059930
2018-01-08,27.45 ( 4.97 %),2304,14554340,6316.99,3178,13362370,4205,1191970
2018-01-05,26.15 ( -0.76 %),2998,14850700,4953.54,2186,14464420,6617,386280
2018-01-04,26.35 ( 0.19 %),2574,10250180,3982.2,2013,11642060,5783,-1391880
2018-01-03,26.3 ( -0.94 %),3179,11973490,3766.43,2894,14677310,5072,-2703820
2018-01-02,26.55 ( 4.53 %),3082,13390250,4344.66,2565,11122970,4336,2267280
2017-12-29,25.4 ( -0.97 %),2181,7780500,3567.4,2018,9931420,4921,-2150920
2017-12-28,25.65 ( 2.19 %),2661,15805490,5939.68,2959,15827610,5349,-22120
2017-12-27,25.1 ( 0.4 %),2705,10677220,3947.22,1769,11018060,6228,-340840
2017-12-26,25 ( 0 %),2367,8779090,3708.95,967,7530730,7788,1248360
2017-12-25,25 ( -0.99 %),1750,6254920,3574.24,1638,8271300,5050,-2016380
2017-12-22,25.25 ( 1.2 %),1300,6831870,5255.28,2004,8935330,4459,-2103460
2017-12-21,24.95 ( 0.2 %),1489,8227370,5525.43,2133,10479030,4913,-2251660
2017-12-20,24.9 ( 1.43 %),1571,7712180,4909.09,1860,8347710,4488,-635530
2017-12-19,24.55 ( -0.61 %),1537,5601100,3644.18,1209,6242570,5163,-641470
2017-12-18,24.7 ( 1.86 %),1523,6656200,4370.45,1281,7105890,5547,-449690
2017-12-15,24.25 ( 1.04 %),1544,4719470,3056.65,976,4830890,4950,-111420
2017-12-14,24 ( 3.23 %),1689,5524800,3271.05,859,4694050,5465,830750
2017-12-13,23.25 ( -3.12 %),1866,4247750,2276.39,901,5732320,6362,-1484570
2017-12-12,24 ( 0 %),2886,12147020,4208.95,2312,12667150,5479,-520130
2017-12-11,24 ( -3.61 %),1404,5112520,3641.4,969,6639130,6852,-1526610
2017-12-08,24.9 ( 0.81 %),1284,5521180,4299.98,1092,4491090,4113,1030090
2017-12-07,24.7 ( -0.8 %),1354,4572550,3377.07,1050,4622860,4403,-50310
2017-12-06,24.9 ( 0 %),3100,10457890,3373.51,1747,9286140,5315,1171750
2017-12-05,24.9 ( -3.68 %),2839,12160530,4283.38,1892,12123230,6408,37300
2017-12-04,25.85 ( 1.37 %),1897,10513120,5541.97,1628,7846460,4820,2666660
2017-12-01,25.5 ( -0.39 %),1672,9038500,5405.8,1743,7947930,4560,1090570
2017-11-30,25.6 ( 2.4 %),2417,15061220,6231.37,2547,12243440,4807,2817780
2017-11-29,25 ( 3.09 %),2020,11947990,5914.85,1887,8805780,4667,3142210
2017-11-28,24.25 ( -0.61 %),2606,11406680,4377.08,1661,10908790,6568,497890
2017-11-27,24.4 ( -1.41 %),2438,8337050,3419.63,1933,10626870,5498,-2289820
2017-11-24,24.75 ( 0.2 %),1949,8812460,4521.53,1746,7746790,4437,1065670
2017-11-23,24.7 ( 2.07 %),4031,17854320,4429.25,3233,17829180,5515,25140
2017-11-22,24.2 ( 0.83 %),3614,15926740,4406.96,2476,16143920,6520,-217180
2017-11-21,24 ( 1.05 %),2325,13691920,5889,3586,15217820,4244,-1525900
2017-11-20,23.75 ( 0.64 %),1141,6020890,5276.85,2131,8814470,4136,-2793580
2017-11-17,23.6 ( 1.29 %),1688,8820910,5225.66,2642,11217250,4246,-2396340
2017-11-16,23.3 ( 1.75 %),2186,9087380,4157.08,1452,7974950,5492,1112430
2017-11-15,22.9 ( -0.87 %),1944,6129300,3152.93,1059,5454820,5151,674480
2017-11-14,23.1 ( 0.22 %),2440,8206950,3363.5,1664,6669900,4008,1537050
2017-11-13,23.05 ( -2.12 %),2197,9602090,4370.55,2034,10315400,5071,-713310
2017-11-10,23.55 ( 0.21 %),2115,10990530,5196.47,3449,12212980,3541,-1222450
2017-11-09,23.5 ( -1.26 %),1682,7541800,4483.83,2159,10248560,4747,-2706760
2017-11-08,23.8 ( 2.37 %),2650,13352980,5038.86,3134,14173630,4523,-820650
2017-11-06,22.9 ( 1.1 %),893,4983600,5580.74,1000,5083660,5084,-100060
2017-11-03,22.65 ( 0.89 %),846,3555730,4202.99,746,3456820,4634,98910
2017-11-02,22.45 ( -0.88 %),1189,6500620,5467.3,1251,7319180,5851,-818560
2017-11-01,22.65 ( 0.22 %),765,5115590,6687.05,1135,5460570,4811,-344980
2017-10-31,22.6 ( 0 %),1047,5849410,5586.83,1557,9026440,5797,-3177030
2017-10-30,0 ( 0 %),1007,6185310,6142.31,1944,8434410,4339,-2249100
2017-10-27,23 ( 2.22 %),683,5094650,7459.22,1356,5641540,4160,-546890
2017-10-26,22.5 ( -0.88 %),1119,5492100,4908.04,974,5831730,5987,-339630
2017-10-25,22.7 ( 1.57 %),1358,8543210,6291.02,1098,6987800,6364,1555410
2017-10-24,22.35 ( 0.68 %),1097,4024750,3668.87,832,3777820,4541,246930
2017-10-23,22.2 ( -1.33 %),1356,4863010,3586.29,1065,5182790,4866,-319780
2017-10-20,22.5 ( -0.44 %),1671,6420560,3842.35,982,6407880,6525,12680
2017-10-19,22.6 ( -2.16 %),2768,8867490,3203.57,1483,10923820,7366,-2056330
2017-10-18,23.1 ( -1.49 %),1515,7203890,4755.04,1320,8559790,6485,-1355900
2017-10-17,23.45 ( 1.52 %),1512,8806570,5824.45,1179,8314860,7052,491710
2017-10-16,23.1 ( -1.07 %),1343,6171730,4595.48,1342,7982780,5948,-1811050
2017-10-13,23.35 ( 1.08 %),1297,7032480,5422.11,1249,6091520,4877,940960
2017-10-12,23.1 ( -0.86 %),1149,6451380,5614.78,1324,6631080,5008,-179700
2017-10-11,23.3 ( -0.21 %),1643,6946290,4227.81,1475,7076870,4798,-130580
2017-10-10,23.35 ( 0.65 %),1837,8780970,4780.06,1902,8267430,4347,513540
2017-10-09,23.2 ( 0.43 %),1852,8613660,4651,2185,9764280,4469,-1150620
2017-10-06,23.1 ( 4.52 %),1721,12751640,7409.44,2618,11346690,4334,1404950
2017-10-05,22.1 ( -1.34 %),1545,6243850,4041.33,1455,7282000,5005,-1038150
2017-10-04,22.4 ( 3.94 %),986,5484240,5562.11,1039,5058880,4869,425360
2017-10-03,21.55 ( -0.23 %),907,2843910,3135.51,620,2973640,4796,-129730
2017-10-02,21.6 ( -0.69 %),1055,3263530,3093.39,649,4214190,6493,-950660
2017-09-29,21.75 ( 1.27 %),1450,3740640,2579.75,858,5116210,5963,-1375570
2017-09-28,22.55 ( -0.66 %),1681,8637640,5138.39,794,8568550,10792,69090
2017-09-27,22.7 ( -0.22 %),999,3557640,3561.2,571,3854920,6751,-297280
2017-09-26,22.75 ( -0.66 %),1569,4975990,3171.44,695,5677720,8169,-701730
2017-09-25,22.9 ( -0.22 %),1120,3517730,3140.83,791,5275910,6670,-1758180
2017-09-22,22.95 ( -0.86 %),1565,5779730,3693.12,953,7876650,8265,-2096920
2017-09-21,23.15 ( 0.87 %),1051,3786410,3602.67,764,4417590,5782,-631180
2017-09-20,22.95 ( 0.22 %),1112,2977730,2677.81,534,3677330,6886,-699600
2017-09-19,22.9 ( -0.43 %),1048,4084040,3896.98,929,6431600,6923,-2347560
2017-09-18,23 ( 0.44 %),1222,4307820,3525.22,1020,6613160,6483,-2305340
2017-09-15,22.9 ( -0.87 %),1248,3209890,2572.03,604,4329030,7167,-1119140
2017-09-14,23.1 ( 0.43 %),944,3328290,3525.73,1032,4884420,4733,-1556130
2017-09-13,23 ( 0 %),718,2365740,3294.9,833,3937620,4727,-1571880
2017-09-12,23 ( 2.45 %),1876,12556540,6693.25,975,9444520,9687,3112020
2017-09-11,22.45 ( -1.32 %),1321,6089200,4609.54,833,5968700,7165,120500
2017-09-08,22.75 ( -1.94 %),1549,6369220,4111.83,993,7025930,7075,-656710
2017-09-07,23.2 ( -0.64 %),1183,5102210,4312.94,899,5739920,6385,-637710
2017-09-06,23.35 ( 0 %),1262,4778740,3786.64,675,4985000,7385,-206260
2017-09-05,23.35 ( -0.43 %),1040,4603450,4426.39,861,5260250,6109,-656800
2017-09-01,23.45 ( -1.26 %),1447,5997540,4144.81,1161,7421910,6393,-1424370
2017-08-31,23.75 ( 2.37 %),1591,11253050,7072.94,2145,11492810,5358,-239760
2017-08-30,23.2 ( 1.09 %),860,4461470,5187.76,1082,4705060,4348,-243590
2017-08-29,22.95 ( -0.43 %),1105,6433480,5822.15,1561,7173630,4596,-740150
2017-08-28,23.05 ( 0.44 %),820,4652320,5673.56,1099,4509480,4103,142840
2017-08-25,22.95 ( 0.66 %),815,5148020,6316.59,1673,6658120,3980,-1510100
2017-08-24,22.8 ( 3.64 %),1406,7759080,5518.55,1221,6408520,5249,1350560
2017-08-23,22 ( 0 %),529,2061910,3897.75,487,1714050,3520,347860
2017-08-22,22 ( -0.9 %),929,3345250,3600.91,621,3100520,4993,244730
2017-08-21,22.2 ( -0.89 %),607,2506790,4129.8,502,2364950,4711,141840
2017-08-18,22.4 ( 1.59 %),1280,4324200,3378.28,709,3765880,5312,558320
2017-08-17,22.05 ( -3.08 %),1508,5173740,3430.86,656,5706910,8700,-533170
2017-08-16,22.75 ( -0.66 %),1036,3365740,3248.78,633,4011150,6337,-645410
2017-08-15,22.9 ( -1.29 %),657,2437690,3710.33,787,3859490,4904,-1421800
2017-08-14,23.2 ( 3.57 %),1075,6118370,5691.51,950,5149740,5421,968630
2017-08-11,22.4 ( -0.44 %),1061,6190140,5834.25,639,5049410,7902,1140730
2017-08-10,22.5 ( 0.22 %),1177,6461410,5489.73,789,4931300,6250,1530110
2017-08-09,22.45 ( -3.65 %),2247,10924800,4861.95,1408,10208320,7250,716480
2017-08-08,23.3 ( -1.69 %),1465,6692870,4568.51,1004,5547930,5526,1144940
2017-08-07,23.7 ( 1.72 %),1050,6161300,5867.9,1080,5597700,5183,563600
2017-08-04,23.3 ( -0.85 %),983,3618730,3681.31,826,4067580,4924,-448850
2017-08-03,23.5 ( 0 %),2628,15112170,5750.45,1036,9932290,9587,5179880
2017-08-02,23.5 ( -0.84 %),1700,7946250,4674.26,1228,6997860,5699,948390
2017-08-01,23.7 ( -0.42 %),1161,4527330,3899.51,1152,5385870,4675,-858540
2017-07-31,23.8 ( 1.28 %),1408,7604430,5400.87,1569,8430280,5373,-825850
2017-07-28,23.5 ( 5.86 %),2146,11524760,5370.34,2397,9806940,4091,1717820
2017-07-27,22.2 ( 0.45 %),977,3732460,3820.33,1228,4924700,4010,-1192240
2017-07-26,22.1 ( 0 %),0,0,0,0,0,0,0
2017-07-25,22.1 ( 6.76 %),1104,5894840,5339.53,960,4825770,5027,1069070
2017-07-24,20.7 ( 1.97 %),581,3003280,5169.16,571,2525250,4423,478030
2017-07-21,20.3 ( -2.4 %),544,2087800,3837.87,368,1994580,5420,93220
2017-07-20,20.8 ( 1.46 %),569,2179840,3831,404,1310990,3245,868850
2017-07-19,20.5 ( -0.97 %),500,1465280,2930.56,358,1520600,4247,-55320
2017-07-18,20.7 ( 0.49 %),877,3346380,3815.71,647,2399370,3708,947010
2017-07-17,20.6 ( -3.06 %),959,4486530,4678.34,731,5448550,7454,-962020
2017-07-14,21.25 ( -0.47 %),502,1450680,2889.8,567,2377510,4193,-926830
2017-07-13,21.35 ( 0.23 %),397,1468240,3698.34,504,1927290,3824,-459050
2017-07-12,21.3 ( 0.47 %),537,2169000,4039.11,621,3212480,5173,-1043480
2017-07-11,21.2 ( 2.17 %),1096,5381480,4910.11,955,4884900,5115,496580
2017-07-10,20.75 ( -3.04 %),1275,5113790,4010.82,1080,6095330,5644,-981540
2017-07-07,21.4 ( -1.83 %),1019,4706520,4618.76,744,4886640,6568,-180120
2017-07-06,21.8 ( 0.23 %),815,3000200,3681.23,631,2793270,4427,206930
2017-07-05,21.75 ( -1.14 %),1454,5000780,3439.33,756,4647400,6147,353380
2017-07-04,22 ( -1.12 %),1192,4387110,3680.46,691,4203350,6083,183760
2017-07-03,22.25 ( -0.22 %),771,2311560,2998.13,654,2700440,4129,-388880
2017-06-30,22.3 ( 0 %),652,3438400,5273.62,984,3709500,3770,-271100
2017-06-29,22.3 ( 2.29 %),814,4574450,5619.72,1193,3508870,2941,1065580
2017-06-28,21.8 ( 0.46 %),516,1967970,3813.9,587,1786880,3044,181090
2017-06-27,21.7 ( 0 %),567,2474970,4365.03,741,2603400,3513,-128430
2017-06-26,21.7 ( 0.93 %),1025,3649860,3560.84,917,3251010,3545,398850
2017-06-23,21.5 ( -0.92 %),1015,3531820,3479.63,848,3717480,4384,-185660
2017-06-22,21.7 ( -0.91 %),1053,4207300,3995.54,1034,4155990,4019,51310
2017-06-21,21.9 ( 2.34 %),1754,8779810,5005.59,1612,7355600,4563,1424210
2017-06-20,21.4 ( 3.13 %),1067,5486240,5141.74,1514,5593390,3694,-107150
2017-06-19,20.75 ( 2.72 %),874,4868130,5569.94,1110,4420250,3982,447880
2017-06-16,20.2 ( 0.5 %),625,3695070,5912.11,637,3051060,4790,644010
2017-06-15,20.1 ( -1.23 %),618,2428490,3929.6,784,3619630,4617,-1191140
2017-06-14,20.35 ( 2.26 %),895,5179530,5787.18,1110,5161070,4650,18460
2017-06-13,19.9 ( 0.25 %),1419,5247690,3698.16,922,4515910,4898,731780
2017-06-12,19.85 ( -1 %),704,2579590,3664.19,662,3414040,5157,-834450
2017-06-09,20.05 ( 0 %),649,2695380,4153.13,757,3169630,4187,-474250
2017-06-08,20.05 ( -0.99 %),967,4254690,4399.89,1047,4616160,4409,-361470
2017-06-07,20.25 ( 4.38 %),1661,9762560,5877.52,1737,8092110,4659,1670450
2017-06-06,19.4 ( 1.57 %),561,2524600,4500.18,784,2827860,3607,-303260
2017-06-05,19.1 ( 0.53 %),670,3474880,5186.39,824,3671310,4455,-196430
2017-06-02,19 ( -0.52 %),467,1665840,3567.11,615,2257810,3671,-591970
2017-06-01,19.1 ( 1.33 %),474,2383530,5028.54,669,2422540,3621,-39010
2017-05-31,18.85 ( -0.79 %),726,3549770,4889.49,716,3336850,4660,212920
2017-05-30,19 ( -1.04 %),1206,5608090,4650.16,1127,4845330,4299,762760
2017-05-29,19.2 ( -1.29 %),864,4238480,4905.65,1033,4744160,4593,-505680
2017-05-26,19.45 ( 1.83 %),888,4221750,4754.22,1270,4045440,3185,176310
2017-05-25,19.1 ( 1.6 %),1537,7509080,4885.54,1587,8668410,5462,-1159330
2017-05-24,18.8 ( 6.82 %),1485,10099400,6800.94,1339,7059240,5272,3040160
2017-05-23,17.6 ( -3.83 %),892,4265710,4782.19,1052,5859620,5570,-1593910
2017-05-22,18.3 ( 3.1 %),1052,4688970,4457.2,1399,4852210,3468,-163240
2017-05-19,17.75 ( 3.2 %),995,5761420,5790.37,1525,5911620,3876,-150200
2017-05-18,17.2 ( 3.93 %),1283,7120430,5549.83,1580,6943310,4394,177120
2017-05-17,16.55 ( 0.3 %),400,2208800,5522,418,1986680,4753,222120
2017-05-16,16.5 ( 0 %),489,3098420,6336.24,564,2533900,4493,564520
2017-05-15,16.5 ( -1.2 %),590,3127590,5301,543,2675760,4928,451830
2017-05-12,16.7 ( -1.18 %),415,2320020,5590.41,497,2121340,4268,198680
2017-05-11,16.9 ( 0 %),362,2537200,7008.84,534,1986470,3720,550730
2017-05-10,16.9 ( 1.5 %),813,4382260,5390.23,1262,5611930,4447,-1229670
2017-05-09,16.65 ( 1.52 %),505,2715990,5378.2,675,2549560,3777,166430
2017-05-08,16.4 ( -1.8 %),463,2891270,6244.64,650,3167150,4873,-275880
2017-05-05,16.7 ( 1.21 %),804,4446290,5530.21,1148,5180310,4512,-734020
2017-05-04,16.5 ( -1.79 %),617,2894200,4690.76,953,4368640,4584,-1474440
2017-05-03,16.8 ( 6.33 %),1236,7358060,5953.12,1445,5885710,4073,1472350
2017-04-28,15.8 ( 3.95 %),647,4999190,7726.72,1101,4021180,3652,978010
2017-04-27,15.2 ( 1 %),423,2535370,5993.78,439,1974650,4498,560720
2017-04-26,15.05 ( 1.01 %),364,1231870,3384.26,297,1330950,4481,-99080
2017-04-25,14.9 ( -0.33 %),264,1048750,3972.54,232,1267730,5464,-218980
2017-04-24,14.95 ( -0.99 %),341,1124390,3297.33,218,1011590,4640,112800
2017-04-21,15.1 ( 0.67 %),302,712920,2360.66,178,676830,3802,36090
2017-04-20,15 ( 0 %),217,851130,3922.26,146,795650,5450,55480
2017-04-19,15 ( -1.32 %),196,840150,4286.48,170,694450,4085,145700
2017-04-18,15.2 ( 0.66 %),239,878250,3674.69,152,819090,5389,59160
2017-04-17,15.1 ( -0.66 %),233,1553630,6667.94,282,1666390,5909,-112760
2017-04-14,15.2 ( -1.94 %),349,1826520,5233.58,240,1849800,7708,-23280
2017-04-13,15.5 ( 0.98 %),186,920550,4949.19,313,1426400,4557,-505850
2017-04-12,15.35 ( -1.92 %),173,977970,5653.01,369,1894480,5134,-916510
2017-04-11,15.65 ( 2.29 %),328,2455530,7486.37,569,2034840,3576,420690
2017-04-10,15.3 ( -0.33 %),159,702950,4421.07,248,787440,3175,-84490
2017-04-07,15.35 ( -0.32 %),189,860570,4553.28,195,842080,4318,18490
2017-04-05,15.4 ( -0.32 %),212,1560630,7361.46,419,1911010,4561,-350380
2017-04-04,15.45 ( 0 %),278,1665630,5991.47,369,1832730,4967,-167100
2017-04-03,15.45 ( 0.65 %),376,2221780,5908.99,236,1557440,6599,664340
2017-03-31,15.35 ( -1.29 %),158,804670,5092.85,309,1424360,4610,-619690
2017-03-30,15.55 ( 1.63 %),206,1749690,8493.64,496,2159210,4353,-409520
2017-03-29,15.3 ( -0.33 %),339,2415290,7124.75,313,1918210,6128,497080
2017-03-28,15.35 ( -0.65 %),236,1546240,6551.86,380,2248880,5918,-702640
2017-03-27,15.45 ( -1.28 %),316,1644850,5205.22,597,2407160,4032,-762310
2017-03-24,15.65 ( 1.62 %),448,3492680,7796.16,983,3945980,4014,-453300
2017-03-23,15.4 ( 0 %),322,3391070,10531.27,608,2869450,4719,521620
2017-03-22,15.4 ( 0 %),354,4140440,11696.16,826,4405240,5333,-264800
2017-03-21,15.4 ( 2.33 %),528,6143810,11636,1107,4958020,4479,1185790
2017-03-20,15.05 ( 3.79 %),594,5252000,8841.75,1289,5067150,3931,184850
2017-03-17,14.5 ( 0 %),168,1184520,7050.71,321,1452360,4524,-267840
2017-03-16,14.5 ( 0 %),188,951380,5060.53,274,1078940,3938,-127560
2017-03-15,14.5 ( -1.02 %),110,556850,5062.27,334,1224230,3665,-667380
2017-03-14,14.65 ( -0.34 %),209,1094650,5237.56,450,1764660,3921,-670010
2017-03-13,14.7 ( 2.08 %),302,1662880,5506.23,562,1675600,2981,-12720
2017-03-10,14.4 ( -1.03 %),326,1781830,5465.74,879,3341290,3801,-1559460
2017-03-09,14.55 ( 3.19 %),445,3228280,7254.56,931,3980070,4275,-751790
2017-03-08,14.1 ( 1.08 %),195,902200,4626.67,199,850940,4276,51260
2017-03-07,13.95 ( 0 %),118,483100,4094.07,139,684920,4927,-201820
2017-03-06,13.95 ( 1.09 %),174,590520,3393.79,194,705990,3639,-115470
2017-03-03,13.8 ( -0.72 %),197,483840,2456.04,121,619220,5118,-135380
2017-03-02,13.9 ( -0.36 %),170,318510,1873.59,133,624760,4697,-306250
2017-03-01,13.95 ( -0.36 %),173,347880,2010.87,190,710950,3742,-363070
2017-02-28,14 ( -0.71 %),175,594440,3396.8,183,889460,4860,-295020
2017-02-27,14.1 ( -0.35 %),141,551660,3912.48,162,677190,4180,-125530
2017-02-24,14.15 ( -0.35 %),158,563060,3563.67,193,797590,4133,-234530
2017-02-23,14.2 ( 1.07 %),276,1265640,4585.65,319,1450250,4546,-184610
2017-02-22,14.65 ( 0 %),172,1163260,6763.14,310,1534780,4951,-371520
2017-02-21,14.65 ( 0 %),166,880230,5302.59,359,1366850,3807,-486620
2017-02-20,14.65 ( -0.68 %),123,742610,6037.48,298,1344600,4512,-601990
2017-02-17,14.75 ( 1.03 %),146,778250,5330.48,280,1153120,4118,-374870
2017-02-16,14.6 ( 0.69 %),383,1878020,4903.45,490,1929660,3938,-51640
2017-02-15,14.5 ( 1.4 %),214,1221060,5705.89,345,958170,2777,262890
2017-02-14,14.3 ( -0.69 %),193,1575830,8164.92,294,1259650,4285,316180
2017-02-13,14.4 ( 1.77 %),268,1432520,5345.22,434,1533860,3534,-101340
2017-02-10,14.15 ( -0.7 %),108,420580,3894.26,238,805320,3384,-384740
2017-02-09,14.25 ( 0.71 %),151,948760,6283.18,228,791560,3472,157200
2017-02-08,14.15 ( 1.07 %),154,946940,6148.96,271,847380,3127,99560
2017-02-07,14 ( -0.71 %),198,1111710,5614.7,299,1262230,4222,-150520
2017-02-06,14.1 ( -0.35 %),148,556010,3756.82,196,756280,3859,-200270
2017-02-03,14.15 ( -0.35 %),155,928090,5987.68,374,1172450,3135,-244360
2017-02-02,14.2 ( 0.35 %),130,642480,4942.15,191,814920,4267,-172440
2017-01-25,14.15 ( 0.35 %),146,1035250,7090.75,184,1010220,5490,25030
2017-01-24,14.1 ( 2.17 %),180,1108360,6157.56,259,999990,3861,108370
2017-01-23,13.8 ( -0.72 %),150,590780,3938.53,207,635820,3072,-45040
2017-01-20,13.9 ( 0 %),185,1356840,7334.27,230,1366820,5943,-9980
2017-01-19,13.9 ( -0.71 %),125,667360,5338.88,180,982130,5456,-314770
2017-01-18,14 ( -1.06 %),188,678180,3607.34,391,1830710,4682,-1152530
2017-01-17,14.15 ( 3.66 %),490,3381740,6901.51,673,4458780,6625,-1077040
2017-01-16,13.65 ( -0.73 %),118,302890,2566.86,160,690810,4318,-387920
2017-01-13,13.75 ( -0.72 %),101,363030,3594.36,214,960080,4486,-597050
2017-01-12,13.85 ( 0.73 %),225,1350920,6004.09,386,1926200,4990,-575280
2017-01-11,13.75 ( 0.36 %),142,670870,4724.44,200,907390,4537,-236520
2017-01-10,13.7 ( 0 %),122,660330,5412.54,186,787040,4231,-126710
2017-01-09,13.7 ( -0.36 %),128,646800,5053.12,223,705830,3165,-59030
2017-01-06,13.75 ( 1.85 %),241,1849020,7672.28,257,1565890,6093,283130
2017-01-05,13.5 ( -0.74 %),181,911590,5036.41,159,735630,4627,175960
2017-01-04,13.6 ( -1.09 %),157,736750,4692.68,219,1263670,5770,-526920
2017-01-03,13.75 ( -1.79 %),202,1015620,5027.82,265,950530,3587,65090
2016-12-30,14 ( 4.48 %),105,2048960,19513.9,124,1664960,13427,384000
2016-12-29,13.4 ( 0.75 %),104,510720,4910.77,143,449340,3142,61380
2016-12-28,13.3 ( 0.38 %),107,706120,6599.25,152,665850,4381,40270
2016-12-27,13.25 ( 0.76 %),105,459240,4373.71,115,486240,4228,-27000
2016-12-26,13.15 ( -0.38 %),91,309170,3397.47,115,497870,4329,-188700
2016-12-23,13.2 ( -0.38 %),77,255030,3312.08,86,384990,4477,-129960
2016-12-22,13.25 ( -0.38 %),83,433270,5220.12,117,518320,4430,-85050
2016-12-21,13.3 ( 0 %),85,417830,4915.65,110,330210,3002,87620
2016-12-20,13.3 ( 0.38 %),109,406110,3725.78,134,291700,2177,114410
2016-12-19,13.25 ( 0.76 %),102,581980,5705.69,179,584940,3268,-2960
2016-12-16,13.15 ( 0 %),95,353330,3719.26,116,392030,3380,-38700
2016-12-15,13.15 ( -0.38 %),86,313830,3649.19,109,357390,3279,-43560
2016-12-14,13.2 ( 0 %),98,462550,4719.9,121,384200,3175,78350
2016-12-13,13.2 ( 0 %),82,381310,4650.12,119,426180,3581,-44870
2016-12-12,13.2 ( -0.75 %),122,355590,2914.67,127,315980,2488,39610
2016-12-09,13.3 ( 1.14 %),112,331670,2961.34,128,348010,2719,-16340
2016-12-08,13.15 ( 0 %),123,270590,2199.92,125,380300,3042,-109710
2016-12-07,13.15 ( -1.13 %),115,283640,2466.43,137,335960,2452,-52320
2016-12-06,13.3 ( 0.76 %),144,441570,3066.46,142,281490,1982,160080
2016-12-05,13.2 ( -0.75 %),244,650410,2665.61,160,439910,2749,210500
2016-12-02,13.3 ( 0.38 %),111,200740,1808.47,73,159180,2181,41560
2016-12-01,13.25 ( -0.75 %),146,357950,2451.71,110,298290,2712,59660
2016-11-30,13.35 ( 0.38 %),105,189990,1809.43,110,221270,2012,-31280
2016-11-29,13.3 ( 0.76 %),134,265080,1978.21,94,156830,1668,108250
2016-11-28,13.2 ( -1.12 %),169,404090,2391.07,81,356740,4404,47350
2016-11-25,13.35 ( -0.74 %),161,307790,1911.74,101,385160,3813,-77370
2016-11-24,13.45 ( 0 %),202,1060500,5250,97,500960,5165,559540
2016-11-23,13.45 ( 0.37 %),197,1061280,5387.21,95,516250,5434,545030
2016-11-22,13.4 ( 0 %),220,636920,2895.09,124,439750,3546,197170
2016-11-21,13.4 ( -0.74 %),170,436060,2565.06,123,557280,4531,-121220
2016-11-18,13.5 ( -0.37 %),183,449960,2458.8,91,383250,4212,66710
2016-11-17,13.55 ( -0.37 %),172,392560,2282.33,104,353720,3401,38840
2016-11-16,13.6 ( -0.73 %),174,485620,2790.92,88,342730,3895,142890
2016-11-15,13.7 ( -0.36 %),142,355400,2502.82,134,402900,3007,-47500
2016-11-14,13.75 ( -0.36 %),140,325390,2324.21,138,556790,4035,-231400
2016-11-11,13.8 ( -0.36 %),102,164040,1608.24,111,293200,2641,-129160
2016-11-10,13.85 ( 0.36 %),178,597630,3357.47,99,554370,5600,43260
2016-11-09,13.8 ( -1.43 %),280,975290,3483.18,123,479830,3901,495460
2016-11-08,14 ( 0.36 %),92,218610,2376.2,104,305820,2941,-87210
2016-11-07,13.95 ( 0.36 %),135,355500,2633.33,77,225030,2922,130470
2016-11-04,13.9 ( -1.07 %),165,471080,2855.03,106,494520,4665,-23440
2016-11-03,14.05 ( -1.06 %),105,238870,2274.95,112,292050,2608,-53180
2016-11-02,14.2 ( -0.7 %),80,295510,3693.88,119,502060,4219,-206550
2016-11-01,14.3 ( 0 %),69,311190,4510,100,254300,2543,56890
2016-10-31,14.3 ( 0.35 %),92,649300,7057.61,123,759040,6171,-109740
2016-10-28,14.25 ( 0 %),92,555780,6041.09,122,455880,3737,99900
2016-10-27,14.25 ( 0 %),114,372120,3264.21,130,502450,3865,-130330
2016-10-26,14.25 ( -0.35 %),76,252570,3323.29,148,524890,3547,-272320
2016-10-25,14.3 ( -0.35 %),123,518640,4216.59,122,432640,3546,86000
2016-10-24,14.35 ( 0.78 %),232,1050810,4529.35,187,1296710,6934,-245900
2016-10-21,14.95 ( -0.33 %),110,432830,3934.82,202,798700,3954,-365870
2016-10-20,15 ( 0 %),96,535430,5577.4,225,968100,4303,-432670
2016-10-19,15 ( 0 %),166,942160,5675.66,302,1044890,3460,-102730
2016-10-18,15 ( 0 %),100,507370,5073.7,223,535220,2400,-27850
2016-10-17,15 ( 1.01 %),159,1098420,6908.3,243,775970,3193,322450
2016-10-14,14.85 ( 0.34 %),200,1242470,6212.35,330,1619010,4906,-376540
2016-10-13,14.8 ( 0 %),113,584810,5175.31,167,1034100,6192,-449290
2016-10-12,14.8 ( 0 %),135,813900,6028.89,203,826700,4072,-12800
2016-10-11,14.8 ( -0.34 %),132,572410,4336.44,195,761590,3906,-189180
2016-10-10,14.85 ( -0.67 %),72,451470,6270.42,256,812700,3175,-361230
2016-10-07,14.95 ( 0.34 %),104,869930,8364.71,344,1148110,3338,-278180
2016-10-06,14.9 ( 1.02 %),132,859700,6512.88,278,1026900,3694,-167200
2016-10-05,14.75 ( 0 %),85,653720,7690.82,272,902590,3318,-248870
2016-10-04,14.75 ( -0.34 %),118,652710,5531.44,282,1035120,3671,-382410
2016-10-03,14.8 ( -0.67 %),114,657200,5764.91,123,753190,6123,-95990
2016-09-30,14.9 ( 0.68 %),55,301240,5477.09,80,224230,2803,77010
2016-09-29,14.8 ( 0.68 %),92,303050,3294.02,127,396880,3125,-93830
2016-09-28,14.7 ( 0 %),201,1205570,5997.86,115,1169920,10173,35650
2016-09-27,14.7 ( -0.34 %),98,646200,6593.88,119,627380,5272,18820
2016-09-26,14.75 ( 0 %),69,349640,5067.25,87,302190,3473,47450
2016-09-23,14.75 ( 0 %),92,521580,5669.35,78,383310,4914,138270
2016-09-22,14.75 ( 0.34 %),121,738640,6104.46,100,542340,5423,196300
2016-09-21,14.7 ( -0.34 %),98,424470,4331.33,92,387140,4208,37330
2016-09-20,14.75 ( 0 %),95,307120,3232.84,81,322810,3985,-15690
2016-09-19,14.75 ( 0 %),54,343850,6367.59,99,558560,5642,-214710
2016-09-16,14.75 ( -0.67 %),62,293960,4741.29,109,499900,4586,-205940
2016-09-15,14.85 ( 0.34 %),51,372620,7306.27,99,501610,5067,-128990
2016-09-14,14.8 ( -0.34 %),61,361640,5928.52,84,365450,4351,-3810
2016-09-13,14.85 ( -0.34 %),69,324550,4703.62,90,388270,4314,-63720
2016-09-12,14.9 ( 0 %),73,461040,6315.62,108,458300,4244,2740
2016-09-09,14.9 ( 0 %),100,594980,5949.8,123,427540,3476,167440
2016-09-08,14.9 ( 0.68 %),96,413240,4304.58,128,385790,3014,27450
2016-09-07,14.8 ( 0.68 %),107,255740,2390.09,88,256090,2910,-350
2016-09-06,14.7 ( 0 %),118,314560,2665.76,105,406770,3874,-92210
2016-09-05,14.7 ( -0.68 %),108,297600,2755.56,102,361070,3540,-63470
2016-09-01,14.8 ( 0 %),93,342690,3684.84,98,361720,3691,-19030
2016-08-31,14.8 ( 0 %),90,298670,3318.56,102,404580,3966,-105910
2016-08-30,14.8 ( 0 %),69,319920,4636.52,131,543020,4145,-223100
2016-08-29,14.8 ( -0.67 %),96,333550,3474.48,120,486850,4057,-153300
2016-08-26,14.9 ( 0 %),127,420490,3310.94,125,415750,3326,4740
2016-08-25,14.9 ( 0.68 %),103,357950,3475.24,88,264070,3001,93880
2016-08-24,14.8 ( 0 %),124,513850,4143.95,112,354860,3168,158990
2016-08-23,14.8 ( 0 %),95,328400,3456.84,87,241300,2774,87100
2016-08-22,14.8 ( 0 %),98,383090,3909.08,92,342080,3718,41010
2016-08-19,14.8 ( -0.67 %),107,388980,3635.33,133,355730,2675,33250
2016-08-18,14.9 ( 0 %),146,674200,4617.81,145,642560,4431,31640
2016-08-17,14.9 ( 0.68 %),139,551760,3969.5,137,512470,3741,39290
2016-08-16,14.8 ( -0.67 %),121,338150,2794.63,118,404610,3429,-66460
2016-08-15,14.9 ( 0 %),115,364310,3167.91,106,327420,3089,36890
2016-08-12,14.9 ( -0.67 %),77,236070,3065.84,167,392690,2351,-156620
2016-08-11,15 ( 0.67 %),106,500060,4717.55,121,402870,3330,97190
2016-08-10,14.9 ( 0.68 %),131,491310,3750.46,127,390860,3078,100450
2016-08-09,14.8 ( 0 %),122,387630,3177.3,110,418810,3807,-31180
2016-08-08,14.8 ( 0 %),84,356010,4238.21,83,299600,3610,56410
2016-08-05,14.8 ( 0 %),136,561900,4131.62,119,498900,4192,63000
2016-08-04,14.8 ( -0.67 %),211,693320,3285.88,145,736120,5077,-42800
2016-08-03,14.9 ( 0 %),116,437550,3771.98,141,402010,2851,35540
2016-08-02,14.9 ( -0.67 %),139,375890,2704.24,128,523990,4094,-148100
2016-08-01,15 ( 0 %),148,615850,4161.15,138,811270,5879,-195420
2016-07-29,15 ( -0.66 %),185,665620,3597.95,170,841160,4948,-175540
2016-07-28,15.1 ( -0.66 %),131,611730,4669.69,132,541850,4105,69880
2016-07-27,15.2 ( 0.66 %),144,489000,3395.83,190,724040,3811,-235040
2016-07-26,15.1 ( 0.67 %),111,602670,5429.46,201,704150,3503,-101480
2016-07-25,15 ( -1.32 %),144,630940,4381.53,150,682760,4552,-51820
2016-07-22,15.2 ( 0 %),186,1000200,5377.42,214,912880,4266,87320
2016-07-21,15.2 ( 0.66 %),187,1011320,5408.13,187,621930,3326,389390
2016-07-20,15.1 ( -0.66 %),170,812070,4776.88,204,610300,2992,201770
2016-07-19,15.2 ( -1.94 %),262,970210,3703.09,309,1035570,3351,-65360
2016-07-18,15.5 ( 0 %),149,716100,4806.04,343,912160,2659,-196060
2016-07-15,15.5 ( 0 %),121,507870,4197.27,354,770770,2177,-262900
2016-07-14,15.5 ( 1.31 %),330,1694370,5134.45,680,2359620,3470,-665250
2016-07-13,15.3 ( 2 %),327,1468830,4491.83,255,1124710,4411,344120
2016-07-12,15 ( -1.32 %),117,879080,7513.5,223,1089170,4884,-210090
2016-07-11,15.2 ( 0.66 %),130,830400,6387.69,197,755520,3835,74880
2016-07-08,15.1 ( 0 %),139,731550,5262.95,248,785250,3166,-53700
2016-07-07,15.1 ( 0 %),130,809300,6225.38,215,715710,3329,93590
2016-07-06,15.1 ( -0.66 %),104,708930,6816.63,164,509700,3108,199230
2016-07-05,15.2 ( 1.33 %),192,1584790,8254.11,360,1213950,3372,370840
2016-07-04,15 ( 0 %),184,1470410,7991.36,263,1443930,5490,26480
2016-07-01,15 ( 0.67 %),148,810090,5473.58,137,801410,5850,8680
2016-06-30,14.9 ( -0.67 %),143,784070,5483.01,155,719070,4639,65000
2016-06-29,15 ( 0.67 %),160,906010,5662.56,173,776860,4491,129150
2016-06-28,14.9 ( 0 %),192,1217190,6339.53,105,446740,4255,770450
2016-06-27,14.9 ( 0 %),290,1979010,6824.17,166,704030,4241,1274980
2016-06-24,14.9 ( -0.67 %),422,2574860,6101.56,352,1811110,5145,763750
2016-06-23,15 ( 0 %),151,616970,4085.89,144,627080,4355,-10110
2016-06-22,15 ( -0.66 %),183,595040,3251.58,183,856190,4679,-261150
2016-06-21,15.1 ( 0 %),139,346360,2491.8,176,647060,3676,-300700
2016-06-20,15.1 ( -0.66 %),140,334050,2386.07,166,725290,4369,-391240
2016-06-17,15.2 ( 0 %),183,751060,4104.15,217,1046780,4824,-295720
2016-06-16,15.2 ( -0.65 %),180,664070,3689.28,201,954380,4748,-290310
2016-06-15,15.3 ( 0 %),215,574490,2672.05,194,941520,4853,-367030
2016-06-14,15.3 ( 0 %),161,365860,2272.42,158,555170,3514,-189310
2016-06-13,15.3 ( -0.65 %),155,307550,1984.19,239,2160460,9040,-1852910
2016-06-10,15.4 ( -0.65 %),815,6966410,8547.74,1330,12606870,9479,-5640460
2016-06-09,15.5 ( 0.65 %),327,2676450,8184.86,374,2532220,6771,144230
2016-06-08,15.4 ( -0.65 %),234,1845420,7886.41,494,3715790,7522,-1870370
2016-06-07,15.5 ( 1.31 %),448,2654260,5924.69,400,2841440,7104,-187180
2016-06-06,15.3 ( -0.65 %),262,1859040,7095.57,392,3310810,8446,-1451770
2016-06-03,15.4 ( -1.28 %),221,826930,3741.76,399,3377160,8464,-2550230
2016-06-02,15.6 ( 0 %),377,3880610,10293.4,587,5540450,9439,-1659840
2016-06-01,15.6 ( 0 %),343,3691290,10761.78,761,6585580,8654,-2894290
2016-05-31,15.6 ( 0 %),206,1284900,6237.38,509,2592700,5094,-1307800
2016-05-30,15.6 ( 1.3 %),330,2531210,7670.33,673,3725990,5536,-1194780
2016-05-27,15.4 ( 0.65 %),307,2795430,9105.64,529,3611010,6826,-815580
2016-05-26,15.3 ( 0.66 %),292,1582460,5419.38,412,2173520,5276,-591060
2016-05-25,15.2 ( -1.94 %),231,866090,3749.31,459,2459110,5358,-1593020
2016-05-24,15.5 ( 0.65 %),400,3663810,9159.52,624,4312520,6911,-648710
2016-05-23,15.4 ( -1.91 %),390,2010600,5155.38,873,5764930,6604,-3754330
2016-05-20,15.7 ( 0.64 %),771,6634610,8605.2,1439,9414950,6543,-2780340
2016-05-19,15.6 ( 1.96 %),918,7829310,8528.66,1300,7292640,5610,536670
2016-05-18,15.3 ( 2 %),724,5030720,6948.51,1029,5815960,5652,-785240
2016-05-17,15 ( 0 %),238,1387390,5829.37,273,1401310,5133,-13920
2016-05-16,15 ( -0.66 %),168,828970,4934.35,257,1435510,5586,-606540
2016-05-13,15.1 ( 0 %),175,949750,5427.14,296,1461170,4936,-511420
2016-05-12,15.1 ( -1.31 %),178,749830,4212.53,435,2074020,4768,-1324190
2016-05-11,15.3 ( 0.66 %),249,2153280,8647.71,465,1902380,4091,250900
2016-05-10,15.2 ( -0.65 %),236,1670350,7077.75,496,2071420,4176,-401070
2016-05-09,15.3 ( 0 %),276,2312240,8377.68,658,3173280,4823,-861040
2016-05-06,15.3 ( 1.32 %),388,3736440,9630,710,3236970,4559,499470
2016-05-05,15.1 ( 0 %),221,1920240,8688.87,439,2088880,4758,-168640
2016-05-04,15.1 ( 0 %),332,3084580,9290.9,513,2606720,5081,477860
2016-04-29,15.1 ( 2.03 %),501,3689900,7365.07,885,4909880,5548,-1219980
2016-04-28,14.8 ( 0.68 %),277,1485200,5361.73,348,1833160,5268,-347960
2016-04-27,14.7 ( -1.34 %),422,2114240,5010.05,464,3134670,6756,-1020430
2016-04-26,14.9 ( 0 %),177,1301240,7351.64,453,2723390,6012,-1422150
2016-04-25,14.9 ( 0 %),272,1959370,7203.57,531,2984120,5620,-1024750
2016-04-22,14.9 ( 2.05 %),281,2536850,9027.94,536,2944280,5493,-407430
2016-04-21,14.6 ( 0.69 %),167,1200580,7189.1,290,1533370,5287,-332790
2016-04-20,14.5 ( 0.69 %),161,1116730,6936.21,223,1602320,7185,-485590
2016-04-19,14.4 ( 0.7 %),243,924240,3803.46,253,1449470,5729,-525230
2016-04-15,14.3 ( -1.38 %),98,368670,3761.94,227,1246930,5493,-878260
2016-04-14,14.5 ( 0.69 %),165,894510,5421.27,239,1338950,5602,-444440
2016-04-13,14.4 ( 0 %),235,1606710,6837.06,231,1097630,4752,509080
2016-04-12,14.4 ( -0.69 %),198,1227400,6198.99,299,1277050,4271,-49650
2016-04-11,14.5 ( 0.69 %),140,783960,5599.71,216,864120,4001,-80160
2016-04-08,14.4 ( -0.69 %),217,1484900,6842.86,286,1511850,5286,-26950
2016-04-07,14.5 ( 0 %),222,1528550,6885.36,309,1713090,5544,-184540
2016-04-06,14.5 ( 2.11 %),312,2383180,7638.4,287,1504060,5241,879120
2016-04-05,14.2 ( 0.71 %),367,1980910,5397.57,231,1640140,7100,340770
2016-04-04,14.1 ( 0 %),298,917060,3077.38,186,805530,4331,111530
2016-04-01,14.1 ( -1.4 %),315,1250580,3970.1,240,1864390,7768,-613810
2016-03-31,14.3 ( -0.69 %),260,1307620,5029.31,285,1705080,5983,-397460
2016-03-30,14.4 ( -0.69 %),230,1608200,6992.17,295,2068850,7013,-460650
2016-03-29,14.5 ( -0.68 %),201,1290680,6421.29,257,1460170,5682,-169490
2016-03-28,14.6 ( 0 %),224,1892270,8447.63,259,1851710,7149,40560
2016-03-25,14.6 ( 0.69 %),322,2988480,9280.99,365,2561100,7017,427380
2016-03-24,14.5 ( -0.68 %),247,1954430,7912.67,348,2352250,6759,-397820
2016-03-23,14.6 ( 0 %),171,1117080,6532.63,298,1747890,5865,-630810
2016-03-22,14.6 ( -0.68 %),227,1750560,7711.72,399,3083920,7729,-1333360
2016-03-21,14.7 ( -0.68 %),294,1703590,5794.52,415,3083530,7430,-1379940
2016-03-18,14.8 ( 0 %),181,912050,5038.95,350,2212050,6320,-1300000
2016-03-17,14.8 ( 0.68 %),388,2600830,6703.17,423,3321770,7853,-720940
2016-03-16,14.7 ( 0 %),341,1932610,5667.48,307,2720940,8863,-788330
2016-03-15,14.7 ( 0 %),471,2633490,5591.27,430,3871320,9003,-1237830
2016-03-14,14.7 ( -1.34 %),397,1876890,4727.68,513,4295140,8373,-2418250
2016-03-11,14.9 ( -0.67 %),284,1418510,4994.75,448,2987130,6668,-1568620
2016-03-10,15 ( 0.67 %),269,2217680,8244.16,404,2510950,6215,-293270
2016-03-09,14.9 ( 0.68 %),394,4034680,10240.3,502,4328470,8622,-293790
2016-03-08,14.8 ( 0 %),396,1911550,4827.15,321,2350940,7324,-439390
2016-03-07,14.8 ( -1.33 %),402,2221800,5526.87,538,4209670,7825,-1987870
2016-03-04,15 ( 0 %),423,3709960,8770.59,674,5165220,7664,-1455260
2016-03-03,15 ( 0 %),313,2748270,8780.42,645,4423080,6857,-1674810
2016-03-02,15 ( -0.66 %),473,4457590,9424.08,856,7158080,8362,-2700490
2016-03-01,15.1 ( 3.42 %),620,5322880,8585.29,663,4947330,7462,375550
2016-02-29,14.6 ( -2.67 %),553,2744230,4962.44,553,4172400,7545,-1428170
2016-02-26,15 ( -0.66 %),597,3370600,5645.9,679,5359050,7893,-1988450
2016-02-25,15.1 ( -1.31 %),416,2827530,6796.95,1063,7547580,7100,-4720050
2016-02-24,15.3 ( 0 %),900,8637110,9596.79,1441,12690810,8807,-4053700
2016-02-23,15.3 ( -1.29 %),655,8193960,12509.86,1766,14598290,8266,-6404330
2016-02-22,15.5 ( 0 %),974,10691070,10976.46,2089,19014180,9102,-8323110
2016-02-19,15.5 ( 4.03 %),2186,25480050,11656.02,3433,32308530,9411,-6828480
2016-02-18,14.9 ( 0 %),466,4925070,10568.82,1232,9511860,7721,-4586790
2016-02-17,14.9 ( -0.67 %),257,2671340,10394.32,640,3370010,5266,-698670
2016-02-16,15 ( 0 %),265,2191500,8269.81,574,3011560,5247,-820060
2016-02-15,15 ( 2.04 %),634,6176900,9742.74,933,5807460,6225,369440
2016-02-05,14.7 ( 1.38 %),370,3562150,9627.43,749,4021510,5369,-459360
2016-02-04,14.5 ( 1.4 %),221,2069470,9364.12,415,1687580,4066,381890
2016-02-03,14.3 ( -0.69 %),136,1011390,7436.69,244,1418150,5812,-406760
2016-02-02,14.4 ( 0 %),252,2330870,9249.48,318,1915510,6024,415360
2016-02-01,14.4 ( 0 %),281,2925990,10412.78,552,3162110,5728,-236120
2016-01-29,14.4 ( -0.69 %),189,1622030,8582.17,593,3442590,5805,-1820560
2016-01-28,14.5 ( 2.11 %),532,5615440,10555.34,1154,5231820,4534,383620
2016-01-27,14.2 ( 0.71 %),297,2597270,8745.02,570,2672030,4688,-74760
2016-01-26,14.1 ( -0.7 %),397,3620280,9119.09,681,4385450,6440,-765170
2016-01-25,14.2 ( 4.41 %),416,4074270,9793.92,578,3108260,5378,966010
2016-01-22,13.6 ( 2.26 %),353,2498870,7078.95,359,1842170,5131,656700
2016-01-21,13.3 ( -0.75 %),398,2174260,5462.96,273,1827740,6695,346520
2016-01-20,13.4 ( -0.74 %),295,1777490,6025.39,285,1745250,6124,32240
2016-01-19,13.5 ( 1.5 %),435,1951150,4485.4,246,1560600,6344,390550
2016-01-18,13.3 ( -2.92 %),613,2592540,4229.27,466,3077980,6605,-485440
2016-01-15,13.7 ( -0.72 %),202,551930,2732.33,230,1532810,6664,-980880
2016-01-14,13.8 ( 0 %),244,777000,3184.43,263,2062440,7842,-1285440
2016-01-13,13.8 ( -0.72 %),215,953510,4434.93,266,1856910,6981,-903400
2016-01-12,13.9 ( 1.46 %),272,1342220,4934.63,256,1513340,5911,-171120
2016-01-11,13.7 ( -0.72 %),269,763840,2839.55,222,1618800,7292,-854960
2016-01-08,13.8 ( -0.72 %),388,1312490,3382.71,341,2534570,7433,-1222080
2016-01-07,13.9 ( -1.42 %),319,1092500,3424.76,358,1809840,5055,-717340
2016-01-06,14.1 ( 0.71 %),214,663010,3098.18,273,1442700,5285,-779690
2016-01-05,14 ( -0.71 %),221,807780,3655.11,359,1357410,3781,-549630
2016-01-04,14.1 ( -3.42 %),344,1330500,3867.73,536,2984370,5568,-1653870
2015-12-31,14.6 ( 4.29 %),422,4377970,10374.34,467,4717420,10102,-339450
2015-12-30,14 ( 0 %),283,1217100,4300.71,307,1711310,5574,-494210
2015-12-29,14 ( 0 %),254,1358930,5350.12,204,1224490,6002,134440
2015-12-28,14 ( 0 %),216,846000,3916.67,230,1094960,4761,-248960
2015-12-25,14 ( 0 %),166,714260,4302.77,210,943670,4494,-229410
2015-12-24,14 ( 0 %),157,707230,4504.65,203,964510,4751,-257280
2015-12-23,14 ( 0 %),208,1122300,5395.67,250,1367050,5468,-244750
2015-12-22,14 ( 0 %),211,1168850,5539.57,260,1434070,5516,-265220
2015-12-21,14 ( -0.71 %),185,1329440,7186.16,320,1896670,5927,-567230
2015-12-18,14.1 ( -0.7 %),174,711810,4090.86,247,1344730,5444,-632920
2015-12-17,14.2 ( 0.71 %),325,2823950,8689.08,348,1685390,4843,1138560
2015-12-16,14.1 ( 0 %),223,1228210,5507.67,294,1155090,3929,73120
2015-12-15,14.1 ( -0.7 %),182,1319970,7252.58,265,1490650,5625,-170680
2015-12-14,14.2 ( 1.43 %),235,1912240,8137.19,305,2585930,8478,-673690
2015-12-11,14 ( 0 %),248,1331650,5369.56,206,1113580,5406,218070
2015-12-10,14 ( 0 %),232,1084370,4674.01,207,970230,4687,114140
2015-12-09,14 ( -0.71 %),280,1632980,5832.07,302,2560160,8477,-927180
2015-12-08,14.1 ( 0 %),441,2707730,6139.98,435,5098000,11720,-2390270
2015-12-07,14.1 ( -0.7 %),236,954350,4043.86,238,1332920,5601,-378570
2015-12-04,14.2 ( -0.7 %),319,1406000,4407.52,299,1741630,5825,-335630
2015-12-03,14.3 ( 0 %),181,939360,5189.83,193,1010540,5236,-71180
2015-12-02,14.3 ( 0.7 %),251,1285550,5121.71,203,886250,4366,399300
2015-12-01,14.2 ( 0.71 %),373,2747280,7365.36,304,1165950,3835,1581330
2015-11-30,14.1 ( -1.4 %),313,1789500,5717.25,336,1791120,5331,-1620
2015-11-27,14.3 ( -0.69 %),278,2024630,7282.84,458,2425260,5295,-400630
2015-11-26,14.4 ( 0 %),289,1374780,4757.02,376,2144750,5704,-769970
2015-11-25,14.4 ( 0 %),353,2063870,5846.66,431,2216840,5143,-152970
2015-11-24,14.4 ( -1.37 %),334,1523320,4560.84,494,3065880,6206,-1542560
2015-11-23,14.6 ( 0 %),346,1942470,5614.08,549,3346920,6096,-1404450
2015-11-20,14.6 ( -0.68 %),273,1688410,6184.65,573,2937420,5126,-1249010
2015-11-19,14.7 ( -0.68 %),241,1737480,7209.46,747,4251270,5691,-2513790
2015-11-18,14.8 ( 1.37 %),354,2791020,7884.24,745,5079360,6818,-2288340
2015-11-17,14.6 ( -1.35 %),307,2141120,6974.33,719,4000850,5564,-1859730
2015-11-16,14.8 ( -0.67 %),400,3097440,7743.6,1055,6206330,5883,-3108890
2015-11-13,14.9 ( 2.05 %),814,6955950,8545.39,1584,7349170,4640,-393220
2015-11-12,14.6 ( 1.39 %),586,5897200,10063.48,1092,5344860,4895,552340
2015-11-11,14.4 ( 0.7 %),506,4098680,8100.16,765,3937210,5147,161470
2015-11-10,14.3 ( -1.38 %),393,2913630,7413.82,749,2976950,3975,-63320
2015-11-09,14.5 ( 2.11 %),536,4712970,8792.85,766,3139160,4098,1573810
2015-11-06,14.2 ( 0 %),424,2196980,5181.56,471,1765880,3749,431100
2015-11-05,14.2 ( 0 %),429,2129330,4963.47,472,1882670,3989,246660
2015-11-04,14.2 ( -1.39 %),380,2315060,6092.26,734,3163150,4309,-848090
2015-11-03,14.4 ( 0 %),524,5112120,9755.95,659,2848630,4323,2263490
2015-11-02,14.4 ( 0 %),495,3685850,7446.16,809,3709940,4586,-24090
2015-10-30,14.4 ( 2.86 %),1049,6978180,6652.22,883,3698580,4189,3279600
2015-10-29,14 ( 0 %),772,3278490,4246.75,534,2387920,4472,890570
2015-10-28,14 ( -0.71 %),635,2291450,3608.58,445,1847060,4151,444390
2015-10-27,14.1 ( -0.7 %),819,3071340,3750.11,543,3303830,6084,-232490
2015-10-26,14.2 ( -1.39 %),687,2782190,4049.77,594,2995690,5043,-213500
2015-10-23,14.4 ( 0.7 %),679,3412230,5025.38,560,2181780,3896,1230450
2015-10-22,14.3 ( 0.7 %),958,4431800,4626.1,475,2819140,5935,1612660
2015-10-21,14.2 ( -1.39 %),1180,3605280,3055.32,650,4252450,6542,-647170
2015-10-20,14.4 ( -1.37 %),969,3835210,3957.91,640,3536610,5526,298600
2015-10-19,14.6 ( -0.68 %),775,2884330,3721.72,631,4082290,6470,-1197960
2015-10-16,14.7 ( 0 %),1130,5281550,4673.94,794,4546950,5727,734600
2015-10-15,14.7 ( 0 %),1284,6394430,4980.09,880,5626770,6394,767660
2015-10-14,14.7 ( -0.68 %),795,2927030,3681.8,645,3749430,5813,-822400
2015-10-13,14.8 ( 0 %),1160,6113580,5270.33,815,4091000,5020,2022580
2015-10-12,14.8 ( -0.67 %),1545,7089980,4588.98,1174,5175790,4409,1914190
2015-10-09,14.9 ( -1.32 %),1452,5307280,3655.15,949,7096300,7478,-1789020
2015-10-08,15.1 ( -1.95 %),2899,17724350,6113.95,1856,18620040,10032,-895690
2015-10-07,15.4 ( -0.65 %),518,3596380,6942.82,988,5321080,5386,-1724700
2015-10-06,15.5 ( 1.97 %),977,8839570,9047.67,1281,6818480,5323,2021090
2015-10-05,15.2 ( 0.66 %),616,5712710,9273.88,894,5978820,6688,-266110
2015-10-02,15.1 ( -0.66 %),447,2861080,6400.63,702,3989890,5684,-1128810
2015-10-01,15.2 ( 1.33 %),1046,5996490,5732.78,1258,7340480,5835,-1343990
2015-09-30,15 ( 0 %),458,2422470,5289.24,733,5047550,6886,-2625080
2015-09-29,15 ( 0 %),824,5318500,6454.49,639,4432190,6936,886310
2015-09-28,15 ( -1.32 %),506,2800640,5534.86,609,3939010,6468,-1138370
2015-09-25,15.2 ( -1.3 %),408,3077460,7542.79,706,4058980,5749,-981520
2015-09-24,15.4 ( 0.65 %),877,7614480,8682.42,1138,6988160,6141,626320
2015-09-23,15.3 ( 0.66 %),714,5753310,8057.86,975,4757360,4879,995950
2015-09-22,15.2 ( -0.65 %),894,7600820,8502.04,1271,8872980,6981,-1272160
2015-09-21,15.3 ( 2.68 %),1124,8392190,7466.36,1348,9921180,7360,-1528990
2015-09-18,14.9 ( 1.36 %),594,3342620,5627.31,636,3271380,5144,71240
2015-09-17,14.7 ( -0.68 %),523,2714830,5190.88,399,2288860,5736,425970
2015-09-16,14.8 ( -1.33 %),827,3824480,4624.52,688,5490140,7980,-1665660
2015-09-15,15 ( 0 %),908,3784000,4167.4,843,6699340,7947,-2915340
2015-09-14,15.5 ( 1.97 %),1221,7910220,6478.48,1519,8927160,5877,-1016940
2015-09-11,15.2 ( -0.65 %),723,3920420,5422.43,777,4229580,5443,-309160
2015-09-10,15.3 ( 0 %),820,5613030,6845.16,981,5383120,5487,229910
2015-09-09,15.3 ( 2 %),918,5732300,6244.34,1117,6613370,5921,-881070
2015-09-08,15 ( 4.17 %),1419,12601530,8880.57,1607,11296660,7030,1304870
2015-09-07,14.4 ( 0.7 %),560,3913170,6987.8,493,2906220,5895,1006950
2015-09-04,14.3 ( 0.7 %),624,4040310,6474.86,573,3497180,6103,543130
2015-09-03,14.2 ( -1.39 %),581,3454830,5946.35,485,3139870,6474,314960
2015-09-01,14.4 ( 1.41 %),584,4218640,7223.7,649,3665970,5649,552670
2015-08-31,14.2 ( -2.74 %),758,4152490,5478.22,703,4460280,6345,-307790
2015-08-28,14.6 ( 2.82 %),897,7613390,8487.61,830,5628330,6781,1985060
2015-08-27,14.2 ( 0.71 %),1051,5848830,5565.01,782,5447400,6966,401430
2015-08-26,14.1 ( 3.68 %),1232,7718440,6264.97,755,5870370,7775,1848070
2015-08-25,13.6 ( 0.74 %),1501,8323710,5545.44,1002,7387040,7372,936670
2015-08-24,13.5 ( -6.25 %),1353,8036450,5939.73,1381,10115800,7325,-2079350
2015-08-21,14.4 ( -1.37 %),1265,7723900,6105.85,979,7551110,7713,172790
2015-08-20,14.6 ( -2.67 %),629,3378910,5371.88,672,5190270,7724,-1811360
2015-08-19,15 ( 1.35 %),822,5121840,6230.95,658,4641680,7054,480160
2015-08-18,14.8 ( 0.68 %),938,5536100,5902.03,716,4687080,6546,849020
2015-08-17,14.7 ( -1.68 %),1161,6510910,5608.02,1166,9127940,7828,-2617030
2015-08-14,15.4 ( -0.65 %),1206,7660030,6351.6,891,6489670,7284,1170360
2015-08-13,15.5 ( -1.9 %),1328,7301040,5497.77,1217,9936180,8164,-2635140
2015-08-12,15.8 ( -1.86 %),989,5826930,5891.74,1048,8705150,8306,-2878220
2015-08-11,16.1 ( 0 %),1126,9615150,8539.21,1678,10893220,6492,-1278070
2015-08-10,16.1 ( 0.63 %),762,6019580,7899.71,1146,6847330,5975,-827750
2015-08-07,16 ( 0 %),572,3159160,5523.01,986,5335970,5412,-2176810
2015-08-06,16 ( 0.63 %),1924,17564690,9129.26,2983,22769440,7633,-5204750
2015-08-05,15.9 ( 1.92 %),724,5847440,8076.57,871,5478790,6290,368650
2015-08-04,15.6 ( 0.65 %),973,6926060,7118.25,843,5598590,6641,1327470
2015-08-03,15.5 ( -1.9 %),1392,8897310,6391.75,1439,11001080,7645,-2103770
2015-07-31,15.8 ( -0.63 %),797,5105890,6406.39,1127,7448700,6609,-2342810
2015-07-30,15.9 ( 0 %),1031,5938950,5760.38,887,6380260,7193,-441310
2015-07-29,15.9 ( -0.62 %),1275,7974890,6254.82,1113,8031190,7216,-56300
2015-07-28,16 ( -1.23 %),1608,9949080,6187.24,1802,16420330,9112,-6471250
2015-07-27,16.2 ( -0.61 %),1394,8815200,6323.67,1669,11822660,7084,-3007460
2015-07-24,16.3 ( 0.62 %),1512,12825700,8482.61,1799,12645880,7029,179820
2015-07-23,16.2 ( 1.25 %),2689,18959890,7050.91,2456,17753300,7229,1206590
2015-07-22,16 ( 0.63 %),1688,9452740,5599.96,1036,9397740,9071,55000
2015-07-21,15.9 ( 0 %),1449,7484480,5165.27,1234,8620570,6986,-1136090
2015-07-20,15.9 ( -0.62 %),1866,10740480,5755.88,1291,9976430,7728,764050
2015-07-17,16 ( 0.63 %),1477,9696230,6564.81,1191,8084420,6788,1611810
2015-07-16,15.9 ( -1.24 %),2024,11750810,5805.74,1534,9958840,6492,1791970
2015-07-15,16.1 ( -3.59 %),2023,14168230,7003.57,2386,16372780,6862,-2204550
2015-07-14,16.7 ( 0 %),2642,16646290,6300.64,2628,16446490,6258,199800
2015-07-13,16.7 ( 2.45 %),3171,21116840,6659.36,2853,17456040,6118,3660800
2015-07-10,16.3 ( 3.16 %),4276,34655570,8104.67,3578,24315490,6796,10340080
2015-07-09,15.8 ( 0 %),1535,12418750,8090.39,1780,11941330,6709,477420
2015-07-08,15.8 ( 1.94 %),3870,33761880,8724,3979,27597980,6936,6163900
2015-07-07,15.5 ( 0.65 %),1743,11705680,6715.82,1868,13884330,7433,-2178650
2015-07-06,15.4 ( 0 %),1455,8157150,5606.29,1239,8227070,6640,-69920
2015-07-03,15.4 ( 0.65 %),2331,18320980,7859.71,2283,16882980,7395,1438000
2015-07-02,15.3 ( 2.68 %),1475,12624350,8558.88,1174,7884790,6716,4739560
2015-07-01,14.9 ( -1.32 %),1007,5710370,5670.68,909,6458610,7105,-748240
2015-06-30,15.1 ( -2.58 %),1148,7911240,6891.32,1146,8908100,7773,-996860
2015-06-29,15.5 ( 1.97 %),1249,10826710,8668.3,1053,6428510,6105,4398200
2015-06-26,15.2 ( -1.3 %),1339,8102590,6051.22,1175,8789800,7481,-687210
2015-06-25,15.4 ( -1.28 %),1139,7385770,6484.43,1078,6740910,6253,644860
2015-06-24,15.6 ( -1.27 %),991,6680340,6741.01,1359,7160170,5269,-479830
2015-06-23,15.8 ( 0.64 %),1821,11814040,6487.67,2543,13875650,5456,-2061610
2015-06-22,15.7 ( 4.67 %),1689,12903860,7639.94,2373,10280350,4332,2623510
2015-06-19,15 ( -0.66 %),933,7942070,8512.4,1916,9659870,5042,-1717800
2015-06-18,15.1 ( -0.66 %),1037,9806200,9456.32,1566,8845600,5649,960600
2015-06-17,15.2 ( 0.66 %),1273,12224630,9603.01,2091,9636960,4609,2587670
2015-06-16,15.1 ( 2.03 %),2196,14649860,6671.16,3309,16154200,4882,-1504340
2015-06-15,14.8 ( 6.47 %),2062,16314180,7911.82,2222,12388980,5576,3925200
2015-06-12,13.9 ( 0.72 %),430,2718000,6320.93,627,3032880,4837,-314880
2015-06-11,13.8 ( -0.72 %),555,3704050,6673.96,710,3879800,5465,-175750
2015-06-10,13.9 ( 0.72 %),504,3392270,6730.69,459,2434150,5303,958120
2015-06-09,13.8 ( -1.43 %),553,3655250,6609.86,735,4119130,5604,-463880
2015-06-08,14 ( 0.72 %),805,7678820,9538.91,1114,6724160,6036,954660
2015-06-05,13.9 ( 0.72 %),732,5531160,7556.23,785,5221780,6652,309380
2015-06-04,13.8 ( 0 %),667,4042520,6060.75,764,5107620,6685,-1065100
2015-06-03,13.8 ( -0.72 %),614,4098570,6675.2,693,3594050,5186,504520
2015-06-02,13.9 ( -2.11 %),828,5463970,6599,1278,7121090,5572,-1657120
2015-06-01,14.2 ( 2.9 %),1275,10533490,8261.56,1432,8376290,5849,2157200
2015-05-29,13.8 ( -0.72 %),926,6502480,7022.12,1175,7689170,6544,-1186690
2015-05-28,13.9 ( 3.73 %),1563,11362550,7269.71,1541,9620320,6243,1742230
2015-05-27,13.4 ( 0 %),293,2179840,7439.73,261,1350870,5176,828970
2015-05-26,13.4 ( 0.75 %),254,1247040,4909.61,313,1300100,4154,-53060
2015-05-25,13.3 ( -0.75 %),184,1005830,5466.47,260,1422100,5470,-416270
2015-05-22,13.4 ( 0.75 %),214,1157420,5408.5,270,1531330,5672,-373910
2015-05-21,13.3 ( 0.76 %),144,852870,5922.71,274,1517740,5539,-664870
2015-05-20,13.2 ( 1.54 %),262,1420640,5422.29,175,906970,5183,513670
2015-05-19,13 ( 0.78 %),256,1007620,3936.02,149,889180,5968,118440
2015-05-18,12.9 ( -1.53 %),274,1404230,5124.93,210,1113350,5302,290880
2015-05-15,13.1 ( -0.76 %),178,411010,2309.04,146,531000,3637,-119990
2015-05-14,13.2 ( 0 %),219,549120,2507.4,168,542460,3229,6660
2015-05-13,13.2 ( 0.76 %),225,571140,2538.4,160,548930,3431,22210
2015-05-12,13.1 ( -1.5 %),290,948720,3271.45,168,816000,4857,132720
2015-05-11,13.3 ( -1.48 %),192,639320,3329.79,175,853140,4875,-213820
2015-05-08,13.5 ( 0.75 %),204,850920,4171.18,149,759720,5099,91200
2015-05-07,13.4 ( 0 %),223,994530,4459.78,198,1127040,5692,-132510
2015-05-06,13.4 ( -0.74 %),324,1698440,5242.1,248,1753910,7072,-55470
2015-05-05,13.5 ( 0.75 %),363,1992380,5488.65,221,1362940,6167,629440
2015-05-04,13.4 ( -2.9 %),311,1890090,6077.46,327,1845940,5645,44150
2015-04-27,13.8 ( 1.47 %),352,2538020,7210.28,511,2437650,4770,100370
2015-04-24,13.6 ( 0 %),200,1538390,7691.95,247,1709160,6920,-170770
2015-04-23,13.6 ( 0.74 %),213,1443110,6775.16,249,2431840,9766,-988730
2015-04-22,13.5 ( 0 %),292,1864770,6386.2,219,1193800,5451,670970
2015-04-21,13.5 ( -0.74 %),238,1028590,4321.81,220,1142040,5191,-113450
2015-04-20,13.6 ( -0.73 %),300,1254600,4182,199,1672490,8404,-417890
2015-04-17,13.7 ( 0 %),290,1808020,6234.55,272,1666700,6128,141320
2015-04-16,13.7 ( 0 %),355,1938810,5461.44,256,1511740,5905,427070
2015-04-15,13.7 ( 0.74 %),311,1794330,5769.55,240,1339260,5580,455070
2015-04-14,13.6 ( -0.73 %),324,2136650,6594.6,323,2024610,6268,112040
2015-04-13,13.7 ( 0 %),270,1762530,6527.89,269,1705540,6340,56990
2015-04-10,13.7 ( 0 %),325,1967860,6054.95,330,1805300,5471,162560
2015-04-09,13.7 ( 0.74 %),304,2025700,6663.49,216,996240,4612,1029460
2015-04-08,13.6 ( 0 %),273,1656430,6067.51,214,1402910,6556,253520
2015-04-07,13.6 ( 0.74 %),349,2325090,6662.15,226,1806950,7995,518140
2015-04-06,13.5 ( 0 %),277,1608050,5805.23,199,1192200,5991,415850
2015-04-03,13.5 ( -0.74 %),243,1258240,5177.94,231,1455070,6299,-196830
2015-04-02,13.6 ( 0.74 %),379,2116290,5583.88,238,1555510,6536,560780
2015-04-01,13.5 ( -1.46 %),265,1361980,5139.55,319,2081560,6525,-719580
2015-03-31,13.7 ( 0.74 %),253,1269810,5019.01,264,2206920,8360,-937110
2015-03-30,13.6 ( -0.73 %),175,906560,5180.34,275,1599240,5815,-692680
2015-03-27,13.7 ( 0 %),302,1817370,6017.78,321,2478780,7722,-661410
2015-03-26,13.7 ( 0.74 %),304,1766740,5811.64,261,1284630,4922,482110
2015-03-25,13.6 ( 0 %),377,2437060,6464.35,325,2452070,7545,-15010
2015-03-24,13.6 ( -0.73 %),414,2893950,6990.22,346,3055250,8830,-161300
2015-03-23,13.7 ( 0 %),263,1332760,5067.53,306,1939590,6339,-606830
2015-03-20,13.7 ( 0.74 %),401,2149920,5361.4,261,1750210,6706,399710
2015-03-19,13.6 ( -0.73 %),347,2244580,6468.53,273,1618300,5928,626280
2015-03-18,13.7 ( -0.72 %),586,3174980,5418.05,346,2707340,7825,467640
2015-03-17,13.8 ( 0 %),422,2516900,5964.22,374,2718650,7269,-201750
2015-03-16,13.8 ( -0.72 %),400,2640520,6601.3,349,2548520,7302,92000
2015-03-13,13.9 ( 0 %),339,2232040,6584.19,430,2594830,6034,-362790
2015-03-12,13.9 ( 0 %),387,2979440,7698.81,392,2737890,6984,241550
2015-03-11,13.9 ( 0 %),457,2574720,5633.96,351,2112000,6017,462720
2015-03-10,13.9 ( 0 %),415,2571050,6195.3,371,2334160,6292,236890
2015-03-09,13.9 ( -0.71 %),462,3022650,6542.53,515,3119910,6058,-97260
2015-03-06,14 ( 0.72 %),547,3270130,5978.3,428,3204030,7486,66100
2015-03-05,13.9 ( -1.42 %),439,3084970,7027.27,530,3781680,7135,-696710
2015-03-04,14.1 ( 0 %),533,3093480,5803.9,503,3168020,6298,-74540
2015-03-03,14.1 ( 0.71 %),548,3669630,6696.41,509,2890070,5678,779560
2015-03-02,14 ( -0.71 %),532,2999270,5637.73,448,3111500,6945,-112230
2015-02-27,14.1 ( -1.4 %),418,2330070,5574.33,551,3380620,6135,-1050550
2015-02-26,14.3 ( 1.42 %),499,3534200,7082.57,537,2907970,5415,626230
2015-02-25,14.1 ( -0.7 %),700,5016950,7167.07,968,6173780,6378,-1156830
2015-02-24,14.2 ( 2.16 %),496,3606530,7271.23,459,2781250,6059,825280
2015-02-13,13.9 ( -0.71 %),379,2499760,6595.67,425,2417730,5689,82030
2015-02-12,14 ( -0.71 %),411,2745050,6678.95,518,2989670,5772,-244620
2015-02-11,14.1 ( 0.71 %),250,1953640,7814.56,497,2513550,5057,-559910
2015-02-10,14 ( 0.72 %),438,3948030,9013.77,698,3830550,5488,117480
2015-02-09,13.9 ( 0.72 %),507,4475480,8827.38,745,4079630,5476,395850
2015-02-06,13.8 ( 1.47 %),515,3228020,6268,437,2549280,5834,678740
2015-02-05,13.6 ( 0.74 %),583,3483620,5975.33,462,2481440,5371,1002180
2015-02-04,13.5 ( 1.5 %),1242,8042530,6475.47,967,5814530,6013,2228000
2015-02-03,13.3 ( -5 %),1089,6391390,5869.04,1053,8130490,7721,-1739100
2015-02-02,14 ( -1.41 %),878,4908990,5591.1,718,4956850,6904,-47860
2015-01-30,14.2 ( -4.05 %),1239,7740250,6247.18,1087,8939470,8224,-1199220
2015-01-29,14.8 ( -0.67 %),1482,10114020,6824.57,1694,10789400,6369,-675380
2015-01-28,14.9 ( 4.2 %),1857,13316540,7171,2099,13077610,6230,238930
2015-01-27,14.3 ( -2.05 %),1238,9115150,7362.8,1460,10837800,7423,-1722650
2015-01-26,14.6 ( 0 %),567,3573320,6302.15,1188,5251580,4421,-1678260
2015-01-23,14.6 ( 1.39 %),1676,11463110,6839.56,2234,11651540,5216,-188430
2015-01-22,14.4 ( 3.6 %),1311,11172420,8522.06,1374,9350560,6805,1821860
2015-01-21,13.9 ( -1.42 %),524,3515700,6709.35,691,5391400,7802,-1875700
2015-01-20,14.1 ( 0.71 %),825,8254250,10005.15,756,4765080,6303,3489170
2015-01-19,14 ( 0 %),859,5936030,6910.4,931,6860390,7369,-924360
2015-01-16,14 ( -2.1 %),701,4548530,6488.63,887,5955370,6714,-1406840
2015-01-15,14.3 ( 0 %),953,8433890,8849.83,1419,10235710,7213,-1801820
2015-01-14,14.3 ( -1.38 %),881,6438150,7307.78,1292,6942110,5373,-503960
2015-01-13,14.5 ( 2.11 %),1018,8026770,7884.84,1440,7911360,5494,115410
2015-01-12,14.2 ( -0.7 %),1438,8835880,6144.56,1692,10969780,6483,-2133900
2015-01-09,14.3 ( 5.15 %),1607,11701950,7281.86,1859,9649850,5191,2052100
2015-01-08,13.6 ( 0.74 %),416,2702890,6497.33,788,3373560,4281,-670670
2015-01-07,13.5 ( 0.75 %),681,5105130,7496.52,1046,5172050,4945,-66920
2015-01-06,13.4 ( 3.08 %),626,5323860,8504.57,1083,4993380,4611,330480
2015-01-05,13 ( -0.76 %),171,1280950,7490.94,278,1171690,4215,109260
2014-12-31,13.1 ( 2.34 %),281,2231850,7942.53,253,1306760,5165,925090
2014-12-30,12.8 ( 0 %),252,1785070,7083.61,221,1277890,5782,507180
2014-12-29,12.8 ( -0.78 %),164,1290920,7871.46,202,1285520,6364,5400
2014-12-26,12.9 ( -0.77 %),186,1801270,9684.25,192,993460,5174,807810
2014-12-25,13 ( 0 %),230,2913030,12665.35,269,1044520,3883,1868510
2014-12-24,13 ( 0.78 %),267,3166930,11861.16,368,1727040,4693,1439890
2014-12-23,12.9 ( 0.78 %),275,3049530,11089.2,276,1621280,5874,1428250
2014-12-22,12.8 ( 0.79 %),201,1421300,7071.14,158,704180,4457,717120
2014-12-19,12.7 ( -0.78 %),199,1814000,9115.58,205,1143910,5580,670090
2014-12-18,12.8 ( 0.79 %),241,1694460,7030.95,158,811950,5139,882510
2014-12-17,12.7 ( -0.78 %),411,2360530,5743.38,344,2808150,8163,-447620
2014-12-16,12.8 ( -1.54 %),243,1694990,6975.27,264,1782810,6753,-87820
2014-12-15,13 ( 0 %),229,1809360,7901.14,174,1025770,5895,783590
2014-12-12,13 ( -0.76 %),313,2232830,7133.64,264,2066110,7826,166720
2014-12-11,13.1 ( 1.55 %),397,3732140,9400.86,445,2608530,5862,1123610
2014-12-10,12.9 ( 0 %),368,2679430,7281.06,238,1935490,8132,743940
2014-12-09,12.9 ( -1.53 %),358,2095840,5854.3,355,2732170,7696,-636330
2014-12-08,13.1 ( -1.5 %),178,1010940,5679.44,258,1164180,4512,-153240
2014-12-05,13.3 ( 0 %),249,1296650,5207.43,506,2358350,4661,-1061700
2014-12-04,13.3 ( 3.1 %),557,4895020,8788.19,752,3733840,4965,1161180
2014-12-03,12.9 ( 1.57 %),266,1219970,4586.35,260,1271890,4892,-51920
2014-12-02,12.7 ( 0 %),222,640130,2883.47,166,960720,5787,-320590
2014-12-01,12.7 ( -0.78 %),253,691680,2733.91,178,978130,5495,-286450
2014-11-28,12.8 ( 1.59 %),289,1191830,4123.98,171,825360,4827,366470
2014-11-27,12.6 ( -0.79 %),276,941950,3412.86,173,1041950,6023,-100000
2014-11-26,12.7 ( -0.78 %),277,1402900,5064.62,240,1717070,7154,-314170
2014-11-25,12.8 ( 0.79 %),366,1406000,3841.53,161,1200980,7460,205020
2014-11-24,12.7 ( -1.55 %),375,1350040,3600.11,199,1629870,8190,-279830
2014-11-21,12.9 ( 0 %),550,2681520,4875.49,290,2994890,10327,-313370
2014-11-20,12.9 ( -0.77 %),430,2074020,4823.3,263,2505590,9527,-431570
2014-11-19,13 ( -0.76 %),269,1313590,4883.23,282,1939300,6877,-625710
2014-11-18,13.1 ( -0.76 %),237,1109700,4682.28,323,1657500,5132,-547800
2014-11-17,13.2 ( 0 %),298,1838990,6171.11,330,2232840,6766,-393850
2014-11-14,13.2 ( 0 %),257,1976470,7690.54,260,1712750,6588,263720
2014-11-13,13.2 ( 0 %),220,1062900,4831.36,221,1085970,4914,-23070
2014-11-12,13.2 ( 0 %),216,1634710,7568.1,309,1935980,6265,-301270
2014-11-11,13.2 ( 0.76 %),232,1290180,5561.12,275,1595770,5803,-305590
2014-11-10,13.1 ( -0.76 %),215,1163750,5412.79,265,1604090,6053,-440340
2014-11-07,13.2 ( 0.76 %),350,2313630,6610.37,293,1542930,5266,770700
2014-11-06,13.1 ( 0 %),270,1731630,6413.44,210,1338590,6374,393040
2014-11-05,13.1 ( -0.76 %),265,980900,3701.51,201,1326090,6597,-345190
2014-11-04,13.2 ( 0 %),230,816720,3550.96,191,1056920,5534,-240200
2014-11-03,13.2 ( -0.75 %),215,990720,4608,252,1589630,6308,-598910
2014-10-31,13.3 ( 1.53 %),560,3069190,5480.7,239,2396080,10025,673110
2014-10-30,13.1 ( -2.24 %),431,2370780,5500.65,342,3591560,10502,-1220780
2014-10-29,13.4 ( 2.29 %),470,1618480,3443.57,317,2176260,6865,-557780
2014-10-28,13.9 ( 0 %),257,1588580,6181.25,322,1938910,6021,-350330
2014-10-27,13.9 ( 0 %),247,1598420,6471.34,363,2340400,6447,-741980
2014-10-24,13.9 ( 0.72 %),294,2549650,8672.28,277,1853720,6692,695930
2014-10-23,13.8 ( -0.72 %),254,1813300,7138.98,371,2443180,6585,-629880
2014-10-22,13.9 ( 0 %),294,2075370,7059.08,512,2913510,5690,-838140
2014-10-21,13.9 ( 0.72 %),229,1478180,6454.93,387,1902910,4917,-424730
2014-10-20,13.8 ( -1.43 %),258,1571760,6092.09,338,2214220,6551,-642460
2014-10-17,14 ( 0.72 %),415,2822640,6801.54,340,2488790,7320,333850
2014-10-16,13.9 ( -0.71 %),405,2843000,7019.75,503,3574720,7107,-731720
2014-10-15,14 ( 1.45 %),422,3018310,7152.39,420,2432200,5791,586110
2014-10-14,13.8 ( -1.43 %),308,1404930,4561.46,559,2729030,4882,-1324100
2014-10-13,14 ( 2.19 %),968,7905880,8167.23,1130,5977360,5290,1928520
2014-10-10,13.7 ( 0 %),203,1477710,7279.36,247,1288530,5217,189180
2014-10-09,13.7 ( 0 %),268,1556690,5808.54,349,1629480,4669,-72790
2014-10-08,13.7 ( 0 %),317,1965340,6199.81,352,2153440,6118,-188100
2014-10-07,13.7 ( -0.72 %),236,1335350,5658.26,357,1730630,4848,-395280
2014-10-06,13.8 ( 1.47 %),438,3635190,8299.52,456,2292200,5027,1342990
2014-10-03,13.6 ( -0.73 %),272,1917940,7051.25,401,2371790,5915,-453850
2014-10-02,13.7 ( 0.74 %),338,2942560,8705.8,476,2888110,6067,54450
2014-10-01,13.6 ( 0 %),341,1927760,5653.26,310,2119380,6837,-191620
2014-09-30,13.6 ( 0.74 %),207,1511510,7301.98,240,1308950,5454,202560
2014-09-29,13.5 ( -0.74 %),217,1629860,7510.88,279,1856580,6654,-226720
2014-09-26,13.6 ( 0 %),262,2005010,7652.71,307,1400900,4563,604110
2014-09-25,13.6 ( 0 %),218,1723940,7907.98,279,1752460,6281,-28520
2014-09-24,13.6 ( 0.74 %),200,1192150,5960.75,260,1214270,4670,-22120
2014-09-23,13.5 ( 0.75 %),247,1574610,6374.94,283,1359220,4803,215390
2014-09-22,13.4 ( -0.74 %),210,808320,3849.14,253,1074040,4245,-265720
2014-09-19,13.5 ( -0.74 %),255,1437810,5638.47,256,1559690,6093,-121880
2014-09-18,13.6 ( -0.73 %),317,1641090,5176.94,332,2284260,6880,-643170
2014-09-17,13.7 ( 0.74 %),411,3762230,9153.84,393,2814220,7161,948010
2014-09-16,13.6 ( 0 %),0,0,0,0,0,0,0
2014-09-15,13.6 ( -0.73 %),277,1583130,5715.27,324,1959470,6048,-376340
2014-09-12,13.7 ( 0 %),351,2641250,7524.93,330,2346760,7111,294490
2014-09-11,13.7 ( 0 %),312,1637530,5248.49,221,1397670,6324,239860
2014-09-10,13.7 ( -1.44 %),583,3652910,6265.71,436,3459090,7934,193820
2014-09-09,13.9 ( -1.42 %),624,5835910,9352.42,817,6012220,7359,-176310
2014-09-08,14.1 ( -0.7 %),435,3618540,8318.48,598,3335020,5577,283520
2014-09-05,14.2 ( 0 %),317,2108510,6651.45,453,2315160,5111,-206650
2014-09-04,14.2 ( -0.7 %),392,2527510,6447.73,535,2659550,4971,-132040
2014-09-03,14.3 ( 2.14 %),643,5238740,8147.34,810,4704620,5808,534120
2014-08-29,14 ( 0.72 %),617,4992360,8091.35,813,4646690,5715,345670
2014-08-28,13.9 ( 0.72 %),305,2663920,8734.16,377,2366770,6278,297150
2014-08-27,13.8 ( -0.72 %),270,2215560,8205.78,445,2422120,5443,-206560
2014-08-26,13.9 ( 0 %),351,2846340,8109.23,457,2793640,6113,52700
2014-08-25,13.9 ( 0.72 %),317,2610330,8234.48,489,3176780,6496,-566450
2014-08-22,13.8 ( 0.73 %),284,1572070,5535.46,410,2149060,5242,-576990
2014-08-21,13.7 ( -0.72 %),299,2179140,7288.09,429,2984270,6956,-805130
2014-08-20,13.8 ( 0.73 %),270,2147400,7953.33,364,1708190,4693,439210
2014-08-19,13.7 ( 0 %),319,2805410,8794.39,499,3309300,6632,-503890
2014-08-18,13.7 ( 0 %),274,1965460,7173.21,343,2104690,6136,-139230
2014-08-15,13.7 ( -0.72 %),232,1512670,6520.13,365,2242650,6144,-729980
2014-08-14,13.8 ( 0.73 %),400,3071970,7679.92,368,2831340,7694,240630
2014-08-13,13.7 ( -0.72 %),301,1879800,6245.18,337,2155110,6395,-275310
2014-08-12,13.8 ( 0 %),249,1650150,6627.11,304,2039950,6710,-389800
2014-08-11,13.8 ( 0.73 %),0,0,0,0,0,0,0
2014-08-08,13.7 ( -0.72 %),239,1414810,5919.71,398,2162420,5433,-747610
2014-08-07,13.8 ( 1.47 %),195,1506500,7725.64,276,1438010,5210,68490
2014-08-06,13.6 ( -0.73 %),255,1961490,7692.12,403,2671350,6629,-709860
2014-08-05,13.7 ( 1.48 %),272,1605840,5903.82,255,1332450,5225,273390
2014-08-04,13.5 ( 0 %),309,1463080,4734.89,209,1397430,6686,65650
2014-08-01,13.5 ( -0.74 %),368,1695220,4606.58,240,1715340,7147,-20120
2014-07-31,13.6 ( 0.74 %),292,2039280,6983.84,225,1456370,6473,582910
2014-07-30,13.5 ( -0.74 %),359,2132530,5940.19,254,1622720,6389,509810
2014-07-29,13.6 ( 0 %),0,0,0,0,0,0,0
2014-07-28,13.6 ( -1.45 %),526,2980140,5665.67,462,3598330,7789,-618190
2014-07-25,13.8 ( 0 %),359,2321710,6467.16,386,2286070,5922,35640
2014-07-24,13.8 ( -0.72 %),305,1823870,5979.9,310,2010680,6486,-186810
2014-07-23,13.9 ( 0.72 %),353,2580790,7311.02,360,2705870,7516,-125080
2014-07-22,13.8 ( -0.72 %),315,1686750,5354.76,290,1694110,5842,-7360
2014-07-21,13.9 ( -0.71 %),306,2017730,6593.89,397,2285500,5757,-267770
2014-07-18,14 ( 0.72 %),394,2234270,5670.74,354,2174060,6141,60210
2014-07-17,13.9 ( -0.71 %),312,1575190,5048.69,318,2096230,6592,-521040
2014-07-16,14 ( 0 %),687,7045610,10255.62,760,5991530,7884,1054080
2014-07-15,14 ( 0.72 %),462,3710240,8030.82,515,3638000,7064,72240
2014-07-14,13.9 ( 0 %),187,681510,3644.44,254,1264110,4977,-582600
2014-07-11,13.9 ( 0 %),358,1931210,5394.44,295,1937210,6567,-6000
2014-07-10,13.9 ( -0.71 %),482,2944840,6109.63,392,2958020,7546,-13180
2014-07-09,14 ( 0 %),337,1636710,4856.71,365,2366620,6484,-729910
2014-07-08,14 ( -1.41 %),373,2466120,6611.58,450,3360080,7467,-893960
2014-07-07,14.2 ( 0.71 %),576,5789300,10050.87,602,3641620,6049,2147680
2014-07-04,14.1 ( 0.71 %),336,2317570,6897.53,381,2307350,6056,10220
2014-07-03,14 ( 0.72 %),546,3787380,6936.59,525,3514750,6695,272630
2014-07-02,13.9 ( 0 %),351,1830940,5216.35,272,1894910,6967,-63970
2014-07-01,13.9 ( 0.72 %),384,1878020,4890.68,301,1817570,6038,60450
2014-06-30,13.8 ( -1.43 %),391,2083770,5329.34,289,1860210,6437,223560
2014-06-27,14 ( -1.41 %),320,1590750,4971.09,413,2360970,5717,-770220
2014-06-25,14.3 ( 4.38 %),743,6812040,9168.29,849,4582820,5398,2229220
2014-06-24,13.7 ( 1.48 %),304,2443370,8037.4,333,1529470,4593,913900
2014-06-23,13.5 ( 0 %),253,1289970,5098.7,214,1171320,5473,118650
2014-06-20,0 ( 0 %),235,1226060,5217.28,235,1415160,6022,-189100
2014-06-19,13.5 ( -0.74 %),471,2140100,4543.74,246,1564740,6361,575360
2014-06-18,13.6 ( 0 %),277,1419760,5125.49,344,2103460,6115,-683700
2014-06-17,13.6 ( 0 %),326,1390140,4264.23,283,1982210,7004,-592070
2014-06-16,13.6 ( -1.45 %),259,1258890,4860.58,294,1921640,6536,-662750
2014-06-13,13.8 ( 0.73 %),205,865620,4222.54,403,2171360,5388,-1305740
2014-06-12,13.7 ( 0.74 %),576,5711910,9916.51,754,4091470,5426,1620440
2014-06-11,13.6 ( 0.74 %),269,1874780,6969.44,430,2556050,5944,-681270
2014-06-10,13.5 ( 0 %),207,1575640,7611.79,404,1986110,4916,-410470
2014-06-09,13.5 ( 0 %),302,2725180,9023.77,471,2808660,5963,-83480
2014-06-06,13.5 ( 1.5 %),240,1269140,5288.08,182,1118320,6145,150820
2014-06-05,13.3 ( 0 %),318,1451880,4565.66,161,821990,5106,629890
2014-06-04,13.3 ( -0.75 %),457,2459810,5382.52,241,1630000,6763,829810
2014-06-03,13.4 ( 0 %),368,2981380,8101.58,217,1041530,4800,1939850
2014-06-02,13.4 ( -2.9 %),331,1738750,5253.02,269,1398930,5200,339820
2014-05-30,13.8 ( 0.73 %),290,1989390,6859.97,338,1521780,4502,467610
2014-05-29,13.7 ( 1.48 %),725,6139080,8467.7,857,4523770,5279,1615310
2014-05-28,13.5 ( 0 %),441,2997490,6797.03,500,2779150,5558,218340
2014-05-27,13.5 ( 1.5 %),366,2082600,5690.16,412,2049840,4975,32760
2014-05-26,13.3 ( -0.75 %),390,1805560,4629.64,295,1759460,5964,46100
2014-05-23,13.4 ( 0 %),232,1306360,5630.86,383,1413160,3690,-106800
2014-05-22,13.4 ( 0 %),454,3018860,6649.47,626,2937430,4692,81430
2014-05-21,13.4 ( 1.52 %),440,2449200,5566.36,459,2278500,4964,170700
2014-05-20,13.2 ( 0 %),373,1523520,4084.5,254,1528710,6019,-5190
2014-05-19,13.2 ( 0.76 %),399,1593470,3993.66,290,1836480,6333,-243010
2014-05-16,13.1 ( 0.77 %),370,1933450,5225.54,252,1327950,5270,605500
2014-05-15,13 ( -2.26 %),560,3255210,5812.88,563,4000350,7105,-745140
2014-05-14,13.3 ( 2.31 %),402,2304990,5733.81,352,2108260,5989,196730
2014-05-13,13 ( 0.78 %),379,2687450,7090.9,427,2036200,4769,651250
2014-05-12,12.9 ( -3.01 %),771,5160390,6693.11,569,4601360,8087,559030
2014-05-09,13.3 ( 3.1 %),638,3011700,4720.53,425,1855530,4366,1156170
2014-05-08,12.9 ( -5.84 %),1239,7622000,6151.74,931,8726280,9373,-1104280
2014-05-07,13.7 ( 0.74 %),268,1156130,4313.92,266,832170,3128,323960
2014-05-06,13.6 ( -1.45 %),523,2696430,5155.7,392,2699180,6886,-2750
2014-05-05,13.8 ( -1.43 %),315,1088650,3456.03,292,1409810,4828,-321160
2014-04-29,14 ( 0 %),242,917260,3790.33,202,903840,4474,13420
2014-04-28,14 ( -0.71 %),239,1086230,4544.9,204,1254510,6150,-168280
2014-04-25,14.1 ( 0.71 %),355,1838960,5180.17,243,1623430,6681,215530
2014-04-24,14 ( -1.41 %),337,1479890,4391.36,270,1969570,7295,-489680
2014-04-23,14.2 ( -1.39 %),309,1407580,4555.28,412,2244900,5449,-837320
2014-04-22,14.4 ( 3.6 %),462,2305320,4989.87,319,1542430,4835,762890
2014-04-21,13.9 ( 0 %),595,3255780,5471.9,452,2227830,4929,1027950
2014-04-18,13.9 ( -4.79 %),940,4833330,5141.84,580,5587100,9633,-753770
2014-04-17,14.6 ( 0 %),619,2622170,4236.14,434,3148070,7254,-525900
2014-04-16,14.6 ( -2.01 %),966,5170320,5352.3,676,5039310,7455,131010
2014-04-15,14.9 ( -3.25 %),622,3290380,5290,648,5338280,8238,-2047900
2014-04-14,15.4 ( -0.65 %),432,2392360,5537.87,551,4080760,7406,-1688400
2014-04-11,15.5 ( 0 %),589,2909170,4939.17,404,3029740,7499,-120570
2014-04-10,15.5 ( -1.27 %),623,3679220,5905.65,558,4519460,8099,-840240
2014-04-08,15.7 ( 0 %),468,2676430,5718.87,562,3131760,5573,-455330
2014-04-07,15.7 ( 0.64 %),407,2725190,6695.8,623,3714880,5963,-989690
2014-04-04,15.6 ( -1.27 %),447,2499090,5590.81,471,3310290,7028,-811200
2014-04-03,15.8 ( 1.94 %),452,2731860,6043.94,383,2363520,6171,368340
2014-04-02,15.5 ( 0 %),707,4733930,6695.8,685,4821650,7039,-87720
2014-04-01,15.5 ( -2.52 %),771,4298970,5575.84,766,6767430,8835,-2468460
2014-03-31,15.9 ( -1.24 %),510,3422230,6710.25,665,4938550,7426,-1516320
2014-03-28,16.1 ( 0.63 %),511,2877910,5631.92,678,4244320,6260,-1366410
2014-03-27,16 ( 1.27 %),1078,6391820,5929.33,619,4335900,7005,2055920
2014-03-26,15.8 ( -3.07 %),1472,8553240,5810.62,1143,9538530,8345,-985290
2014-03-25,16.3 ( -2.98 %),1195,7196820,6022.44,1460,9291220,6364,-2094400
2014-03-24,16.8 ( 2.44 %),1304,9853970,7556.73,1359,7789340,5732,2064630
2014-03-21,16.4 ( 3.14 %),1463,13776520,9416.62,1837,9984080,5435,3792440
2014-03-20,15.9 ( -0.62 %),1234,9242920,7490.21,1656,9616450,5807,-373530
2014-03-19,16 ( 4.58 %),1715,16427970,9578.99,2191,10790780,4925,5637190
2014-03-18,15.3 ( 1.32 %),795,7059310,8879.64,785,4513070,5749,2546240
2014-03-17,15.1 ( 0 %),501,2821660,5632.06,728,4025760,5530,-1204100
2014-03-14,15.1 ( 0 %),698,4729040,6775.13,797,5180770,6500,-451730
2014-03-13,15.1 ( 0 %),627,3486480,5560.57,612,3504610,5726,-18130
2014-03-12,15.1 ( -0.66 %),526,3870420,7358.21,936,5253290,5612,-1382870
2014-03-11,15.2 ( 0.66 %),607,4335460,7142.44,919,4779360,5201,-443900
2014-03-10,15.1 ( 0.67 %),662,5691550,8597.51,804,4472920,5563,1218630
2014-03-07,15 ( -0.66 %),490,3419080,6977.71,725,3964030,5468,-544950
2014-03-06,15.1 ( 0 %),368,2981380,8101.58,217,1041530,4800,1939850
2014-03-05,15.1 ( 0.67 %),593,4583440,7729.24,817,4088270,5004,495170
2014-03-04,15 ( 0 %),848,5186520,6116.18,640,4607730,7200,578790
2014-03-03,15 ( -3.23 %),724,4526770,6252.44,799,5696200,7129,-1169430
2014-02-28,15.5 ( -0.64 %),681,4765870,6998.34,891,5492600,6165,-726730
2014-02-27,15.6 ( 1.3 %),1181,9833180,8326.15,1541,9418700,6112,414480
2014-02-26,15.4 ( 1.32 %),911,6427130,7055.03,1275,7540980,5914,-1113850
2014-02-25,15.2 ( 1.33 %),843,6885910,8168.34,887,5596190,6309,1289720
2014-02-24,15 ( 0.67 %),570,3635340,6377.79,569,4097840,7202,-462500
2014-02-21,14.9 ( -0.67 %),636,4055280,6376.23,707,4237300,5993,-182020
2014-02-20,15 ( 0 %),1299,9941130,7652.91,1809,11626520,6427,-1685390
2014-02-19,15 ( 2.74 %),783,7095750,9062.26,964,5490430,5695,1605320
2014-02-18,14.6 ( 0.69 %),740,5700110,7702.85,725,5134500,7082,565610
2014-02-17,14.5 ( -2.03 %),678,4399360,6488.73,879,6157400,7005,-1758040
2014-02-14,14.8 ( 0.68 %),551,4688280,8508.68,1158,6098410,5266,-1410130
2014-02-13,14.7 ( 5 %),1207,11737360,9724.41,1548,8912620,5758,2824740
2014-02-12,14 ( 2.19 %),571,4898800,8579.33,804,4457430,5544,441370
2014-02-11,13.7 ( -0.72 %),388,3073260,7920.77,567,3593610,6338,-520350
2014-02-10,13.8 ( 0.73 %),296,2008730,6786.25,427,2358630,5524,-349900
2014-02-07,13.7 ( 0 %),252,2129440,8450.16,528,2787300,5279,-657860
2014-02-06,13.7 ( -0.72 %),153,1077570,7042.94,275,1752740,6374,-675170
2014-01-27,13.8 ( 0.73 %),163,1214350,7450,230,1283360,5580,-69010
2014-01-24,13.7 ( 0 %),254,2338420,9206.38,610,3769050,6179,-1430630
2014-01-23,13.7 ( 0 %),264,2304710,8729.96,667,3762710,5641,-1458000
2014-01-22,13.7 ( 0 %),516,4691690,9092.42,993,6141990,6185,-1450300
2014-01-21,13.7 ( 3.01 %),451,4380860,9713.66,857,3721160,4342,659700
2014-01-20,13.3 ( 0.76 %),398,2669760,6707.94,932,4057230,4353,-1387470
2014-01-17,13.2 ( 3.94 %),686,5020950,7319.17,1054,5073370,4813,-52420
2014-01-16,12.7 ( -0.78 %),170,854350,5025.59,258,1482640,5747,-628290
2014-01-15,12.8 ( 0.79 %),207,1144150,5527.29,283,1427520,5044,-283370
2014-01-14,12.7 ( 0.79 %),223,1629310,7306.32,305,1677890,5501,-48580
2014-01-13,12.6 ( -0.79 %),176,891580,5065.8,279,1358540,4869,-466960
2014-01-10,12.7 ( 0 %),248,1441670,5813.19,319,1794030,5624,-352360
2014-01-09,12.7 ( 0 %),198,1126760,5690.71,252,1115670,4427,11090
2014-01-08,12.7 ( -0.78 %),226,1255550,5555.53,356,1808540,5080,-552990
2014-01-07,12.8 ( 2.4 %),479,3036210,6338.64,608,2803920,4612,232290
2014-01-06,12.5 ( 0 %),190,629900,3315.26,186,757880,4075,-127980
2014-01-03,12.5 ( 0 %),154,489420,3178.05,182,905860,4977,-416440
2014-01-02,12.5 ( -1.57 %),153,459610,3003.99,196,1008330,5145,-548720
2013-12-31,12.7 ( 1.6 %),180,856410,4757.83,189,1024250,5419,-167840
2013-12-30,12.5 ( 0 %),210,921410,4387.67,244,1409060,5775,-487650
2013-12-27,12.5 ( 0 %),161,792570,4922.8,189,901890,4772,-109320
2013-12-26,12.5 ( 0 %),219,1317650,6016.67,256,1769740,6913,-452090
2013-12-25,12.5 ( -0.79 %),168,615170,3661.73,204,1371850,6725,-756680
2013-12-24,12.6 ( 0.8 %),248,880990,3552.38,198,998740,5044,-117750
2013-12-23,12.5 ( -0.79 %),260,906660,3487.15,290,1357990,4683,-451330
2013-12-20,12.6 ( 0 %),360,1455510,4043.08,343,1976860,5763,-521350
2013-12-19,12.6 ( 0 %),263,949010,3608.4,197,1287690,6536,-338680
2013-12-18,12.6 ( -0.79 %),214,834600,3900,225,1338540,5949,-503940
2013-12-17,12.7 ( 0 %),145,648740,4474.07,215,1017200,4731,-368460
2013-12-16,12.7 ( 0 %),251,1200590,4783.23,231,1332880,5770,-132290
2013-12-13,12.7 ( 0.79 %),207,1208690,5839.08,217,1306260,6020,-97570
2013-12-12,12.6 ( 0.8 %),283,1163350,4110.78,160,1122020,7013,41330
2013-12-11,12.5 ( -1.57 %),269,635030,2360.71,230,1751580,7616,-1116550
2013-12-10,12.7 ( 0 %),258,873110,3384.15,210,1165810,5551,-292700
2013-12-09,12.7 ( -0.78 %),305,1004200,3292.46,243,1614590,6644,-610390
2013-12-06,12.8 ( 0 %),188,647410,3443.67,227,1003440,4420,-356030
2013-12-05,12.8 ( 0.79 %),223,1103390,4947.94,227,1033060,4551,70330
2013-12-04,12.7 ( -0.78 %),186,805670,4331.56,255,1168080,4581,-362410
2013-12-03,12.8 ( 0.79 %),211,1030350,4883.18,271,1142350,4215,-112000
2013-12-02,12.7 ( 0 %),157,612630,3902.1,169,594270,3516,18360
2013-11-29,12.7 ( -0.78 %),173,793730,4588.03,129,622720,4827,171010
2013-11-28,12.8 ( 0 %),182,839460,4612.42,191,912960,4780,-73500
2013-11-27,12.8 ( 0 %),180,853580,4742.11,210,674840,3214,178740
2013-11-26,12.8 ( 0 %),208,1022540,4916.06,218,866150,3973,156390
2013-11-25,12.8 ( -0.78 %),188,811020,4313.94,221,921080,4168,-110060
2013-11-22,12.9 ( 0.78 %),150,685190,4567.93,196,684510,3492,680
2013-11-21,12.8 ( -0.78 %),262,1506730,5750.88,334,1325070,3967,181660
2013-11-20,12.9 ( 0.78 %),212,744180,3510.28,196,676330,3451,67850
2013-11-19,12.8 ( 0 %),200,737740,3688.7,226,854920,3783,-117180
2013-11-18,12.8 ( 0.79 %),285,1192280,4183.44,266,1079190,4057,113090
2013-11-15,12.7 ( 0 %),236,821040,3478.98,239,1405780,5882,-584740
2013-11-14,12.7 ( 0 %),195,588100,3015.9,159,789520,4966,-201420
2013-11-13,12.7 ( 0 %),270,643840,2384.59,145,845040,5828,-201200
2013-11-12,12.7 ( -0.78 %),276,1140780,4133.26,244,1429770,5860,-288990
2013-11-11,12.8 ( 0.79 %),212,775330,3657.22,221,1105130,5001,-329800
2013-11-08,12.7 ( 0 %),213,907930,4262.58,178,901680,5066,6250
2013-11-07,12.7 ( -0.78 %),188,932130,4958.14,267,1394280,5222,-462150
2013-11-06,12.8 ( 0.79 %),257,1078730,4197.39,260,1255990,4831,-177260
2013-11-05,12.7 ( -0.78 %),212,516310,2435.42,228,1033260,4532,-516950
2013-11-04,12.8 ( 0.79 %),333,1035590,3109.88,211,1241920,5886,-206330
2013-11-01,12.7 ( 0 %),208,589800,2835.58,171,884490,5172,-294690
2013-10-31,12.7 ( -0.78 %),228,666760,2924.39,169,786510,4654,-119750
2013-10-30,12.8 ( 0.79 %),264,594670,2252.54,163,691980,4245,-97310
2013-10-29,12.7 ( -0.78 %),191,488400,2557.07,223,994500,4460,-506100
2013-10-28,12.8 ( -0.78 %),173,405200,2342.2,221,824120,3729,-418920
2013-10-25,12.9 ( 0 %),151,351400,2327.15,184,680720,3700,-329320
2013-10-24,12.9 ( 0 %),190,869630,4577,260,1327730,5107,-458100
2013-10-23,12.9 ( 0 %),177,555640,3139.21,185,779580,4214,-223940
2013-10-22,12.9 ( 0 %),266,1119780,4209.7,230,1052850,4578,66930
2013-10-21,12.9 ( -1.53 %),234,791460,3382.31,286,1277210,4466,-485750
2013-10-18,13.1 ( 0 %),185,707800,3825.95,180,786640,4370,-78840
2013-10-17,13.1 ( 1.55 %),219,1020970,4661.96,260,1131580,4352,-110610
2013-10-16,12.9 ( 0 %),406,1189390,2929.53,337,1576820,4679,-387430
2013-10-15,13.8 ( 0 %),321,2477930,7719.41,373,2450390,6569,27540
2013-10-14,13.8 ( 0.73 %),224,1216580,5431.16,277,1003960,3624,212620
2013-10-11,13.7 ( 0 %),269,1491660,5545.2,311,1329520,4275,162140
2013-10-10,13.7 ( -0.72 %),255,1122300,4401.18,275,1115030,4055,7270
2013-10-09,13.8 ( -0.72 %),359,2056210,5727.6,389,1922380,4942,133830
2013-10-08,13.9 ( 1.46 %),614,3321970,5410.37,663,3235140,4880,86830
2013-10-07,13.7 ( 0 %),181,1519270,8393.76,340,1305000,3838,214270
2013-10-04,13.7 ( 0 %),219,1476280,6741,370,1570450,4244,-94170
2013-10-03,13.7 ( -0.72 %),219,1809320,8261.74,534,2390790,4477,-581470
2013-10-02,13.8 ( 0.73 %),306,3069460,10030.92,558,2160110,3871,909350
2013-10-01,13.7 ( 1.48 %),323,2672220,8273.13,656,2225860,3393,446360
2013-09-30,13.5 ( 0.75 %),193,1203380,6235.13,274,1049700,3831,153680
2013-09-27,13.4 ( -0.74 %),149,1032690,6930.81,327,1653380,5056,-620690
2013-09-26,13.5 ( 0 %),184,1368800,7439.13,377,1433650,3803,-64850
2013-09-25,13.5 ( 2.27 %),346,2984290,8625.12,646,2302560,3564,681730
2013-09-24,13.2 ( 0.76 %),104,797010,7663.56,175,686790,3925,110220
2013-09-23,13.1 ( 0 %),94,528410,5621.38,137,582170,4249,-53760
2013-09-20,13.1 ( 0.77 %),106,681380,6428.11,139,750970,5403,-69590
2013-09-19,13 ( 0 %),71,504560,7106.48,146,649640,4450,-145080
2013-09-18,13 ( 0 %),80,561060,7013.25,183,667220,3646,-106160
2013-09-17,13 ( 0 %),79,463950,5872.78,161,788130,4895,-324180
2013-09-16,13 ( 0 %),95,562370,5919.68,130,578580,4451,-16210
2013-09-13,13 ( 0 %),120,906610,7555.08,159,934300,5876,-27690
2013-09-12,13 ( 0 %),119,901200,7573.11,183,1132010,6186,-230810
2013-09-11,13 ( 0 %),104,639690,6150.87,161,650730,4042,-11040
2013-09-10,13 ( 0.78 %),91,652100,7165.93,139,570800,4106,81300
2013-09-09,12.9 ( -1.53 %),78,654000,8384.62,174,861160,4949,-207160
2013-09-06,13.1 ( 0.77 %),92,497900,5411.96,125,556660,4453,-58760
2013-09-05,13 ( 0 %),94,542410,5770.32,135,629530,4663,-87120
2013-09-04,13 ( 0 %),98,349870,3570.1,112,475660,4247,-125790
2013-09-03,13 ( -0.76 %),92,399160,4338.7,128,599250,4682,-200090
2013-08-30,13.1 ( 0.77 %),81,436910,5393.95,144,498370,3461,-61460
2013-08-29,13 ( -0.76 %),82,452310,5515.98,141,640450,4542,-188140
2013-08-28,13.1 ( 0 %),128,708400,5534.38,187,970700,5191,-262300
2013-08-27,13.1 ( 0 %),113,653870,5786.46,152,712390,4687,-58520
2013-08-26,13.1 ( 0 %),133,777210,5843.68,170,1126040,6624,-348830
2013-08-23,13.1 ( -0.76 %),131,956590,7302.21,173,877900,5075,78690
2013-08-22,13.2 ( 0 %),104,710030,6827.21,181,621560,3434,88470
2013-08-21,13.2 ( 0 %),108,803090,7436.02,172,874550,5085,-71460
2013-08-20,13.2 ( 0 %),91,628040,6901.54,190,818540,4308,-190500
2013-08-19,13.2 ( 0.76 %),153,1264230,8262.94,319,1525820,4783,-261590
2013-08-16,13.1 ( -0.76 %),100,669630,6696.3,190,981100,5164,-311470
2013-08-15,13.2 ( 0.76 %),108,905180,8381.3,266,1124260,4227,-219080
2013-08-14,13.1 ( 0 %),102,972140,9530.78,206,1049220,5093,-77080
2013-08-13,13.1 ( 0 %),74,438050,5919.59,206,785240,3812,-347190
2013-08-12,13.1 ( 0 %),79,396800,5022.78,136,488290,3590,-91490
2013-08-09,13.1 ( -0.76 %),96,652470,6796.56,209,666880,3191,-14410
2013-08-08,13.2 ( 0.76 %),77,516490,6707.66,186,681360,3663,-164870
2013-08-07,13.1 ( -0.76 %),104,758400,7292.31,182,679680,3735,78720
2013-08-06,13.2 ( 0.76 %),120,983160,8193,172,667380,3880,315780
2013-08-05,13.1 ( 0 %),119,1034640,8694.45,195,1026950,5266,7690
2013-08-02,13.1 ( 0 %),89,667720,7502.47,198,705920,3565,-38200
2013-08-01,13.1 ( 0 %),137,1359250,9921.53,239,1450470,6069,-91220
2013-07-31,13.1 ( 0 %),119,985930,8285.13,208,844300,4059,141630
2013-07-30,13.1 ( 0 %),127,867380,6829.76,215,1017670,4733,-150290
2013-07-29,13.1 ( 0.77 %),156,994490,6374.94,257,1066650,4150,-72160
2013-07-26,13 ( 0 %),131,1224780,9349.47,266,1193720,4488,31060
2013-07-25,13 ( -0.76 %),121,642330,5308.51,244,1094540,4486,-452210
2013-07-24,13.1 ( 0 %),115,1027470,8934.52,267,1077450,4035,-49980
2013-07-23,13.1 ( 0 %),100,771150,7711.5,219,651630,2975,119520
2013-07-22,13.1 ( -0.76 %),135,822780,6094.67,226,873380,3865,-50600
2013-07-19,13.2 ( 0.76 %),127,1016370,8002.91,248,883140,3561,133230
2013-07-18,13.1 ( -0.76 %),112,774440,6914.64,206,742850,3606,31590
2013-07-17,13.2 ( 0 %),93,847260,9110.32,172,653330,3798,193930
2013-07-16,13.2 ( 0 %),113,933200,8258.41,267,874510,3275,58690
2013-07-15,13.2 ( 0.76 %),107,718540,6715.33,242,928680,3838,-210140
2013-07-12,13.1 ( 0 %),98,606190,6185.61,259,967020,3734,-360830
2013-07-11,13.1 ( 0 %),98,870720,8884.9,245,918690,3750,-47970
2013-07-10,13.1 ( 0 %),279,887930,3182.54,219,975190,4453,-87260
2013-07-09,13.1 ( 0 %),122,716450,5872.54,181,713920,3944,2530
2013-07-08,13.1 ( 0 %),113,976490,8641.5,312,1189550,3813,-213060
2013-07-05,13.1 ( 0 %),126,962910,7642.14,288,1122800,3899,-159890
2013-07-04,13.1 ( 0 %),172,1210730,7039.13,288,1151640,3999,59090
2013-07-03,13.1 ( 0 %),225,1361500,6051.11,230,1579260,6866,-217760
2013-07-02,13.1 ( 0.77 %),159,1021860,6426.79,245,1364840,5571,-342980
2013-07-01,13 ( -1.52 %),139,784880,5646.62,206,921070,4471,-136190
2013-06-28,13.2 ( 0 %),164,788770,4809.57,294,1172500,3988,-383730
2013-06-27,13.2 ( 1.54 %),177,1266850,7157.34,323,1343480,4159,-76630
2013-06-26,13 ( 0 %),177,1146460,6477.18,232,1071880,4620,74580
2013-06-25,13 ( -0.76 %),289,2623880,9079.17,447,2680950,5998,-57070
2013-06-24,13.1 ( 0.77 %),189,1288760,6818.84,301,1524860,5066,-236100
2013-06-21,13 ( 0 %),203,1368450,6741.13,252,1053110,4179,315340
2013-06-20,13 ( -0.76 %),267,1667650,6245.88,308,1588030,5156,79620
2013-06-19,13.1 ( 0.77 %),210,970830,4623,279,1228640,4404,-257810
2013-06-18,13 ( 0 %),286,1463110,5115.77,200,1112280,5561,350830
2013-06-17,13 ( -1.52 %),320,1691300,5285.31,293,1694310,5783,-3010
2013-06-14,13.3 ( 0.76 %),256,1320140,5156.8,318,1344310,4227,-24170
2013-06-13,13.2 ( -0.75 %),291,1259460,4328.04,274,1183090,4318,76370
2013-06-12,13.3 ( 0 %),276,1357850,4919.75,368,1709020,4644,-351170
2013-06-11,13.3 ( -0.75 %),242,1344780,5556.94,430,1643450,3822,-298670
2013-06-10,13.4 ( 0 %),273,1807280,6620.07,752,2994890,3983,-1187610
2013-06-07,13.4 ( 1.52 %),367,2164370,5897.47,505,2191690,4340,-27320
2013-06-06,13.2 ( 0 %),336,1886670,5615.09,374,1662080,4444,224590
2013-06-05,13.2 ( 0.76 %),269,1106850,4114.68,273,1120990,4106,-14140
2013-06-04,13.1 ( -1.5 %),211,1000390,4741.18,359,1602560,4464,-602170
2013-06-03,13.3 ( -0.75 %),278,1452950,5226.44,464,1861200,4011,-408250
2013-05-31,13.4 ( 1.52 %),479,3264860,6815.99,1020,3852940,3777,-588080
2013-05-30,13.2 ( 0 %),210,946820,4508.67,351,1277390,3639,-330570
2013-05-29,13.2 ( 0 %),293,1475280,5035.09,589,1842140,3128,-366860
2013-05-28,13.2 ( 0 %),173,603950,3491.04,418,1426430,3413,-822480
2013-05-27,13.2 ( 1.54 %),299,1509360,5048.03,581,2106540,3626,-597180
2013-05-24,13 ( 0 %),167,813530,4871.44,350,1251100,3575,-437570
2013-05-23,13 ( -0.76 %),183,968590,5292.84,439,1501470,3420,-532880
2013-05-22,13.1 ( 0.77 %),250,1408820,5635.28,492,1550690,3152,-141870
2013-05-21,13 ( 0 %),219,1178970,5383.42,430,1420540,3304,-241570
2013-05-20,13 ( 0 %),189,908060,4804.55,301,1050000,3488,-141940
2013-05-17,13 ( 0 %),152,870220,5725.13,345,1033600,2996,-163380
2013-05-16,13 ( 0 %),176,704610,4003.47,314,842670,2684,-138060
2013-05-15,13 ( 1.56 %),211,1181540,5599.72,324,1075320,3319,106220
2013-05-14,12.8 ( 0.79 %),210,840490,4002.33,242,1011960,4182,-171470
2013-05-13,12.9 ( -0.77 %),181,777410,4295.08,305,1048350,3437,-270940
2013-05-10,13 ( 0 %),192,759430,3955.36,344,1214800,3531,-455370
2013-05-09,13 ( 0 %),252,919600,3649.21,305,1159710,3802,-240110
2013-05-08,13 ( 0 %),261,1075600,4121.07,339,1270650,3748,-195050
2013-05-07,13 ( -0.76 %),215,764230,3554.56,404,1535790,3801,-771560
2013-05-06,13.1 ( 0.77 %),254,1176610,4632.32,412,1370370,3326,-193760
2013-05-03,13 ( 1.56 %),206,1303310,6326.75,313,1405590,4491,-102280
2013-05-02,12.8 ( -0.78 %),140,709170,5065.5,239,1036000,4335,-326830
2013-04-26,12.9 ( 0 %),166,860420,5183.25,286,923810,3230,-63390
2013-04-25,12.9 ( 0.78 %),240,932090,3883.71,272,975130,3585,-43040
2013-04-24,12.8 ( -0.78 %),229,1050640,4587.95,328,1269420,3870,-218780
2013-04-23,12.9 ( 0.78 %),174,890710,5119.02,223,649310,2912,241400
2013-04-22,12.8 ( 0 %),196,702530,3584.34,221,852160,3856,-149630
2013-04-18,12.8 ( -0.78 %),266,739600,2780.45,228,1012250,4440,-272650
2013-04-17,12.9 ( 0 %),173,632550,3656.36,225,815270,3623,-182720
2013-04-16,12.9 ( 0 %),369,1456110,3946.1,271,1322390,4880,133720
2013-04-15,12.9 ( -0.77 %),307,1373080,4472.57,330,1498070,4540,-124990
2013-04-12,13 ( -0.76 %),299,1492040,4990.1,318,1364570,4291,127470
2013-04-11,13.1 ( 0.77 %),334,1382910,4140.45,311,1272740,4092,110170
2013-04-10,13 ( -2.99 %),236,891610,3778.01,532,2341850,4402,-1450240
2013-04-09,13.4 ( 1.52 %),289,1794010,6207.65,529,1904190,3600,-110180
2013-04-08,13.2 ( 1.54 %),269,1154400,4291.45,366,1309000,3577,-154600
2013-04-05,13 ( 0 %),297,1351420,4550.24,288,1467210,5094,-115790
2013-04-04,13 ( -0.76 %),254,1309570,5155.79,272,1730590,6362,-421020
2013-04-03,13.1 ( -0.76 %),220,749310,3405.95,389,1332900,3426,-583590
2013-04-02,13.2 ( 0.76 %),300,1510200,5034,554,1797410,3244,-287210
2013-04-01,13.1 ( 1.55 %),277,978020,3530.76,273,965900,3538,12120
2013-03-29,12.9 ( 0 %),265,994420,3752.53,204,630300,3090,364120
2013-03-28,12.9 ( -0.77 %),238,840830,3532.9,249,1011290,4061,-170460
2013-03-27,13 ( -0.76 %),207,883920,4270.14,248,897950,3621,-14030
2013-03-26,13.1 ( 0 %),178,648960,3645.84,303,826130,2727,-177170
2013-03-25,13.1 ( 0.77 %),289,1287440,4454.81,313,1294630,4136,-7190
2013-03-22,13 ( -0.76 %),322,940130,2919.66,359,1468170,4090,-528040
2013-03-21,13.1 ( 0 %),241,860720,3571.45,309,965600,3125,-104880
2013-03-20,13.1 ( 0.77 %),292,1014910,3475.72,266,809540,3043,205370
2013-03-19,13 ( 0 %),299,978480,3272.51,259,1000750,3864,-22270
2013-03-18,13 ( 0 %),220,669890,3044.95,268,1101000,4108,-431110
2013-03-15,13 ( 0 %),309,736300,2382.85,245,823070,3359,-86770
2013-03-14,13 ( -0.76 %),282,688060,2439.93,250,829110,3316,-141050
2013-03-13,13.1 ( -0.76 %),271,819490,3023.95,314,1198780,3818,-379290
2013-03-12,13.2 ( 0 %),244,754340,3091.56,334,1204210,3605,-449870
2013-03-11,13.2 ( 0.76 %),335,973950,2907.31,291,808410,2778,165540
2013-03-08,13.1 ( 0 %),306,875200,2860.13,303,1144420,3777,-269220
2013-03-07,13.1 ( 0 %),267,1034710,3875.32,291,962140,3306,72570
2013-03-06,13.1 ( 0 %),317,1029640,3248.08,267,1057280,3960,-27640
2013-03-05,13.1 ( 0 %),384,1298820,3382.34,418,1245580,2980,53240
2013-03-04,13.1 ( -1.5 %),445,1334860,2999.69,398,1610660,4047,-275800
2013-03-01,13.3 ( -0.75 %),321,985190,3069.13,416,1355200,3258,-370010
2013-02-28,13.4 ( 1.52 %),500,1813620,3627.24,442,1525120,3450,288500
2013-02-27,13.2 ( 0 %),686,2078860,3030.41,483,1885110,3903,193750
2013-02-26,13.2 ( -2.94 %),655,2222570,3393.24,702,2919600,4159,-697030
2013-02-25,13.6 ( -0.73 %),577,1731600,3001.04,507,1922090,3791,-190490
2013-02-22,13.7 ( 0 %),1060,4718360,4451.28,788,5018280,6368,-299920
2013-02-21,13.7 ( -2.84 %),549,2038170,3712.51,745,3201410,4297,-1163240
2013-02-20,14.1 ( -0.7 %),495,1669220,3372.16,527,2225530,4223,-556310
2013-02-19,14.2 ( -0.7 %),787,4145870,5267.94,1037,5310240,5121,-1164370
2013-02-18,14.3 ( 1.42 %),618,3540620,5729.16,828,3563880,4304,-23260
2013-02-08,14.1 ( 1.44 %),432,2467240,5711.2,592,2203680,3722,263560
2013-02-07,13.9 ( 0 %),395,1529810,3872.94,480,2161630,4503,-631820
2013-02-06,13.9 ( 1.46 %),457,2003240,4383.46,518,2267530,4377,-264290
2013-02-05,13.7 ( 0 %),716,2445720,3415.81,430,2705350,6292,-259630
2013-02-04,13.7 ( -1.44 %),419,1441710,3440.84,487,2686850,5517,-1245140
2013-02-01,13.9 ( 0 %),539,1981230,3675.75,479,2326100,4856,-344870
2013-01-31,13.9 ( -1.42 %),479,2177850,4546.66,719,3533270,4914,-1355420
2013-01-30,14.1 ( 0.71 %),594,4053640,6824.31,867,3833950,4422,219690
2013-01-29,14 ( 0 %),688,3439900,4999.85,891,4305240,4832,-865340
2013-01-28,14 ( 0.72 %),908,4831780,5321.34,1312,6059290,4618,-1227510
2013-01-25,13.9 ( 0.72 %),445,2323400,5221.12,894,3716030,4157,-1392630
2013-01-24,13.8 ( 1.47 %),445,2501400,5621.12,647,2456260,3796,45140
2013-01-23,13.6 ( 0 %),601,2093960,3484.13,642,3082450,4801,-988490
2013-01-22,13.6 ( -2.86 %),814,2544920,3126.44,827,5084580,6148,-2539660
2013-01-21,14 ( -0.71 %),805,3964710,4925.11,1036,5907290,5702,-1942580
2013-01-18,14.1 ( 0 %),988,6470170,6548.76,1172,7371560,6290,-901390
2013-01-17,14.1 ( -2.08 %),762,4056290,5323.22,1178,6342040,5384,-2285750
2013-01-16,14.4 ( 1.41 %),1007,6592430,6546.6,1481,7303360,4931,-710930
2013-01-15,14.2 ( 2.16 %),1149,6385660,5557.58,1484,7118730,4797,-733070
2013-01-14,13.9 ( -0.71 %),789,4076820,5167.07,1026,5128530,4999,-1051710
2013-01-11,14 ( 0.72 %),885,5781110,6532.33,1675,8406750,5019,-2625640
2013-01-10,13.9 ( 3.73 %),950,5820620,6126.97,927,5266550,5681,554070
2013-01-09,13.4 ( -1.47 %),1349,7033660,5213.98,1598,8932680,5590,-1899020
2013-01-08,13.6 ( 3.82 %),1258,9360760,7440.99,1562,7626510,4883,1734250
2013-01-07,13.1 ( 0.77 %),575,2891620,5028.9,801,3642680,4548,-751060
2013-01-04,13 ( 0.78 %),676,3154770,4666.82,626,2704500,4320,450270
2013-01-03,12.9 ( -1.53 %),763,3797850,4977.52,1100,5473830,4976,-1675980
2013-01-02,13.1 ( 4.8 %),968,6367070,6577.55,998,4420160,4429,1946910
2012-12-28,12.5 ( 0 %),509,1950750,3832.51,622,2979990,4791,-1029240
2012-12-27,12.5 ( 0.81 %),729,4365530,5988.38,902,4823160,5347,-457630
2012-12-26,12.4 ( 1.64 %),446,1792640,4019.37,449,1996180,4446,-203540
2012-12-25,12.2 ( -0.81 %),382,1076410,2817.83,459,1825550,3977,-749140
2012-12-24,12.3 ( 0 %),291,1101850,3786.43,452,1831650,4052,-729800
2012-12-21,12.3 ( 0 %),291,1371430,4712.82,353,1627240,4610,-255810
2012-12-20,12.3 ( 0 %),438,1988450,4539.84,523,3031090,5796,-1042640
2012-12-19,12.3 ( 0.82 %),431,1598060,3707.8,463,2107030,4551,-508970
2012-12-18,12.2 ( -0.81 %),308,1048390,3403.86,379,1623070,4283,-574680
2012-12-17,12.3 ( -0.81 %),371,1119040,3016.28,412,1940900,4711,-821860
2012-12-14,12.4 ( 1.64 %),652,2997590,4597.53,828,3542890,4279,-545300
2012-12-13,12.2 ( -0.81 %),348,1322590,3800.55,407,1833990,4506,-511400
2012-12-12,12.3 ( 0.82 %),382,1836740,4808.22,431,2059950,4779,-223210
2012-12-11,12.3 ( 0 %),351,1519610,4329.37,406,1738600,4282,-218990
2012-12-10,12.3 ( 0.82 %),407,1828810,4493.39,408,1981530,4857,-152720
2012-12-07,12.2 ( -0.81 %),363,1767910,4870.28,419,2197950,5246,-430040
2012-12-06,12.3 ( 0 %),412,1824170,4427.6,502,2554700,5089,-730530
2012-12-05,12.3 ( 0.82 %),641,3249770,5069.84,519,2886710,5562,363060
2012-12-04,12.2 ( 0 %),285,1293370,4538.14,268,1059380,3953,233990
2012-12-03,12.2 ( 0 %),289,998870,3456.3,277,1264620,4565,-265750
2012-11-30,12.2 ( 0 %),363,1381290,3805.21,414,1679370,4056,-298080
2012-11-29,12.2 ( 0.83 %),301,1096580,3643.12,306,1286910,4206,-190330
2012-11-28,12.1 ( 0 %),292,1390410,4761.68,313,1393370,4452,-2960
2012-11-27,12.1 ( 0.83 %),364,1642390,4512.06,366,1684650,4603,-42260
2012-11-26,12 ( -0.83 %),343,1490240,4344.72,406,2160220,5321,-669980
2012-11-23,12.1 ( 0 %),298,1195540,4011.88,304,1176850,3871,18690
2012-11-22,12.1 ( 0 %),462,1631760,3531.95,268,1376570,5136,255190
2012-11-21,12.1 ( 0 %),437,2206580,5049.38,358,2171980,6067,34600
2012-11-20,12.1 ( 0.83 %),550,1948330,3542.42,253,1177640,4655,770690
2012-11-19,12 ( -2.44 %),777,3167540,4076.63,395,3186670,8068,-19130
2012-11-16,12.3 ( 0.82 %),509,1987960,3905.62,212,1085120,5118,902840
2012-11-15,12.2 ( -1.61 %),546,1446380,2649.05,308,1756150,5702,-309770
2012-11-14,12.4 ( -1.59 %),847,3560480,4203.64,563,4632830,8229,-1072350
2012-11-13,12.6 ( 0 %),820,2370830,2891.26,592,3557600,6009,-1186770
2012-11-12,13.6 ( 1.49 %),640,4232900,6613.91,822,4644590,5650,-411690
2012-11-09,13.4 ( 0 %),663,4831810,7287.8,863,4903970,5682,-72160
2012-11-08,13.4 ( 2.29 %),719,4437700,6172.04,856,4174910,4877,262790
2012-11-07,13.1 ( 0.77 %),665,3326320,5001.98,543,2955770,5443,370550
2012-11-06,13 ( 0.78 %),466,2333360,5007.21,377,2327250,6173,6110
2012-11-05,12.9 ( -0.77 %),557,2885150,5179.8,423,3218150,7608,-333000
2012-11-02,13 ( -1.52 %),759,3824370,5038.7,655,4190540,6398,-366170
2012-11-01,13.2 ( 3.94 %),1402,6586660,4698.05,968,5748420,5938,838240
2012-10-31,12.7 ( 0.79 %),257,1023170,3981.21,244,864370,3542,158800
2012-10-30,12.6 ( -0.79 %),185,762460,4121.41,270,943490,3494,-181030
2012-10-29,12.7 ( 1.6 %),281,1412420,5026.41,280,901090,3218,511330
2012-10-26,12.5 ( -0.79 %),264,950820,3601.59,231,1074400,4651,-123580
2012-10-25,12.6 ( 0 %),430,2143830,4985.65,244,978760,4011,1165070
2012-10-24,12.6 ( -0.79 %),330,941460,2852.91,228,952020,4176,-10560
2012-10-23,12.7 ( 0 %),437,1149210,2629.77,242,1111920,4595,37290
2012-10-22,12.7 ( -1.55 %),447,1581530,3538.1,335,1746570,5214,-165040
2012-10-19,12.9 ( -0.77 %),382,1466330,3838.56,336,1564180,4655,-97850
2012-10-18,13 ( -0.76 %),630,2436210,3867,382,2668360,6985,-232150
2012-10-17,13.1 ( 0 %),370,1732030,4681.16,338,2231370,6602,-499340
2012-10-16,13.1 ( 0.77 %),712,3821330,5367.04,406,3111630,7664,709700
2012-10-15,13 ( -0.76 %),307,1559690,5080.42,286,1812810,6338,-253120
2012-10-12,13.1 ( 0 %),478,2159380,4517.53,252,1617230,6418,542150
2012-10-11,13.1 ( -0.76 %),530,2299120,4337.96,402,2926450,7280,-627330
2012-10-10,13.2 ( 0 %),291,1182010,4061.89,291,1669380,5737,-487370
2012-10-09,13.2 ( -0.75 %),210,1042520,4964.38,333,1712790,5144,-670270
2012-10-08,13.3 ( 0.76 %),199,869000,4366.83,273,922170,3378,-53170
2012-10-05,13.2 ( 0 %),167,1126240,6743.95,260,934180,3593,192060
2012-10-04,13.2 ( 0 %),213,1747220,8202.91,312,1359960,4359,387260
2012-10-03,13.2 ( 0 %),235,1345530,5725.66,285,1061240,3724,284290
2012-10-02,13.2 ( 1.54 %),285,1596850,5602.98,282,1004800,3563,592050
2012-10-01,13 ( -1.52 %),298,1297650,4354.53,241,995440,4130,302210
2012-09-28,13.2 ( -0.75 %),214,820990,3836.4,251,1054690,4202,-233700
2012-09-27,13.3 ( -0.75 %),233,1010850,4338.41,318,1339690,4213,-328840
2012-09-26,13.4 ( 0.75 %),239,1070370,4478.54,293,1350670,4610,-280300
2012-09-25,13.3 ( 0 %),266,1062770,3995.38,264,1023900,3878,38870
2012-09-24,13.3 ( -0.75 %),274,974990,3558.36,269,1101870,4096,-126880
2012-09-21,13.4 ( 2.29 %),520,2301540,4426.04,302,1735260,5746,566280
2012-09-20,13.1 ( -2.96 %),730,2833640,3881.7,365,2684750,7355,148890
2012-09-19,13.5 ( 0.75 %),423,1867790,4415.58,256,1021510,3990,846280
2012-09-18,13.4 ( -2.19 %),373,1412130,3785.87,402,2233030,5555,-820900
2012-09-17,13.7 ( -0.72 %),269,1241710,4616.02,522,2492590,4775,-1250880
2012-09-14,13.8 ( 1.47 %),311,1290220,4148.62,478,2086090,4364,-795870
2012-09-13,13.6 ( 1.49 %),286,1784080,6238.04,224,1150870,5138,633210
2012-09-12,13.4 ( -0.74 %),270,1192120,4415.26,302,1626190,5385,-434070
2012-09-11,13.5 ( 1.5 %),461,2225200,4826.9,264,1073770,4067,1151430
2012-09-10,13.3 ( -2.92 %),504,1854010,3678.59,427,2296950,5379,-442940
2012-09-07,13.7 ( 0 %),435,1870270,4299.47,294,1490650,5070,379620
2012-09-06,13.7 ( -0.72 %),366,1775230,4850.36,373,1801230,4829,-26000
2012-09-05,13.8 ( 0 %),399,1976250,4953.01,447,2609800,5838,-633550
2012-09-04,13.8 ( 0.73 %),361,1466320,4061.83,362,1557900,4304,-91580
2012-08-31,13.7 ( -2.14 %),401,1558920,3887.58,488,2354590,4825,-795670
2012-08-30,14 ( 0.72 %),441,2251650,5105.78,684,2497490,3651,-245840
2012-08-29,13.9 ( 2.21 %),499,2394070,4797.74,478,1754590,3671,639480
2012-08-28,13.6 ( 1.49 %),758,4090730,5396.74,330,1350450,4092,2740280
2012-08-27,13.4 ( -3.6 %),863,4870020,5643.13,659,5257080,7977,-387060
2012-08-24,13.9 ( 4.51 %),1623,8202590,5053.97,574,3651190,6361,4551400
2012-08-23,13.3 ( -4.32 %),1330,9566510,7192.86,1240,9348410,7539,218100
2012-08-22,13.9 ( -2.11 %),1171,5614820,4794.89,734,3868580,5271,1746240
2012-08-21,14.2 ( -4.7 %),909,3513850,3865.62,1201,7689620,6403,-4175770
2012-08-20,14.9 ( 2.05 %),611,4316190,7064.14,1057,4261700,4032,54490
2012-08-17,14.6 ( 0 %),533,2285970,4288.87,436,2070620,4749,215350
2012-08-16,14.6 ( 0 %),286,1105110,3864.02,540,1936920,3587,-831810
2012-08-15,14.6 ( -0.68 %),684,2684940,3925.35,1213,5571790,4593,-2886850
2012-08-14,14.7 ( 2.8 %),2567,24816610,9667.55,2524,25841020,10238,-1024410
2012-08-13,14.3 ( 2.14 %),264,1678180,6356.74,394,1643550,4171,34630
2012-08-10,14 ( 0 %),220,1062310,4828.68,398,1659930,4171,-597620
2012-08-09,14 ( 0 %),295,1589960,5389.69,456,2080660,4563,-490700
2012-08-08,14 ( 0 %),264,1451780,5499.17,372,1750850,4707,-299070
2012-08-07,14 ( -0.71 %),289,1365090,4723.49,462,2649850,5736,-1284760
2012-08-06,14.1 ( 1.44 %),339,2271860,6701.65,545,2581420,4737,-309560
2012-08-03,13.9 ( 0.72 %),314,1714910,5461.5,291,1746250,6001,-31340
2012-08-02,13.8 ( 0 %),281,1398170,4975.69,276,1539790,5579,-141620
2012-08-01,13.8 ( -1.43 %),271,1451300,5355.35,356,2408060,6764,-956760
2012-07-31,14 ( -0.71 %),224,1266890,5655.76,354,1479030,4178,-212140
2012-07-30,14.1 ( 0 %),245,1432930,5848.69,317,1446940,4564,-14010
2012-07-27,14.1 ( 1.44 %),357,2470550,6920.31,416,2369210,5695,101340
2012-07-26,13.9 ( 0.72 %),336,1458910,4341.99,252,1391150,5520,67760
2012-07-25,13.8 ( 0 %),505,1955580,3872.44,280,2043250,7297,-87670
2012-07-24,13.8 ( -2.13 %),483,1786560,3698.88,286,1770890,6192,15670
2012-07-23,14.1 ( -1.4 %),295,1459310,4946.81,465,2424190,5213,-964880
2012-07-20,14.3 ( -1.38 %),359,1984610,5528.16,737,3526540,4785,-1541930
2012-07-19,14.5 ( 2.11 %),361,1890890,5237.92,513,1979530,3859,-88640
2012-07-18,14.2 ( -0.7 %),259,1216150,4695.56,624,2597150,4162,-1381000
2012-07-17,14.3 ( 2.14 %),335,2319890,6925.04,562,2230800,3969,89090
2012-07-16,14 ( 1.45 %),393,3410210,8677.38,852,3413990,4007,-3780
2012-07-13,13.8 ( 4.55 %),552,3515720,6369.06,572,2363750,4132,1151970
2012-07-12,13.2 ( 1.54 %),272,611280,2247.35,157,581660,3705,29620
2012-07-10,13 ( -0.76 %),340,1123440,3304.24,227,957390,4218,166050
2012-07-09,13.1 ( -3.68 %),331,836150,2526.13,286,1319580,4614,-483430
2012-07-06,13.6 ( 0.74 %),337,1049980,3115.67,237,1022990,4316,26990
2012-07-05,13.5 ( 0 %),375,1329730,3545.95,267,1336210,5005,-6480
2012-07-04,13.5 ( -1.46 %),257,1029800,4007,303,1330590,4391,-300790
2012-07-03,13.7 ( -0.72 %),385,1355460,3520.68,415,1599490,3854,-244030
2012-07-02,13.8 ( -1.43 %),263,724560,2754.98,327,1586270,4851,-861710
2012-06-29,14 ( 0.72 %),288,1166360,4049.86,303,1628090,5373,-461730
2012-06-28,13.9 ( -0.71 %),324,1276550,3939.97,332,1338890,4033,-62340
2012-06-27,14 ( -0.71 %),331,1608200,4858.61,356,2021790,5679,-413590
2012-06-26,14.1 ( 0 %),448,2522360,5630.27,511,1927820,3773,594540
2012-06-25,14.1 ( -1.4 %),425,2174590,5116.68,495,2721950,5499,-547360
2012-06-22,14.3 ( -0.69 %),430,1934530,4498.91,423,2243060,5303,-308530
2012-06-21,14.4 ( 0 %),401,2402640,5991.62,497,2098680,4223,303960
2012-06-20,14.4 ( 0 %),269,1079430,4012.75,374,1264710,3382,-185280
2012-06-19,14.4 ( -1.37 %),332,1603070,4828.52,540,2690800,4983,-1087730
2012-06-18,14.6 ( 1.39 %),349,2302910,6598.6,737,3352050,4548,-1049140
2012-06-15,14.4 ( 0.7 %),355,1446780,4075.44,502,2222190,4427,-775410
2012-06-14,0 ( 0 %),536,2168810,4046.29,400,1943200,4858,225610
2012-06-13,14.3 ( 0 %),511,2043120,3998.28,407,1921790,4722,121330
2012-06-12,14.3 ( -2.05 %),506,2237460,4421.86,474,2703410,5703,-465950
2012-06-11,14.6 ( 0 %),611,3290560,5385.53,551,2931990,5321,358570
2012-06-08,14.6 ( -1.35 %),489,1574510,3219.86,811,3292920,4060,-1718410
2012-06-07,14.8 ( 1.37 %),613,3223690,5258.87,760,4051830,5331,-828140
2012-06-06,14.6 ( 0 %),434,1759710,4054.63,470,2181210,4641,-421500
2012-06-05,14.6 ( 1.39 %),514,2394630,4658.81,391,1728170,4420,666460
2012-06-04,14.4 ( -2.7 %),656,3636450,5543.37,689,5259560,7634,-1623110
2012-06-01,14.8 ( 0.68 %),373,2445500,6556.3,824,3278540,3979,-833040
2012-05-31,14.7 ( -1.34 %),354,1816330,5130.88,630,2602980,4132,-786650
2012-05-30,14.9 ( 1.36 %),446,3253400,7294.62,872,3720950,4267,-467550
2012-05-29,14.7 ( -0.68 %),374,2095640,5603.32,563,2210690,3927,-115050
2012-05-28,14.8 ( 0 %),374,2284790,6109.06,859,3536920,4117,-1252130
2012-05-25,14.8 ( 4.96 %),651,4125720,6337.51,567,2345210,4136,1780510
2012-05-24,14.1 ( -1.4 %),642,3060810,4767.62,598,2798700,4680,262110
2012-05-23,14.3 ( -2.72 %),581,2208380,3801,594,3006040,5061,-797660
2012-05-22,14.7 ( -2 %),537,1817620,3384.77,768,3810240,4961,-1992620
2012-05-21,15 ( 4.9 %),832,3838260,4613.29,435,2096790,4820,1741470
2012-05-18,14.3 ( -2.72 %),981,4815060,4908.32,913,4870510,5335,-55450
2012-05-17,14.7 ( 0 %),670,3015880,4501.31,612,3188110,5209,-172230
2012-05-16,14.9 ( 0.68 %),842,3712080,4408.65,750,3298520,4398,413560
2012-05-15,14.8 ( -1.33 %),1057,4798690,4539.91,1004,4661360,4643,137330
2012-05-14,15 ( -3.23 %),1234,5251620,4255.77,1322,7563440,5721,-2311820
2012-05-11,15.5 ( -1.27 %),773,5131010,6637.79,1295,5200140,4016,-69130
2012-05-10,15.7 ( 0.64 %),741,3536870,4773.1,1534,6266240,4085,-2729370
2012-05-09,15.6 ( -0.64 %),794,3775300,4754.79,1969,7719670,3921,-3944370
2012-05-08,15.7 ( 4.67 %),1971,12458500,6320.9,1727,9091390,5264,3367110
2012-05-07,15 ( -1.32 %),1367,3976280,2908.76,1148,5995740,5223,-2019460
2012-05-04,15.2 ( 0.66 %),915,3689930,4032.71,879,4176830,4752,-486900
2012-05-03,15.1 ( -0.66 %),820,2677940,3265.78,822,3427460,4170,-749520
2012-05-02,15.2 ( -0.65 %),778,3266180,4198.17,1001,4894720,4890,-1628540
2012-04-27,15.3 ( 0 %),1340,5197300,3878.58,942,4885900,5187,311400
2012-04-26,15.3 ( -1.92 %),818,3382590,4135.2,1248,6431380,5153,-3048790
2012-04-25,15.6 ( 0.65 %),866,4562970,5269.02,1487,6504050,4374,-1941080
2012-04-24,15.5 ( 0.65 %),1108,5722840,5165.02,1077,5036060,4676,686780
2012-04-23,15.4 ( 0 %),1251,6121620,4893.38,1329,6133830,4615,-12210
2012-04-20,15.4 ( 0 %),1145,5425370,4738.31,1074,5529880,5149,-104510
2012-04-19,15.4 ( -1.91 %),1124,4968220,4420.12,1371,6455280,4708,-1487060
2012-04-18,15.7 ( -1.26 %),1471,8061300,5480.15,2274,11522540,5067,-3461240
2012-04-17,15.9 ( 0.63 %),1359,8438830,6209.59,2583,12176990,4714,-3738160
2012-04-16,15.8 ( 1.94 %),1240,5638880,4547.48,1679,6888920,4103,-1250040
2012-04-13,15.5 ( -1.9 %),1192,5231300,4388.67,2024,8458670,4179,-3227370
2012-04-12,15.8 ( 3.27 %),2519,15368480,6101.02,2909,13795660,4742,1572820
2012-04-11,15.3 ( 2.68 %),1683,7223280,4291.91,1456,7565860,5196,-342580
2012-04-10,14.9 ( -2.61 %),1553,6566060,4227.98,1574,8214820,5219,-1648760
2012-04-09,15.3 ( 1.32 %),808,3774130,4670.95,1234,4619970,3744,-845840
2012-04-06,15.1 ( -1.31 %),819,3790050,4627.66,2015,7651330,3797,-3861280
2012-04-05,15.3 ( 2.68 %),1034,6350530,6141.71,1371,6802350,4962,-451820
2012-04-04,14.9 ( -1.97 %),849,4475790,5271.84,1376,7702590,5598,-3226800
2012-04-03,15.2 ( 4.83 %),1240,9300400,7500.32,1184,6469120,5464,2831280
2012-03-30,14.5 ( -1.36 %),1547,6313270,4080.98,964,6948190,7208,-634920
2012-03-29,14.7 ( -2.65 %),1626,5807710,3571.78,1113,7894360,7093,-2086650
2012-03-28,15.1 ( 2.03 %),2368,8909150,3762.31,983,5890740,5993,3018410
2012-03-27,14.8 ( -4.52 %),2667,8404650,3151.35,1570,10736220,6838,-2331570
2012-03-26,15.5 ( -3.12 %),1846,6223520,3371.35,1608,9919170,6169,-3695650
2012-03-23,16 ( 1.27 %),2061,11269150,5467.81,2135,13553800,6348,-2284650
2012-03-22,15.8 ( -2.47 %),1828,7457400,4079.54,2077,12913290,6217,-5455890
2012-03-21,16.2 ( 1.89 %),1880,12450070,6622.38,2801,18809080,6715,-6359010
2012-03-20,15.9 ( 2.58 %),1197,7631790,6375.76,1608,6702130,4168,929660
2012-03-19,15.5 ( 0 %),1308,7295170,5577.35,1821,8595920,4720,-1300750
2012-03-16,15.5 ( 1.31 %),1855,11352190,6119.78,2745,14532530,5294,-3180340
2012-03-15,15.3 ( 4.79 %),1945,11899690,6118.09,1477,7583360,5134,4316330
2012-03-14,14.6 ( -2.67 %),1420,5392470,3797.51,1622,9908240,6109,-4515770
2012-03-13,15 ( 4.17 %),2129,10370810,4871.21,1474,8711570,5910,1659240
2012-03-12,14.4 ( -3.36 %),1930,10532180,5457.09,2197,13202580,6009,-2670400
2012-03-09,14.9 ( -2.61 %),2208,11689930,5294.35,2073,12628440,6092,-938510
2012-03-08,15.3 ( -4.97 %),2601,12229970,4702.03,2962,20196520,6819,-7966550
2012-03-07,16.1 ( -2.42 %),3128,15417980,4929.02,2736,17214010,6292,-1796030
2012-03-06,16.5 ( 1.23 %),4571,21450350,4692.7,2924,20659530,7066,790820
2012-03-05,16.3 ( 4.49 %),2462,15580230,6328.28,307,1604700,5227,13975530
2012-03-02,15.6 ( 4.7 %),4235,25590310,6042.58,2071,19904370,9611,5685940
2012-03-01,14.9 ( 4.2 %),2722,16735570,6148.26,1826,14725720,8064,2009850
2012-02-29,14.3 ( 2.14 %),1504,9928330,6601.28,1189,9643740,8111,284590
2012-02-28,14 ( -2.78 %),1545,7139740,4621.19,1182,8087040,6842,-947300
2012-02-27,14.7 ( 3.52 %),1445,8228230,5694.28,1235,8581630,6949,-353400
2012-02-24,14.2 ( 2.16 %),1652,10753540,6509.41,1614,12495540,7742,-1742000
2012-02-23,13.9 ( 4.51 %),1515,10631750,7017.66,1424,6599770,4635,4031980
2012-02-22,13.3 ( 3.1 %),943,6784270,7194.35,979,5617850,5738,1166420
2012-02-21,12.9 ( -2.27 %),803,4171900,5195.39,1013,6216030,6136,-2044130
2012-02-20,13.2 ( 3.94 %),790,4684520,5929.77,829,4625560,5580,58960
2012-02-17,12.7 ( 1.6 %),430,2093590,4868.81,516,2365110,4584,-271520
2012-02-16,12.5 ( 0.81 %),503,2601600,5172.17,324,1723550,5320,878050
2012-02-15,12.4 ( -2.36 %),509,2016190,3961.08,518,2942380,5680,-926190
2012-02-14,12.7 ( 3.25 %),570,3079240,5402.18,375,1911470,5097,1167770
2012-02-13,12.3 ( -2.38 %),508,1365910,2688.8,365,1824480,4999,-458570
2012-02-10,13.2 ( -1.49 %),820,4336770,5288.74,1254,6334740,5052,-1997970
2012-02-09,13.4 ( 2.29 %),1068,6248160,5850.34,1384,6842270,4944,-594110
2012-02-08,13.1 ( 3.97 %),688,4413750,6415.33,810,3959720,4889,454030
2012-02-07,12.6 ( 0.8 %),444,1925090,4335.79,489,2339240,4784,-414150
2012-02-06,12.5 ( -2.34 %),444,1552620,3496.89,495,2789000,5634,-1236380
2012-02-03,12.8 ( 1.59 %),858,5115040,5961.59,900,4843420,5382,271620
2012-02-02,12.6 ( 5 %),532,2866880,5388.87,451,1570120,3481,1296760
2012-02-01,12 ( -0.83 %),261,1113540,4266.44,324,1141910,3524,-28370
2012-01-31,12.1 ( 0.83 %),365,1186460,3250.58,421,1546340,3673,-359880
2012-01-30,12 ( 1.69 %),273,739530,2708.9,247,772590,3128,-33060
2012-01-20,11.8 ( -0.84 %),230,594160,2583.3,278,896200,3224,-302040
2012-01-19,11.9 ( 3.48 %),247,663610,2686.68,202,498120,2466,165490
2012-01-18,11.5 ( 0 %),257,734620,2858.44,226,671930,2973,62690
2012-01-17,11.5 ( -2.54 %),241,875470,3632.66,338,1640470,4853,-765000
2012-01-16,11.8 ( 2.61 %),302,1022480,3385.7,296,1005790,3398,16690
2012-01-13,11.5 ( 1.77 %),318,1520190,4780.47,250,676640,2707,843550
2012-01-12,11.3 ( 1.8 %),275,1214570,4416.62,292,917510,3142,297060
2012-01-11,11.1 ( 0.91 %),247,1385570,5609.6,298,1235680,4147,149890
2012-01-10,11 ( 1.85 %),308,1721440,5589.09,279,1288740,4619,432700
2012-01-09,10.8 ( 0.93 %),188,1080510,5747.39,187,725890,3882,354620
2012-01-06,10.7 ( 0 %),189,855550,4526.72,192,802290,4179,53260
2012-01-05,10.7 ( -1.83 %),199,873000,4386.93,209,957670,4582,-84670
2012-01-04,10.9 ( 0 %),247,1024140,4146.32,230,751570,3268,272570
2012-01-03,10.9 ( 0.93 %),194,935800,4823.71,203,755670,3723,180130
2011-12-30,10.8 ( 0 %),215,1259010,5855.86,234,1052620,4498,206390
2011-12-29,10.8 ( 1.89 %),261,1473880,5647.05,260,1386550,5333,87330
2011-12-28,10.6 ( 0.95 %),541,2599000,4804.07,254,2299140,9052,299860
2011-12-27,10.5 ( -4.55 %),376,2137330,5684.39,332,2753690,8294,-616360
2011-12-26,11 ( -0.9 %),371,1471680,3966.79,224,1622820,7245,-151140
2011-12-23,11.1 ( -0.89 %),229,1167360,5097.64,239,971370,4064,195990
2011-12-22,11.2 ( -1.75 %),222,1019770,4593.56,280,1328290,4744,-308520
2011-12-21,11.4 ( 0.88 %),211,1380030,6540.43,199,1031390,5183,348640
2011-12-20,11.3 ( 0 %),222,1513350,6816.89,231,967610,4189,545740
2011-12-19,11.3 ( 0 %),211,882810,4183.93,272,1006480,3700,-123670
2011-12-16,11.3 ( 0 %),260,1174220,4516.23,259,1232020,4757,-57800
2011-12-15,11.3 ( 0 %),269,1704570,6336.69,316,1488010,4709,216560
2011-12-14,11.3 ( -0.88 %),309,1662820,5381.29,380,2089120,5498,-426300
2011-12-13,11.4 ( -0.87 %),268,1248590,4658.92,326,1526840,4684,-278250
2011-12-12,11.5 ( 0.88 %),282,1403700,4977.66,266,1225590,4607,178110
2011-12-09,11.4 ( -1.72 %),377,1573670,4174.19,252,1682480,6677,-108810
2011-12-08,11.6 ( -0.85 %),309,1449630,4691.36,223,1128780,5062,320850
2011-12-07,11.7 ( 0.86 %),578,2205780,3816.23,321,1963760,6118,242020
2011-12-06,12.8 ( -1.54 %),283,1189320,4202.54,441,1961270,4447,-771950
2011-12-05,13 ( 2.36 %),420,1795660,4275.38,413,1584690,3837,210970
2011-12-02,12.7 ( 0 %),317,1208640,3812.74,304,1404340,4620,-195700
2011-12-01,12.7 ( 1.6 %),356,1903380,5346.57,422,1667410,3951,235970
2011-11-30,12.5 ( -2.34 %),361,1548530,4289.56,509,2590780,5090,-1042250
2011-11-29,12.8 ( 1.59 %),364,2130490,5852.99,534,2394490,4484,-264000
2011-11-28,12.6 ( 2.44 %),398,1978450,4970.98,401,1748840,4361,229610
2011-11-25,12.3 ( -0.81 %),390,1211460,3106.31,252,1121910,4452,89550
2011-11-24,12.4 ( -2.36 %),275,813860,2959.49,351,1516670,4321,-702810
2011-11-23,12.7 ( -0.78 %),334,1056500,3163.17,501,2252700,4496,-1196200
2011-11-22,12.8 ( 3.23 %),587,2237310,3811.43,527,2013430,3821,223880
2011-11-21,12.4 ( 3.33 %),528,2846310,5390.74,471,1623780,3448,1222530
2011-11-18,12 ( 0.84 %),359,2676340,7454.99,403,2226240,5524,450100
2011-11-17,11.9 ( 0 %),314,1657710,5279.33,267,1338040,5011,319670
2011-11-16,11.9 ( 0.85 %),350,1724170,4926.2,328,1790400,5459,-66230
2011-11-15,11.8 ( -0.84 %),219,834180,3809.04,209,665280,3183,168900
2011-11-14,11.9 ( -0.83 %),304,1213090,3990.43,305,1146190,3758,66900
2011-11-11,12 ( 1.69 %),621,2146490,3456.51,431,2037640,4728,108850
2011-11-10,11.8 ( 1.72 %),698,2839680,4068.31,433,2077910,4799,761770
2011-11-09,11.6 ( -3.33 %),572,1771950,3097.81,283,1341280,4740,430670
2011-11-08,12 ( -2.44 %),598,2047540,3423.98,401,1907700,4757,139840
2011-11-07,12.3 ( -4.65 %),569,1604470,2819.81,412,2068410,5020,-463940
2011-11-04,12.9 ( -1.53 %),513,1274700,2484.8,181,1070050,5912,204650
2011-11-03,13.1 ( -0.76 %),732,2549980,3483.58,278,1818500,6541,731480
2011-11-02,13.2 ( -4.35 %),686,1480410,2158.03,375,2635110,7027,-1154700
2011-11-01,13.8 ( 0 %),1846,4538020,2458.3,971,7127580,7340,-2589560
