Ngày,Thay đổi,Số lệnh mua,Kl mua,KLTB 1 lệnh mua,Số lệnh bán,Kl bán,KLTB 1 lệnh bán,Kl ròng
2025-05-09,0 ( 0 %),0,0,0,0,0,0,0
2025-05-07,109.7 ( 0 %),0,0,0,0,0,0,0
2025-05-06,109.7 ( 1.01 %),0,0,0,0,0,0,0
2025-05-05,108.6 ( -0.73 %),0,0,0,0,0,0,0
2025-04-29,109.4 ( -0.09 %),6809,5534900,812.88,4932,5901900,1197,-367000
2025-04-28,109.5 ( -2.58 %),11099,6993800,630.13,5639,7651100,1357,-657300
2025-04-25,112.4 ( 0.36 %),7751,8169300,1053.97,7147,9797800,1371,-1628500
2025-04-24,112 ( 1.45 %),9441,12006800,1271.77,12598,14434000,1146,-2427200
2025-04-23,110.4 ( 0 %),11289,9540900,845.15,9656,12335200,1277,-2794300
2025-04-22,110.4 ( -1.16 %),17722,14790600,834.59,9687,16100600,1662,-1310000
2025-04-21,111.7 ( 0.09 %),7024,6999500,996.51,7753,9738900,1256,-2739400
2025-04-18,111.6 ( 2.01 %),10301,11805100,1146.01,14844,15093900,1017,-3288800
2025-04-17,109.4 ( 1.39 %),16239,18071400,1112.84,12362,14933200,1208,3138200
2025-04-16,107.9 ( -6.98 %),30819,23249400,754.39,13137,29043600,2211,-5794200
2025-04-15,116 ( -2.11 %),14498,12389000,854.53,8766,15141900,1727,-2752900
2025-04-14,118.5 ( 0 %),16987,14949400,880.05,9602,17891100,1863,-2941700
2025-04-11,118.5 ( 5.24 %),23521,30094900,1279.49,15887,34804900,2191,-4710000
2025-04-10,112.6 ( 6.93 %),19225,44690400,2324.6,607,1005400,1656,43685000
2025-04-09,105.3 ( 0.19 %),22242,33074900,1487.05,16306,24979800,1532,8095100
2025-04-08,105.1 ( -6.99 %),15959,21376700,1339.48,11741,25837800,2201,-4461100
2025-04-04,113 ( -0.44 %),21005,34089300,1622.91,15773,27195800,1724,6893500
2025-04-03,113.5 ( -6.97 %),17188,14974200,871.2,11157,24099500,2160,-9125300
2025-04-02,122 ( 1.24 %),6002,7456000,1242.25,5829,6327700,1086,1128300
2025-04-01,120.5 ( -0.41 %),15756,15677200,995,8060,11778100,1461,3899100
2025-03-31,121 ( -2.42 %),11265,8697200,772.06,4735,8333400,1760,363800
2025-03-28,124 ( -1.74 %),6775,5329600,786.66,4542,5768600,1270,-439000
2025-03-27,126.2 ( 2.6 %),12381,15964600,1289.44,9603,10339300,1077,5625300
2025-03-26,123 ( -2.77 %),22305,18174000,814.79,7877,14328600,1819,3845400
2025-03-25,126.5 ( -1.94 %),10409,8746100,840.24,7306,10538100,1442,-1792000
2025-03-24,129 ( 0.78 %),7142,8487900,1188.45,8046,8998500,1118,-510600
2025-03-21,128 ( 2.4 %),12215,12135400,993.48,11719,12266800,1047,-131400
2025-03-20,125 ( 0.32 %),13899,14561400,1047.66,8742,11804400,1350,2757000
2025-03-19,124.6 ( -4.15 %),36314,28048200,772.38,15221,26193600,1721,1854600
2025-03-18,130 ( 0 %),11750,10752100,915.07,6548,8310000,1269,2442100
2025-03-17,130 ( -1.07 %),15511,11796600,760.53,7327,10266200,1401,1530400
2025-03-14,131.4 ( -3.74 %),32682,25326600,774.94,10600,22107000,2086,3219600
2025-03-12,135.9 ( -1.16 %),16342,10205900,624.52,5789,9949600,1719,256300
2025-03-11,137.5 ( -1.29 %),16017,10925000,682.09,5185,8902900,1717,2022100
2025-03-10,139.3 ( -1.49 %),12252,8766900,715.55,5215,8085700,1550,681200
2025-03-07,0 ( 0 %),5007,6132000,1224.69,5310,5592300,1053,539700
2025-03-06,141.6 ( 1.8 %),6391,11540900,1805.81,9690,9944400,1026,1596500
2025-03-05,139.1 ( -0.64 %),6713,5137200,765.26,3508,5575900,1589,-438700
2025-03-04,140 ( -0.36 %),7122,7035600,987.87,3760,5837300,1552,1198300
2025-03-03,140.5 ( 0.14 %),4470,4695000,1050.34,3977,4703700,1183,-8700
2025-02-28,140.3 ( -0.71 %),11226,9638900,858.62,4706,7849900,1668,1789000
2025-02-27,141.3 ( -0.35 %),6158,5945700,965.52,5715,5615400,983,330300
2025-02-26,141.8 ( 2.01 %),6994,6565300,938.7,5954,5098300,856,1467000
2025-02-25,139 ( -1.07 %),15157,13845300,913.46,7231,10285100,1422,3560200
2025-02-24,140.5 ( -1.06 %),15565,12194500,783.46,7955,10961100,1378,1233400
2025-02-21,142 ( -0.7 %),11433,8729400,763.53,5258,8403900,1598,325500
2025-02-20,143 ( -0.69 %),6464,5158200,797.99,3805,6584900,1731,-1426700
2025-02-19,144 ( 0.07 %),6262,5414500,864.66,3428,4917400,1434,497100
2025-02-18,143.9 ( 0.21 %),4722,3369200,713.51,3478,3186700,916,182500
2025-02-17,143.6 ( -0.9 %),5253,4674700,889.91,3781,4153000,1098,521700
2025-02-14,144.9 ( 1.26 %),4567,5738600,1256.54,5229,5072500,970,666100
2025-02-13,143.1 ( -1.31 %),6839,5214700,762.49,4258,5658900,1329,-444200
2025-02-12,145 ( -0.28 %),3567,3945200,1106.03,3583,3977900,1110,-32700
2025-02-11,145.4 ( 2.39 %),12220,10402000,851.23,5984,7527000,1258,2875000
2025-02-10,142 ( -2.81 %),15765,11088900,703.39,7490,11497000,1535,-408100
2025-02-07,146.1 ( -0.27 %),5189,6353900,1224.49,4042,5642300,1396,711600
2025-02-06,146.5 ( 0.14 %),6689,6215200,929.17,5459,5563300,1019,651900
2025-02-05,146.3 ( 0.07 %),8247,7738600,938.35,4768,7707000,1616,31600
2025-02-04,146.2 ( 0.48 %),10816,9777300,903.97,4875,7924300,1625,1853000
2025-02-03,0 ( 0 %),23502,18494800,786.95,9669,20946900,2166,-2452100
2025-01-24,153.4 ( -0.58 %),4877,6648600,1363.26,5946,5997300,1009,651300
2025-01-23,154.3 ( 3.07 %),7367,11613100,1576.37,10394,11994400,1154,-381300
2025-01-22,149.7 ( -0.13 %),4461,4930400,1105.22,5533,5524900,999,-594500
2025-01-21,149.9 ( -0.07 %),3949,4033500,1021.4,5697,5615800,986,-1582300
2025-01-20,150 ( 0.67 %),3119,5157700,1653.64,3616,4575000,1265,582700
2025-01-17,149 ( 1.71 %),5347,7052700,1319,5908,6277500,1063,775200
2025-01-16,146.5 ( 0.69 %),4773,5523800,1157.3,4114,4910500,1194,613300
2025-01-15,145.5 ( 0.28 %),6234,5498300,881.99,4252,4330100,1018,1168200
2025-01-14,145.1 ( -1.69 %),7352,5166200,702.69,3547,4712900,1329,453300
2025-01-13,147.6 ( 0.2 %),6938,6270500,903.79,3653,6035300,1652,235200
2025-01-10,147.3 ( -1.01 %),4635,3630300,783.24,3267,5068100,1551,-1437800
2025-01-09,148.8 ( 0.34 %),4824,3219300,667.35,2367,3232500,1366,-13200
2025-01-08,148.3 ( -1.2 %),9274,6611600,712.92,4632,6746600,1457,-135000
2025-01-07,150.1 ( 0.54 %),5060,5574900,1101.76,4920,6373000,1295,-798100
2025-01-06,149.3 ( 0.2 %),6846,6048200,883.46,4435,6090700,1373,-42500
2025-01-03,149 ( -1.97 %),7060,6640800,940.62,2671,7229000,2706,-588200
2025-01-02,152 ( -0.33 %),6365,5814000,913.43,3849,5915300,1537,-101300
2024-12-31,152.5 ( 1.33 %),4031,6133100,1521.48,5061,7513200,1485,-1380100
2024-12-30,150.5 ( 0.6 %),4099,3896000,950.48,2188,3480100,1591,415900
2024-12-27,149.6 ( -0.13 %),4087,4644200,1136.33,1871,4430400,2368,213800
2024-12-26,149.8 ( -0.66 %),4301,3743200,870.31,2735,4655500,1702,-912300
2024-12-25,150.8 ( 0.27 %),3250,4250600,1307.88,3671,4492400,1224,-241800
2024-12-24,150.4 ( 0.4 %),2796,4244300,1517.99,3486,4376800,1256,-132500
2024-12-23,149.8 ( 0.2 %),3432,4702000,1370.05,2671,4341600,1625,360400
2024-12-20,149.5 ( 0.95 %),8038,6611600,822.54,4658,6191900,1329,419700
2024-12-19,148.1 ( -0.4 %),11561,9697500,838.81,3911,6468300,1654,3229200
2024-12-18,148.7 ( 0.47 %),5918,5903600,997.57,3851,4562900,1185,1340700
2024-12-17,148 ( -1.27 %),10441,11013400,1054.82,5026,9397400,1870,1616000
2024-12-16,149.9 ( 0.27 %),6916,6749000,975.85,5285,5123900,970,1625100
2024-12-13,149.5 ( -0.47 %),9167,5634700,614.67,4195,5661100,1349,-26400
2024-12-12,150.2 ( -0.2 %),6666,6363100,954.56,5480,8085900,1476,-1722800
2024-12-11,150.5 ( 0.67 %),8043,7964200,990.2,6369,8055700,1265,-91500
2024-12-10,149.5 ( 1.7 %),7324,6165600,841.84,3540,5615500,1586,550100
2024-12-09,147 ( -1.67 %),10556,8166900,773.67,4966,8527900,1717,-361000
2024-12-06,149.5 ( 0.67 %),7843,6533400,833.02,8180,10049700,1229,-3516300
2024-12-05,148.5 ( 3.48 %),6685,7643100,1143.32,6545,7721200,1180,-78100
2024-12-04,143.5 ( -1.03 %),5523,8099200,1466.45,5961,8681600,1456,-582400
2024-12-03,145 ( 1.97 %),6694,7483300,1117.91,7106,8404200,1183,-920900
2024-12-02,142.2 ( -0.77 %),7631,10897600,1428.07,8555,11482200,1342,-584600
2024-11-29,144.3 ( 3.52 %),8811,17707500,2009.7,14902,18400800,1235,-693300
2024-11-28,139.4 ( 0.36 %),4267,7605400,1782.38,8686,10652300,1226,-3046900
2024-11-27,138.9 ( 2.74 %),7111,16276400,2288.9,13610,18231100,1340,-1954700
2024-11-26,135.2 ( 0.97 %),4113,7316900,1778.97,5635,7131600,1266,185300
2024-11-25,133.9 ( 0 %),2533,3330300,1314.77,3209,4370400,1362,-1040100
2024-11-22,133.9 ( 0.68 %),3067,4856800,1583.57,5299,6301100,1189,-1444300
2024-11-21,133 ( 0.45 %),5793,6265800,1081.62,3348,5315200,1588,950600
2024-11-20,132.4 ( 1.85 %),15019,14959400,996.03,8597,12091100,1406,2868300
2024-11-19,130 ( -2.99 %),14012,12392600,884.43,5958,11596300,1946,796300
2024-11-18,134 ( 0.07 %),7425,7150000,962.96,3272,6371300,1947,778700
2024-11-14,136 ( -1.31 %),4440,6615100,1489.89,5563,9565400,1719,-2950300
2024-11-13,137.8 ( 0.73 %),3503,5975700,1705.88,5401,7058300,1307,-1082600
2024-11-12,136.8 ( -1.08 %),4202,4399400,1046.98,4259,6049200,1420,-1649800
2024-11-11,138.3 ( 1.84 %),3565,9315800,2613.13,7502,10226100,1363,-910300
2024-11-08,135.8 ( 0.52 %),2604,3601800,1383.18,3351,4324200,1290,-722400
2024-11-07,135.1 ( 0.37 %),4476,5224400,1167.2,4591,7130700,1553,-1906300
2024-11-06,0 ( 0 %),2719,3272700,1203.64,2097,2969700,1416,303000
2024-11-05,132.6 ( -0.15 %),5399,3553000,658.08,1878,2707900,1442,845100
2024-11-04,132.8 ( -1.34 %),5599,4854700,867.07,1757,4972600,2830,-117900
2024-11-01,134.6 ( -0.96 %),5541,4320300,779.7,2765,4633400,1676,-313100
2024-10-31,135.9 ( 0 %),2972,2491900,838.46,1738,2593300,1492,-101400
2024-10-30,135.9 ( 0.37 %),2020,3220000,1594.06,2422,3140100,1296,79900
2024-10-29,135.4 ( 0.37 %),3328,3641500,1094.2,1994,5051100,2533,-1409600
2024-10-28,134.9 ( 0.67 %),2727,3148900,1154.71,1817,2795300,1538,353600
2024-10-25,134 ( -0.22 %),3907,3334400,853.44,2614,3361700,1286,-27300
2024-10-24,134.3 ( 0.07 %),3678,3962900,1077.46,2252,3610900,1603,352000
2024-10-23,134.2 ( 0.83 %),5228,6012500,1150.06,2938,4491700,1529,1520800
2024-10-22,133.1 ( -1.77 %),9707,8800800,906.64,3327,9045000,2719,-244200
2024-10-21,135.5 ( -1.09 %),4331,4356000,1005.77,3316,6335400,1911,-1979400
2024-10-18,137 ( 0 %),3677,4545600,1236.23,2812,3828700,1362,716900
2024-10-17,137 ( 0.51 %),4664,5395200,1156.78,2653,4049000,1526,1346200
2024-10-16,136.3 ( -0.51 %),4956,4988500,1006.56,3517,4369900,1243,618600
2024-10-15,137 ( -0.44 %),5814,5218500,897.57,4140,5089700,1229,128800
2024-10-14,137.6 ( -1.43 %),8703,8207000,943.01,7909,9846900,1245,-1639900
2024-10-11,139.6 ( -1.48 %),5419,6262600,1155.67,4945,6969300,1409,-706700
2024-10-10,141.7 ( 4.65 %),10561,16428600,1555.59,11992,14592000,1217,1836600
2024-10-09,135.4 ( 1.2 %),3018,4465000,1479.46,4229,5483600,1297,-1018600
2024-10-08,133.8 ( -0.22 %),3616,3752700,1037.8,2653,3632400,1369,120300
2024-10-07,134.1 ( 0 %),2231,2303800,1032.63,2383,2515200,1055,-211400
2024-10-04,134.1 ( 0.07 %),2830,3433400,1213.22,1910,2739300,1434,694100
2024-10-03,134 ( -1.03 %),2411,3590100,1489.05,4043,4781800,1183,-1191700
2024-10-02,135.4 ( -0.37 %),3045,2924100,960.3,2787,3356700,1204,-432600
2024-10-01,135.9 ( 1.04 %),3810,6369800,1671.86,6561,8416800,1283,-2047000
2024-09-30,134.5 ( 0.22 %),4631,4602200,993.78,2707,4540200,1677,62000
2024-09-27,134.2 ( -0.07 %),5727,4814300,840.63,2898,5461100,1884,-646800
2024-09-26,134.3 ( -0.37 %),4126,4269700,1034.83,3399,5151500,1516,-881800
2024-09-25,134.8 ( 0.22 %),5516,6737400,1221.43,3893,6413200,1647,324200
2024-09-24,134.5 ( 0.37 %),2900,3264100,1125.55,2833,3257900,1150,6200
2024-09-23,134 ( -0.96 %),3675,3936800,1071.24,2489,4651100,1869,-714300
2024-09-20,135.3 ( 0.07 %),3421,5405800,1580.18,6265,7395900,1181,-1990100
2024-09-19,135.2 ( 0.45 %),4344,8383300,1929.86,7807,8528900,1092,-145600
2024-09-18,134.6 ( 1.28 %),4060,7701500,1896.92,8648,9971800,1153,-2270300
2024-09-17,132.9 ( 1.37 %),3614,4277000,1183.45,3643,4787000,1314,-510000
2024-09-16,131.1 ( -1.43 %),3854,4714500,1223.27,2738,4042200,1476,672300
2024-09-13,133 ( 0.53 %),2526,5471800,2166.19,5486,7269600,1325,-1797800
2024-09-12,132.3 ( 1.3 %),2728,6294700,2307.44,5716,6963800,1218,-669100
2024-09-11,130.6 ( 0.46 %),3182,5053300,1588.09,3132,5644500,1802,-591200
2024-09-10,130 ( -0.99 %),4677,6219000,1329.7,3610,7320100,2028,-1101100
2024-09-09,131.3 ( -0.61 %),3982,5012300,1258.74,4002,4661700,1165,350600
2024-09-06,132.1 ( 1.15 %),3375,5583400,1654.34,5052,6107200,1209,-523800
2024-09-05,130.6 ( -1.8 %),9457,11326000,1197.63,6258,12197800,1949,-871800
2024-09-04,133 ( -1.34 %),7260,6832800,941.16,4222,7562200,1791,-729400
2024-08-30,134.8 ( 0.82 %),2960,5468900,1847.6,6283,7981400,1270,-2512500
2024-08-29,133.7 ( 0.3 %),3750,3627300,967.28,4146,5097300,1229,-1470000
2024-08-28,133.3 ( 0.6 %),3836,4128700,1076.3,5942,6891500,1160,-2762800
2024-08-27,132.5 ( 0.76 %),3674,4274300,1163.39,3505,4491600,1281,-217300
2024-08-26,131.5 ( -1.2 %),4775,3898000,816.34,2804,4772300,1702,-874300
2024-08-23,133.1 ( -0.52 %),4148,5096800,1228.74,4598,6153700,1338,-1056900
2024-08-22,133.8 ( 0.22 %),3685,4804600,1303.83,5965,7554000,1266,-2749400
2024-08-21,133.5 ( 1.52 %),6051,10242800,1692.75,7461,10529500,1411,-286700
2024-08-20,131.5 ( 0.77 %),3944,5541400,1405.02,6303,9380600,1488,-3839200
2024-08-19,130.5 ( -0.08 %),3640,4332000,1190.11,4688,5650100,1205,-1318100
2024-08-16,130.6 ( 1.48 %),5357,8068000,1506.07,7386,8855800,1199,-787800
2024-08-15,128.7 ( -0.62 %),3981,4396800,1104.45,3134,4480800,1430,-84000
2024-08-14,129.5 ( -0.15 %),2748,5073900,1846.4,5503,6886300,1251,-1812400
2024-08-13,129.7 ( -0.23 %),4665,7111400,1524.42,6644,7782300,1171,-670900
2024-08-12,130 ( 2.44 %),5490,14109000,2569.95,8549,10665100,1248,3443900
2024-08-08,121.4 ( -0.49 %),4037,4570400,1132.13,3497,4834500,1382,-264100
2024-08-07,122 ( 0.99 %),4884,6116700,1252.4,3073,5184700,1687,932000
2024-08-06,120.8 ( 1.85 %),6309,14036800,2224.89,8520,10229000,1201,3807800
2024-08-05,118.6 ( -3.73 %),13687,14483000,1058.16,7044,15789200,2242,-1306200
2024-08-02,123.2 ( -1.28 %),13226,18225300,1377.99,7029,12902000,1836,5323300
2024-08-01,124.8 ( -2.95 %),8473,10261300,1211.06,6662,12313700,1848,-2052400
2024-07-31,128.6 ( 0.47 %),4511,5254100,1164.73,3041,4542500,1494,711600
2024-07-30,128 ( -0.78 %),4192,4430000,1056.77,3013,4718100,1566,-288100
2024-07-29,129 ( 0.78 %),4721,7254900,1536.73,5187,8751200,1687,-1496300
2024-07-26,128 ( 2.4 %),5907,7044200,1192.52,3638,6011200,1652,1033000
2024-07-25,125 ( -0.79 %),5935,5308600,894.46,2440,4508600,1848,800000
2024-07-24,126 ( 0.4 %),6239,7419500,1189.21,4548,6877400,1512,542100
2024-07-22,124.1 ( -1.51 %),11421,11368900,995.44,5730,9464000,1652,1904900
2024-07-19,126 ( -1.49 %),13956,10730700,768.9,5916,12180800,2059,-1450100
2024-07-18,127.9 ( -3.03 %),16030,17225000,1074.55,7157,14964500,2091,2260500
2024-07-17,131.9 ( -1.57 %),7976,10881600,1364.29,5358,11183500,2087,-301900
2024-07-16,134 ( 0.98 %),4460,7149200,1602.96,4563,6832900,1497,316300
2024-07-15,132.7 ( -0.82 %),6450,6112200,947.63,4299,5850800,1361,261400
2024-07-12,133.8 ( 0.6 %),7189,7839300,1090.46,4696,6934000,1477,905300
2024-07-11,0 ( 0 %),12661,12280100,969.92,6031,9489600,1573,2790500
2024-07-10,134 ( -2.55 %),11043,9956300,901.59,5661,9363600,1654,592700
2024-07-09,137.5 ( -1.5 %),11263,15442900,1371.12,9799,14521500,1482,921400
2024-07-08,139.6 ( 0.65 %),3841,10422500,2713.49,6219,8672500,1395,1750000
2024-07-05,138.7 ( 2.14 %),5470,11931600,2181.28,10349,11920700,1152,10900
2024-07-04,135.8 ( 3.66 %),4240,14410100,3398.61,10431,12529500,1201,1880600
2024-07-03,131 ( 2.34 %),5355,14892400,2781.03,8335,12261500,1471,2630900
2024-07-02,128 ( -0.47 %),7033,14043700,1996.83,7014,10440100,1488,3603600
2024-07-01,128.6 ( -1.46 %),7460,9596500,1286.39,7302,9854600,1350,-258100
2024-06-28,130.5 ( -1.73 %),5077,9460800,1863.46,6379,10375700,1627,-914900
2024-06-27,132.8 ( 0.76 %),3967,9940200,2505.72,7773,10638900,1369,-698700
2024-06-26,131.8 ( 1.38 %),5853,10758000,1838.03,5509,10886400,1976,-128400
2024-06-25,130 ( -1.59 %),13575,21105600,1554.74,7822,23993400,3067,-2887800
2024-06-24,132.1 ( -2.94 %),10265,17792000,1733.27,10949,18128100,1656,-336100
2024-06-21,136.1 ( 2.1 %),5691,11715300,2058.57,9232,11679400,1265,35900
2024-06-20,133.3 ( 1.37 %),6413,14426200,2249.52,11877,14701100,1238,-274900
2024-06-19,131.5 ( 2.73 %),11800,15984900,1354.65,10298,14125600,1372,1859300
2024-06-18,128 ( -0.62 %),9011,9531300,1057.74,5830,9761100,1674,-229800
2024-06-17,128.8 ( -1.68 %),9589,7870400,820.77,4924,8535300,1733,-664900
2024-06-14,131 ( 0.77 %),11003,12357200,1123.08,7719,9825700,1273,2531500
2024-06-13,130 ( -1.52 %),13758,12421900,902.89,7674,11797500,1537,624400
2024-06-12,132 ( 4.33 %),17305,20033300,1157.66,9431,15355300,1628,4678000
2024-06-11,146.5 ( 1.74 %),5627,12235200,2174.37,7180,8939800,1245,3295400
2024-06-10,144 ( 1.41 %),4919,7039700,1431.12,6069,6346700,1046,693000
2024-06-07,142 ( 1.72 %),4175,8404000,2012.93,5116,5806000,1135,2598000
2024-06-06,139.6 ( -0.36 %),5153,7942900,1541.41,6406,8506300,1328,-563400
2024-06-05,140.1 ( 0.72 %),7975,10349900,1297.79,7501,10843900,1446,-494000
2024-06-04,139.1 ( 1.61 %),4232,10296700,2433.06,9466,11047700,1167,-751000
2024-06-03,136.9 ( 1.71 %),3731,11302100,3029.24,9125,14123900,1548,-2821800
2024-05-31,134.6 ( -0.3 %),4374,4974200,1137.22,4357,6566400,1507,-1592200
2024-05-30,135 ( -0.52 %),12403,11763500,948.44,5931,10798900,1821,964600
2024-05-29,135.7 ( -0.95 %),6802,9646400,1418.17,5977,10515700,1759,-869300
2024-05-28,137 ( 3.16 %),4149,8964700,2160.69,6756,8588600,1271,376100
2024-05-27,132.8 ( 0.68 %),7233,9119400,1260.8,3782,8587700,2271,531700
2024-05-24,131.9 ( -4.07 %),21790,20546300,942.92,7697,20189300,2623,357000
2024-05-23,137.5 ( -0.36 %),6813,7524300,1104.4,4278,6072900,1420,1451400
2024-05-22,138 ( 1.47 %),4559,7306000,1602.54,5751,7464200,1298,-158200
2024-05-21,136 ( 2.26 %),4594,6331600,1378.23,3539,6270200,1772,61400
2024-05-20,133 ( -1.12 %),3725,3128500,839.87,2688,3870600,1440,-742100
2024-05-17,134.5 ( -0.66 %),6102,4547100,745.18,2891,4388600,1518,158500
2024-05-16,135.4 ( 0.97 %),3792,4846500,1278.09,4182,5721900,1368,-875400
2024-05-15,134.1 ( 2.76 %),3869,6771900,1750.3,4182,6658700,1592,113200
2024-05-14,130.5 ( 0.62 %),3699,4663500,1260.75,2934,4880800,1664,-217300
2024-05-13,129.7 ( -0.99 %),3895,3413300,876.33,2240,3803600,1698,-390300
2024-05-10,131 ( 0.54 %),5174,6940100,1341.34,3444,6425000,1866,515100
2024-05-09,130.3 ( -0.53 %),3865,4005300,1036.3,2897,4403200,1520,-397900
2024-05-08,131 ( -0.23 %),5286,5138800,972.15,2847,5124100,1800,14700
2024-05-07,131.3 ( 2.9 %),3712,5885900,1585.64,4708,6318800,1342,-432900
2024-05-06,127.6 ( 1.35 %),4694,6481700,1380.85,3518,5231000,1487,1250700
2024-05-03,125.9 ( -1.1 %),5625,5974300,1062.1,3441,5763800,1675,210500
2024-05-02,127.3 ( 3.33 %),4128,8406000,2036.34,5079,6710100,1321,1695900
2024-04-26,123.2 ( 0 %),5510,7507800,1362.58,4394,6780200,1543,727600
2024-04-25,123.2 ( 2.58 %),8234,10468300,1271.35,7771,9915700,1276,552600
2024-04-24,120.1 ( 6.95 %),7876,23074600,2929.74,9660,14752200,1527,8322400
2024-04-23,112.3 ( 1.81 %),4087,6751700,1651.99,4124,9634200,2336,-2882500
2024-04-22,110.3 ( 1.19 %),3737,5589700,1495.77,2553,4028500,1578,1561200
2024-04-19,109 ( -2.5 %),6700,9335900,1393.42,3126,7199100,2303,2136800
2024-04-17,111.8 ( -1.06 %),3697,3761600,1017.47,1673,3345400,2000,416200
2024-04-16,113 ( 1.25 %),5284,6904800,1306.74,3234,5544000,1714,1360800
2024-04-15,111.6 ( -3.38 %),4700,5293700,1126.32,2848,5717400,2008,-423700
2024-04-12,115.5 ( 0.52 %),2400,3537500,1473.96,2248,3220600,1433,316900
2024-04-11,114.9 ( 0.97 %),2309,3617000,1566.48,2571,3670300,1428,-53300
2024-04-10,113.8 ( 0.71 %),2233,6172600,2764.26,2503,3287700,1314,2884900
2024-04-09,113 ( 0.36 %),2925,3045000,1041.03,1720,2553600,1485,491400
2024-04-08,112.6 ( -0.97 %),3872,3587600,926.55,1679,3032000,1806,555600
2024-04-05,113.7 ( -0.26 %),5229,5767900,1103.06,1982,4173700,2106,1594200
2024-04-04,114 ( -0.96 %),4710,4290000,910.83,2314,4602400,1989,-312400
2024-04-03,115.1 ( -1.62 %),4388,4262400,971.38,1979,4295100,2170,-32700
2024-04-02,117 ( 0.17 %),3182,4258500,1338.31,1503,3245400,2159,1013100
2024-04-01,116.8 ( 0.26 %),3266,4077300,1248.41,2028,3528600,1740,548700
2024-03-29,116.5 ( -0.51 %),2292,2937100,1281.46,1855,3275900,1766,-338800
2024-03-28,117.1 ( 1.65 %),2641,5316200,2012.95,3654,5474300,1498,-158100
2024-03-27,115.2 ( 0.17 %),2810,2662800,947.62,1565,2434800,1556,228000
2024-03-26,115 ( 0.88 %),3147,3645200,1158.31,1943,3233800,1664,411400
2024-03-25,114 ( -0.78 %),3561,4707800,1322.04,2149,4793900,2231,-86100
2024-03-22,114.9 ( -1.12 %),4717,4455700,944.6,2499,4633800,1854,-178100
2024-03-21,116.2 ( 1.48 %),2633,5541200,2104.52,4104,6294700,1534,-753500
2024-03-20,114.5 ( 2.23 %),6155,7343000,1193.01,4186,5603400,1339,1739600
2024-03-19,112 ( -0.88 %),7120,6565500,922.12,2735,4714000,1724,1851500
2024-03-18,113 ( -2.59 %),10045,11547600,1149.59,4403,8850300,2010,2697300
2024-03-15,116 ( -0.85 %),6187,6693500,1081.87,2800,7139900,2550,-446400
2024-03-14,117 ( 0 %),4677,5671700,1212.68,3685,6641000,1802,-969300
2024-03-13,117 ( 4.56 %),4451,9097300,2043.88,5576,9509600,1705,-412300
2024-03-12,111.9 ( 1.73 %),3708,5526400,1490.4,4223,6391900,1514,-865500
2024-03-11,110 ( 0 %),4100,5386600,1313.8,3784,5836300,1542,-449700
2024-03-08,110 ( -1.17 %),5172,6297700,1217.65,2645,5395200,2040,902500
2024-03-07,111.3 ( 2.02 %),5503,7902500,1436.03,3660,6917200,1890,985300
2024-03-06,109 ( -1.54 %),5021,6100500,1215,2346,6096400,2599,4100
2024-03-05,110.7 ( -0.63 %),4616,5406700,1171.3,2236,5773000,2582,-366300
2024-03-04,111.4 ( 0.54 %),2765,5963000,2156.6,2598,5406900,2081,556100
2024-03-01,110.8 ( 1.65 %),3731,7037900,1886.33,3621,7241100,2000,-203200
2024-02-29,109 ( 0.46 %),3572,4689800,1312.93,2536,5433800,2143,-744000
2024-02-28,108.5 ( 0.56 %),5111,5837600,1142.16,2096,5980300,2853,-142700
2024-02-27,107.9 ( -0.09 %),3373,4173700,1237.39,2857,5195500,1819,-1021800
2024-02-26,108 ( 3.95 %),4182,7682000,1836.92,3932,6611300,1681,1070700
2024-02-23,103.9 ( -0.67 %),3931,6072200,1544.7,3239,7132200,2202,-1060000
2024-02-22,104.6 ( -1.23 %),3227,2953600,915.28,1824,3179200,1743,-225600
2024-02-21,105.9 ( 1.53 %),4552,5369400,1179.57,2395,4831700,2017,537700
2024-02-20,104.3 ( -0.67 %),2654,3177400,1197.21,1595,3511200,2201,-333800
2024-02-19,105 ( -0.1 %),2394,3462300,1446.24,2360,3822000,1619,-359700
2024-02-16,105.1 ( 1.06 %),1787,3434600,1921.99,1779,2961900,1665,472700
2024-02-15,104 ( -0.86 %),2334,3086700,1322.49,2235,3996900,1788,-910200
2024-02-07,104.9 ( 0.77 %),0,0,0,0,0,0,0
2024-02-06,104.1 ( 0.58 %),1991,3676300,1846.46,2798,4239900,1515,-563600
2024-02-05,103.5 ( 1.47 %),2352,4534500,1927.93,3352,5169300,1542,-634800
2024-02-02,102 ( 2.1 %),2638,5249000,1989.76,4463,5223300,1170,25700
2024-02-01,99.9 ( 4.39 %),5133,13434300,2617.24,8569,11719800,1368,1714500
2024-01-31,95.7 ( 0.1 %),1904,2627800,1380.15,1798,2881600,1603,-253800
2024-01-30,95.6 ( -0.31 %),1507,1809300,1200.6,1159,2047100,1766,-237800
2024-01-29,95.9 ( 0 %),1599,1827900,1143.15,1299,2391200,1841,-563300
2024-01-26,95.9 ( 0.84 %),1272,1845200,1450.63,1864,1992100,1069,-146900
2024-01-25,95.1 ( 0.11 %),1988,2034400,1023.34,1123,1745300,1554,289100
2024-01-24,95 ( -0.63 %),2679,2765400,1032.25,1317,3383300,2569,-617900
2024-01-23,95.6 ( -0.83 %),2515,2878100,1144.37,1634,3156000,1931,-277900
2024-01-22,96.4 ( 0.1 %),1510,1949100,1290.79,1853,2695100,1454,-746000
2024-01-19,96.3 ( 0.73 %),1643,2826400,1720.27,2511,3981300,1586,-1154900
2024-01-18,95.6 ( -0.1 %),1556,2456800,1578.92,1565,2639100,1686,-182300
2024-01-17,95.7 ( 0 %),2133,2798100,1311.81,1772,2975300,1679,-177200
2024-01-16,95.7 ( 0.31 %),1730,1947100,1125.49,1213,1953500,1610,-6400
2024-01-15,95.4 ( 0.74 %),1243,2640300,2124.14,1920,2640700,1375,-400
2024-01-12,94.7 ( -0.32 %),5075,5985000,1179.31,1826,3855300,2111,2129700
2024-01-11,95 ( 0.32 %),2830,3150100,1113.11,1329,2534500,1907,615600
2024-01-10,94.7 ( -1.97 %),0,0,0,0,0,0,0
2024-01-09,96.6 ( -0.72 %),2370,2033300,857.93,1404,2651600,1889,-618300
2024-01-08,97.3 ( -0.1 %),1507,2505500,1662.57,2972,3949800,1329,-1444300
2024-01-05,97.4 ( 0.21 %),1569,2302100,1467.24,1901,2769400,1457,-467300
2024-01-04,97.2 ( 0.93 %),2367,4835700,2042.97,4246,6039300,1422,-1203600
2024-01-03,96.3 ( 0.42 %),2496,2672800,1070.83,1737,2388400,1375,284400
2024-01-02,95.9 ( -0.21 %),2034,2814800,1383.87,1530,3444300,2251,-629500
2023-12-29,96.1 ( -0.52 %),0,0,0,0,0,0,0
2023-12-28,96.6 ( -0.31 %),2082,2194400,1053.99,1796,2515800,1401,-321400
2023-12-27,96.9 ( -0.31 %),1702,2666300,1566.57,2462,3549600,1442,-883300
2023-12-26,97.2 ( 1.25 %),3106,5493800,1768.77,4975,7321200,1472,-1827400
2023-12-25,96 ( 1.48 %),1588,3381800,2129.6,2719,4229400,1555,-847600
2023-12-22,94.6 ( -0.53 %),2234,2458500,1100.49,2343,3232400,1380,-773900
2023-12-21,95.1 ( 0.42 %),3008,3271200,1087.5,1851,2855700,1543,415500
2023-12-20,94.7 ( 0.11 %),1980,2561900,1293.89,1736,2530300,1458,31600
2023-12-19,94.6 ( 0.64 %),2720,2628700,966.43,1698,2533000,1492,95700
2023-12-18,94 ( -2.29 %),3899,3814900,978.43,1888,4601800,2437,-786900
2023-12-15,96.2 ( 0 %),2085,2474200,1186.67,1652,3321300,2010,-847100
2023-12-14,96.2 ( 1.05 %),1953,3273700,1676.24,2415,3497100,1448,-223400
2023-12-13,95.2 ( -1.65 %),2782,3673000,1320.27,2939,4810900,1637,-1137900
2023-12-12,96.8 ( 1.89 %),2723,7416800,2723.76,4270,6828400,1599,588400
2023-12-11,95 ( 0.85 %),1612,2694800,1671.71,3096,4287100,1385,-1592300
2023-12-08,94.2 ( -0.11 %),1780,3040600,1708.2,2209,3800200,1720,-759600
2023-12-07,94.3 ( -0.74 %),4164,6610300,1587.49,2646,6399600,2419,210700
2023-12-06,95 ( 0.21 %),1671,2242800,1342.19,1986,3563400,1794,-1320600
2023-12-05,94.8 ( 1.28 %),3386,7330600,2164.97,4389,7104000,1619,226600
2023-12-04,93.6 ( 1.3 %),2882,6189000,2147.47,4267,6036500,1415,152500
2023-12-01,92.4 ( 0.54 %),1660,2305800,1389.04,1819,3293200,1810,-987400
2023-11-30,91.9 ( 0.22 %),2300,4046800,1759.48,3283,4644300,1415,-597500
2023-11-29,91.7 ( 0.66 %),1150,1758300,1528.96,1436,2004600,1396,-246300
2023-11-28,91.1 ( 0.44 %),2428,2550800,1050.58,1423,2306900,1621,243900
2023-11-27,90.7 ( -0.55 %),2976,3607000,1212.03,1275,3089400,2423,517600
2023-11-24,91.2 ( 0.44 %),2493,3952500,1585.44,2154,4151700,1927,-199200
2023-11-23,90.8 ( -2.37 %),1864,2910000,1561.16,2858,5209500,1823,-2299500
2023-11-22,93 ( 1.2 %),1686,5203700,3086.42,3323,6381000,1920,-1177300
2023-11-21,91.9 ( 1.32 %),2077,3551300,1709.82,1570,3132000,1995,419300
2023-11-20,90.7 ( -0.33 %),3031,3462900,1142.49,1829,3191500,1745,271400
2023-11-17,91 ( -2.15 %),4738,5662400,1195.1,2205,8045000,3649,-2382600
2023-11-16,93 ( 0.65 %),2662,3958900,1487.19,1499,8090400,5397,-4131500
2023-11-15,92.4 ( -0.22 %),2021,3594900,1778.77,2777,7195100,2591,-3600200
2023-11-14,92.6 ( 1.31 %),1825,3518700,1928.05,2554,5792100,2268,-2273400
2023-11-13,91.4 ( -0.11 %),2222,2892100,1301.58,1555,2839600,1826,52500
2023-11-10,91.5 ( -1.08 %),2828,4231500,1496.29,2308,5658100,2452,-1426600
2023-11-09,92.5 ( -0.11 %),2580,4277900,1658.1,2717,4399600,1619,-121700
2023-11-08,92.6 ( 4.87 %),2552,5698600,2232.99,3658,4481900,1225,1216700
2023-11-07,88.3 ( -0.23 %),2016,2937900,1457.29,1770,2456700,1388,481200
2023-11-06,88.5 ( 1.72 %),1836,3403200,1853.59,2252,2504200,1112,899000
2023-11-03,87 ( -2.25 %),5665,13173400,2325.4,2102,6496300,3091,6677100
2023-11-01,85.4 ( 2.89 %),3028,3985800,1316.31,2371,3050800,1287,935000
2023-10-31,83 ( -2.35 %),4218,5530800,1311.24,2683,5242300,1954,288500
2023-10-30,85 ( -2.3 %),3091,3096400,1001.75,1636,3097500,1893,-1100
2023-10-27,87 ( 0.23 %),3573,4355100,1218.89,1948,3535500,1815,819600
2023-10-26,86.8 ( -4.51 %),10569,10555800,998.75,3709,9123900,2460,1431900
2023-10-25,90.9 ( -1.2 %),2742,3532800,1288.4,1725,3404600,1974,128200
2023-10-24,92 ( 1.1 %),2486,4082800,1642.32,2188,3663100,1674,419700
2023-10-23,91 ( -2.05 %),4235,4346600,1026.35,2037,4052300,1989,294300
2023-10-20,92.9 ( 0.98 %),5052,6124500,1212.29,3136,5150500,1642,974000
2023-10-19,92 ( -1.08 %),3683,7574600,2056.64,3182,7043400,2214,531200
2023-10-18,0 ( 0 %),6829,8755000,1282.03,3573,10883900,3046,-2128900
2023-10-17,93.1 ( -3.82 %),3110,4375700,1406.98,2578,6047200,2346,-1671500
2023-10-16,96.8 ( 0.73 %),4566,8752000,1916.78,5155,9539700,1851,-787700
2023-10-13,96.1 ( -0.31 %),3234,4421700,1367.25,2326,4227600,1818,194100
2023-10-12,96.4 ( -0.62 %),2222,3253900,1464.4,2710,5571800,2056,-2317900
2023-10-11,97 ( 0.73 %),2089,4852500,2322.88,3444,5914700,1717,-1062200
2023-10-10,96.3 ( 0.73 %),2791,6109000,2188.82,3487,6414800,1840,-305800
2023-10-09,95.6 ( 3.13 %),3309,6457100,1951.38,3507,5817500,1659,639600
2023-10-06,92.7 ( 1.2 %),2325,2833700,1218.8,1789,2025300,1132,808400
2023-10-05,91.6 ( -0.97 %),2586,2792300,1079.78,1439,2548500,1771,243800
2023-10-04,92.5 ( 0.33 %),2495,3643700,1460.4,1816,2955400,1627,688300
2023-10-03,92.2 ( -1.07 %),3229,4023400,1246.02,2178,3990900,1832,32500
2023-10-02,93.2 ( 0.43 %),2433,2720000,1117.96,1735,2708800,1561,11200
2023-09-29,92.8 ( -1.28 %),2681,3168900,1181.98,1849,3952900,2138,-784000
2023-09-28,94 ( -0.32 %),3758,4095300,1089.76,1960,3658800,1867,436500
2023-09-27,94.3 ( 0.86 %),6402,7956100,1242.75,3941,7229000,1834,727100
2023-09-26,93.5 ( -0.85 %),3346,4462700,1333.74,2381,4403100,1849,59600
2023-09-25,94.3 ( -2.48 %),3119,3878400,1243.48,2222,4341500,1954,-463100
2023-09-22,96.7 ( -0.1 %),6487,11185800,1724.34,2333,9400200,4029,1785600
2023-09-21,96.8 ( -1.73 %),4989,6317400,1266.27,2472,6140900,2484,176500
2023-09-20,98.5 ( 0.1 %),1929,3792200,1965.89,3176,6112100,1924,-2319900
2023-09-19,98.4 ( 1.55 %),3144,5494700,1747.68,2988,6358400,2128,-863700
2023-09-18,96.9 ( -0.62 %),2863,3620100,1264.44,1752,3561700,2033,58400
2023-09-15,97.5 ( 1.67 %),3201,4997900,1561.36,1955,3861200,1975,1136700
2023-09-14,95.9 ( -2.14 %),3985,3946200,990.26,2025,4318500,2133,-372300
2023-09-13,98 ( -0.91 %),3565,4782000,1341.37,3090,4952600,1603,-170600
2023-09-12,98.9 ( 1.54 %),2458,4524200,1840.6,2935,4668900,1591,-144700
2023-09-11,97.4 ( -0.2 %),5708,8244400,1444.36,3465,8045900,2322,198500
2023-09-08,97.6 ( -0.31 %),2575,3627800,1408.85,1951,4130700,2117,-502900
2023-09-07,97.9 ( -1.11 %),3369,5563100,1651.26,2720,5930200,2180,-367100
2023-09-06,99 ( 2.27 %),2853,4813200,1687.07,2412,4844900,2009,-31700
2023-09-05,96.8 ( 0.1 %),1492,3208800,2150.67,2091,2970200,1420,238600
2023-08-31,96.7 ( 0.1 %),2578,2658500,1031.23,2250,3256600,1447,-598100
2023-08-30,96.6 ( 3.21 %),2648,5418600,2046.3,3978,4067200,1022,1351400
2023-08-29,93.6 ( -0.43 %),2285,3194300,1397.94,2409,3078700,1278,115600
2023-08-28,94 ( 3.75 %),1887,5763600,3054.37,2796,4398900,1573,1364700
2023-08-25,90.6 ( 0.67 %),2118,5273200,2489.71,2726,5562400,2040,-289200
2023-08-24,90 ( 5.26 %),3102,8786100,2832.4,6239,7908100,1268,878000
2023-08-23,86.5 ( 0 %),1949,3215800,1649.97,1565,2356400,1506,859400
2023-08-22,86.5 ( 0.7 %),2562,4706800,1837.16,2114,4652000,2201,54800
2023-08-21,85.9 ( 0.47 %),1669,8389900,5026.9,2911,4553600,1564,3836300
2023-08-18,85.5 ( -0.58 %),2655,6590600,2482.34,3954,6632100,1677,-41500
2023-08-17,86 ( 1.06 %),2619,5255000,2006.49,3570,5604600,1570,-349600
2023-08-16,85.1 ( 1.31 %),1676,4855400,2897.02,3079,4323300,1404,532100
2023-08-15,84 ( 1.69 %),1837,3636200,1979.42,1717,2603000,1516,1033200
2023-08-14,82.6 ( 0.73 %),1357,1763100,1299.26,910,1731800,1903,31300
2023-08-11,82 ( -0.24 %),1931,1972300,1021.39,1323,2033900,1537,-61600
2023-08-10,82.2 ( -1.08 %),2109,1968300,933.29,1172,2163500,1846,-195200
2023-08-09,83.1 ( -1.31 %),1607,1604200,998.26,1128,1897500,1682,-293300
2023-08-08,84.2 ( -0.36 %),1164,1206600,1036.6,1044,1364500,1307,-157900
2023-08-07,84.5 ( 1.44 %),1393,1388400,996.7,1046,1357800,1298,30600
2023-08-04,83.3 ( -0.48 %),2580,4544000,1761.24,1056,2451800,2322,2092200
2023-08-03,83.7 ( 0.24 %),1917,2086500,1088.42,1315,1756500,1336,330000
2023-08-02,83.5 ( -1.18 %),1801,1658100,920.66,1260,1818700,1443,-160600
2023-08-01,84.5 ( -1.29 %),1273,1895300,1488.85,1829,2426300,1327,-531000
2023-07-31,85.6 ( 1.42 %),1371,2401700,1751.79,1730,2580900,1492,-179200
2023-07-28,84.4 ( 0.84 %),1434,1654200,1153.56,1528,1645200,1077,9000
2023-07-27,83.7 ( 1.21 %),1813,2488500,1372.59,2430,2399700,988,88800
2023-07-26,82.7 ( 1.72 %),1265,2157100,1705.22,1776,2072600,1167,84500
2023-07-25,81.3 ( 0.37 %),1645,1670900,1015.74,2046,2056100,1005,-385200
2023-07-24,81 ( 0 %),1438,1642700,1142.35,1582,2238500,1415,-595800
2023-07-21,81 ( 0.87 %),1650,2111200,1279.52,1380,1781700,1291,329500
2023-07-20,80.3 ( 2.29 %),1778,3346000,1881.89,3211,4359200,1358,-1013200
2023-07-19,78.5 ( -0.25 %),1496,1093400,730.88,1148,1574500,1372,-481100
2023-07-18,78.7 ( -0.38 %),1182,1243800,1052.28,1338,1697900,1269,-454100
2023-07-17,79 ( 0.89 %),1582,1904700,1203.98,1786,2348100,1315,-443400
2023-07-14,78.3 ( 3.3 %),2261,4557200,2015.57,3055,4564500,1494,-7300
2023-07-13,75.8 ( 0.66 %),1224,1737200,1419.28,1549,2526400,1631,-789200
2023-07-12,75.3 ( 0.4 %),1198,1727100,1441.65,1327,1761600,1328,-34500
2023-07-11,75 ( -0.4 %),1898,1823200,960.59,1547,1726700,1116,96500
2023-07-10,75.3 ( 0 %),1644,1955500,1189.48,1559,2204200,1414,-248700
2023-07-07,75.3 ( 0.94 %),1320,1430300,1083.56,1156,1481900,1282,-51600
2023-07-06,74.6 ( -0.27 %),2450,2621400,1069.96,1338,2657500,1986,-36100
2023-07-05,74.8 ( 0 %),3475,2659800,765.41,1727,3651300,2114,-991500
2023-07-04,87 ( 0.69 %),1280,1982300,1548.67,1064,2001300,1881,-19000
2023-07-03,86.4 ( 0.47 %),1301,1891200,1453.65,885,1711500,1934,179700
2023-06-30,86 ( -0.58 %),1175,1162100,989.02,772,1361200,1763,-199100
2023-06-29,86.5 ( -0.57 %),1009,1077100,1067.49,1116,1209400,1084,-132300
2023-06-28,87 ( -0.34 %),1221,1396200,1143.49,1375,2112100,1536,-715900
2023-06-27,87.3 ( 1.75 %),1350,2987000,2212.59,1774,2296000,1294,691000
2023-06-26,85.8 ( 0.82 %),1296,1816700,1401.77,863,1576500,1827,240200
2023-06-23,85.1 ( -0.47 %),0,0,0,0,0,0,0
2023-06-22,85.5 ( -0.35 %),1539,1786800,1161.01,1290,2213200,1716,-426400
2023-06-21,85.8 ( 0.35 %),648,1025800,1583.02,1226,1553600,1267,-527800
2023-06-20,85.5 ( 0.94 %),852,1830900,2148.94,1385,1670800,1206,160100
2023-06-19,84.7 ( 0.24 %),620,1745500,2815.32,1067,1641900,1539,103600
2023-06-16,84.5 ( 0.48 %),1705,5812000,3408.8,2300,3877600,1686,1934400
2023-06-15,84.1 ( -0.12 %),1019,1476200,1448.68,1119,2008800,1795,-532600
2023-06-14,84.2 ( -0.24 %),802,1172300,1461.72,858,3164800,3689,-1992500
2023-06-13,84.4 ( -0.59 %),717,851300,1187.31,852,1864700,2189,-1013400
2023-06-12,84.9 ( 0.35 %),939,1004000,1069.22,722,1044400,1447,-40400
2023-06-09,84.6 ( 1.2 %),670,1264500,1887.31,1418,2262300,1595,-997800
2023-06-08,83.6 ( -1.65 %),1594,1805900,1132.94,1105,2300300,2082,-494400
2023-06-07,85 ( -0.35 %),1110,1245200,1121.8,1451,1379300,951,-134100
2023-06-06,85.3 ( 0.35 %),739,1058500,1432.34,1222,1245900,1020,-187400
2023-06-05,85 ( 1.43 %),1007,2697400,2678.65,1991,2299900,1155,397500
2023-06-02,83.8 ( 0.36 %),1268,1579100,1245.35,1198,1492300,1246,86800
2023-06-01,83.5 ( -0.71 %),888,940400,1059.01,700,1004900,1436,-64500
2023-05-31,84.1 ( 0.12 %),963,1324900,1375.8,871,1448500,1663,-123600
2023-05-30,84 ( 1.08 %),1436,6660400,4638.16,1683,3007800,1787,3652600
2023-05-29,83.1 ( 0 %),684,1719200,2513.45,1196,2412700,2017,-693500
2023-05-26,83.1 ( -0.12 %),847,2102700,2482.53,1638,1712300,1045,390400
2023-05-25,83.2 ( 2.34 %),989,3563000,3602.63,1811,2064400,1140,1498600
2023-05-24,81.3 ( -0.85 %),893,1353800,1516.01,773,1127700,1459,226100
2023-05-23,82 ( -0.61 %),986,1155600,1172.01,903,1683500,1864,-527900
2023-05-22,82.5 ( -0.36 %),779,1179600,1514.25,985,1481200,1504,-301600
2023-05-19,82.8 ( -0.12 %),969,2848600,2939.73,1528,2519500,1649,329100
2023-05-18,82.9 ( 1.72 %),1119,3246100,2900.89,1832,2474700,1351,771400
2023-05-17,81.5 ( 0 %),858,1636000,1906.76,1885,2165200,1149,-529200
2023-05-16,81.5 ( 0.62 %),748,1730300,2313.24,1272,1841500,1448,-111200
2023-05-15,81 ( 0.62 %),1096,1859200,1696.35,1923,2207500,1148,-348300
2023-05-12,80.5 ( 1.77 %),933,2409800,2582.85,1493,1756800,1177,653000
2023-05-11,79.1 ( 0.13 %),558,953600,1708.96,829,1139600,1375,-186000
2023-05-10,79 ( 0.13 %),817,1303000,1594.86,985,1306400,1326,-3400
2023-05-09,78.9 ( 0.51 %),718,1441700,2007.94,1157,1334100,1153,107600
2023-05-08,78.5 ( 0.13 %),769,935700,1216.78,762,688300,903,247400
2023-05-05,78.4 ( -0.13 %),682,891700,1307.48,612,688000,1124,203700
2023-05-04,78.5 ( 1.29 %),996,1354100,1359.54,863,868100,1006,486000
2023-04-28,77.5 ( -1.02 %),0,0,0,0,0,0,0
2023-04-27,78.3 ( 0 %),895,819400,915.53,643,591700,920,227700
2023-04-26,78.3 ( -0.13 %),0,0,0,0,0,0,0
2023-04-25,78.4 ( -0.88 %),1495,1167100,780.67,971,911800,939,255300
2023-04-24,79.1 ( -0.25 %),1645,1874300,1139.39,1366,1781000,1304,93300
2023-04-21,79.3 ( -0.13 %),772,1149300,1488.73,881,860700,977,288600
2023-04-20,79.4 ( 0.13 %),874,1060600,1213.5,779,956800,1228,103800
2023-04-19,79.3 ( -0.13 %),0,0,0,0,0,0,0
2023-04-18,79.4 ( -0.25 %),909,844600,929.15,875,810000,926,34600
2023-04-17,79.6 ( 0 %),976,993200,1017.62,602,797300,1324,195900
2023-04-14,79.6 ( 0 %),870,927200,1065.75,668,929100,1391,-1900
2023-04-13,79.6 ( -0.87 %),1179,1140600,967.43,723,1166900,1614,-26300
2023-04-12,80.3 ( 0 %),911,1027900,1128.32,745,1096200,1471,-68300
2023-04-11,80.3 ( 0 %),712,1208800,1697.75,915,919000,1004,289800
2023-04-10,80.3 ( -0.25 %),902,1575200,1746.34,1235,1401100,1134,174100
2023-04-07,80.5 ( 0.25 %),760,1418700,1866.71,765,848600,1109,570100
2023-04-06,80.3 ( -0.37 %),733,1216100,1659.07,1266,1480300,1169,-264200
2023-04-05,80.6 ( 0.12 %),1043,1357100,1301.15,866,980900,1133,376200
2023-04-04,80.5 ( -0.49 %),905,1285200,1420.11,1076,1395700,1297,-110500
2023-04-03,80.9 ( 2.28 %),1241,2164300,1744,1669,2070300,1240,94000
2023-03-31,79.1 ( 0 %),929,1611500,1734.66,3587,1482900,413,128600
2023-03-30,79.1 ( 0.13 %),710,1116000,1571.83,909,1183000,1301,-67000
2023-03-29,79 ( -0.25 %),790,1250000,1582.28,801,888100,1109,361900
2023-03-28,79.2 ( 0.13 %),984,1964800,1996.75,1011,1649300,1631,315500
2023-03-27,79.1 ( 0.64 %),768,1665500,2168.62,1109,1540600,1389,124900
2023-03-24,78.6 ( 0.77 %),862,1407900,1633.29,915,870600,951,537300
2023-03-23,78 ( -0.64 %),1456,1443100,991.14,819,838800,1024,604300
2023-03-22,78.5 ( 0.51 %),1268,1488600,1173.97,775,1064700,1374,423900
2023-03-21,78.1 ( 0.64 %),1364,1632700,1196.99,869,1031600,1187,601100
2023-03-20,77.6 ( -1.77 %),2199,1531800,696.59,758,1280600,1689,251200
2023-03-17,79 ( -0.25 %),891,1345100,1509.65,868,1117300,1287,227800
2023-03-16,79.2 ( -1.61 %),1575,1665800,1057.65,1090,1577900,1448,87900
2023-03-15,80.5 ( 2.29 %),654,1414000,2162.08,1610,1403700,872,10300
2023-03-14,78.7 ( -0.25 %),985,1376300,1397.26,906,971200,1072,405100
2023-03-13,78.9 ( -0.75 %),1669,1991000,1192.93,1031,1435900,1393,555100
2023-03-10,79.5 ( -1.36 %),1964,1379500,702.39,1134,1506500,1328,-127000
2023-03-09,80.6 ( 1.38 %),1116,1367100,1225,1299,1261000,971,106100
2023-03-08,79.5 ( 0.89 %),1260,1567500,1244.05,856,873800,1021,693700
2023-03-07,78.8 ( 0.77 %),1013,1626200,1605.33,1261,1392000,1104,234200
2023-03-06,78.2 ( -0.38 %),2186,1602000,732.85,1081,1408600,1303,193400
2023-03-03,78.5 ( -1.88 %),2048,1717500,838.62,697,1439900,2066,277600
2023-03-02,80 ( -0.62 %),1008,1186700,1177.28,602,878700,1460,308000
2023-03-01,80.5 ( 0 %),2568,2441200,950.62,870,1941900,2232,499300
2023-02-28,80.5 ( 0.25 %),1327,1473100,1110.1,651,969200,1489,503900
2023-02-27,80.3 ( -0.62 %),1349,1848100,1369.98,831,1667800,2007,180300
2023-02-24,80.8 ( -0.74 %),1266,1399100,1105.13,618,1055200,1707,343900
2023-02-23,81.4 ( -0.49 %),1514,2011100,1328.34,973,1785300,1835,225800
2023-02-22,81.8 ( -1.21 %),882,1761900,1997.62,962,1544400,1605,217500
2023-02-21,82.8 ( 0 %),828,1942000,2345.41,1628,2263500,1390,-321500
2023-02-20,82.8 ( 1.47 %),1367,2599600,1901.68,1453,2301700,1584,297900
2023-02-17,81.6 ( 0 %),1044,1245600,1193.1,786,1044700,1329,200900
2023-02-16,81.6 ( 0 %),1032,1199200,1162.02,870,2126100,2444,-926900
2023-02-15,81.6 ( 0.99 %),979,1747600,1785.09,1244,1592900,1280,154700
2023-02-14,80.8 ( 0.12 %),990,1795200,1813.33,849,1042600,1228,752600
2023-02-13,80.7 ( 0 %),2334,1671200,716.02,1071,1205300,1125,465900
2023-02-10,80.7 ( 0 %),1170,1546300,1321.62,859,1296600,1509,249700
2023-02-09,80.7 ( -0.62 %),2126,1173900,552.16,842,1244200,1478,-70300
2023-02-08,81.2 ( 0.62 %),863,1129300,1308.57,1096,1299300,1185,-170000
2023-02-07,80.7 ( 0.25 %),1201,1427400,1188.51,1143,1522800,1332,-95400
2023-02-06,80.5 ( 0.5 %),1461,1849900,1266.19,945,1605600,1699,244300
2023-02-03,80.1 ( -2.2 %),2297,4593900,1999.96,781,2276300,2915,2317600
2023-02-02,81.9 ( -0.12 %),1428,3322600,2326.75,1076,2030000,1887,1292600
2023-02-01,82 ( -1.8 %),1941,1603000,825.86,1320,1975100,1496,-372100
2023-01-31,83.5 ( -0.24 %),1856,2393400,1289.55,1146,2532800,2210,-139400
2023-01-30,83.7 ( -0.36 %),749,1433100,1913.35,1255,1654500,1318,-221400
2023-01-27,84 ( 0.12 %),805,1498500,1861.49,1893,2115800,1118,-617300
2023-01-19,83.9 ( 0.6 %),1186,1920300,1619.14,2093,2424000,1158,-503700
2023-01-18,83.4 ( 1.71 %),975,1487800,1525.95,1691,1535400,908,-47600
2023-01-17,82 ( 1.49 %),921,1766600,1918.13,1504,1542200,1025,224400
2023-01-16,80.8 ( 1 %),1128,1181000,1046.99,1184,1189800,1005,-8800
2023-01-13,80 ( -0.87 %),877,866400,987.91,1064,1332800,1253,-466400
2023-01-12,80.7 ( -0.25 %),1009,998900,989.99,1439,1190600,827,-191700
2023-01-11,80.9 ( 0.62 %),934,1999900,2141.22,1687,1895300,1123,104600
2023-01-10,80.4 ( 0.12 %),869,1466500,1687.57,1537,1960800,1276,-494300
2023-01-09,80.3 ( 0 %),855,917100,1072.63,1473,1238600,841,-321500
2023-01-06,80.3 ( -0.37 %),1169,1201200,1027.54,1396,1565700,1122,-364500
2023-01-05,80.6 ( 0.75 %),971,1629100,1677.75,2338,1818000,778,-188900
2023-01-04,80 ( 0 %),1126,1261200,1120.07,1957,1977200,1010,-716000
2023-01-03,80 ( 4.03 %),1834,2757200,1503.38,2640,2352700,891,404500
2022-12-30,76.9 ( 0.92 %),908,1136200,1251.32,923,1506100,1632,-369900
2022-12-29,76.2 ( -0.65 %),752,1007400,1339.63,888,1341600,1511,-334200
2022-12-28,76.7 ( 0.26 %),1440,1327800,922.08,915,1656200,1810,-328400
2022-12-27,76.5 ( 0.13 %),1014,1384900,1365.78,1345,1888000,1404,-503100
2022-12-26,76.4 ( -2.05 %),986,1366200,1385.6,1342,1996000,1487,-629800
2022-12-23,78 ( 1.04 %),1678,2078700,1238.8,1569,2036800,1298,41900
2022-12-22,77.2 ( 0 %),992,1178900,1188.41,1272,1470300,1156,-291400
2022-12-21,77.2 ( 0.78 %),963,1066300,1107.27,1281,1412900,1103,-346600
2022-12-20,76.6 ( 0 %),1705,1521300,892.26,1168,1646400,1410,-125100
2022-12-19,76.6 ( -1.67 %),1410,1642700,1165.04,1348,2171200,1611,-528500
2022-12-16,77.9 ( 0.26 %),1270,1690700,1331.26,1740,1859000,1068,-168300
2022-12-15,77.7 ( 1.83 %),1232,1809900,1469.07,2298,2350600,1023,-540700
2022-12-14,76.3 ( -1.17 %),1445,1962200,1357.92,1377,2411700,1751,-449500
2022-12-13,77.2 ( 0.26 %),1582,1473100,931.16,1258,1804500,1434,-331400
2022-12-12,77 ( -1.28 %),1969,2074400,1053.53,1702,2423100,1424,-348700
2022-12-09,78 ( 1.3 %),1151,1715400,1490.36,1908,2149700,1127,-434300
2022-12-08,77 ( 0.65 %),1620,1972400,1217.53,1930,2543300,1318,-570900
2022-12-07,76.5 ( 0.66 %),1629,1820000,1117.25,1509,1634500,1083,185500
2022-12-06,76 ( -2.94 %),1443,2041000,1414.41,2361,2864100,1213,-823100
2022-12-05,78.3 ( 1.16 %),1660,1649200,993.49,2203,2553700,1159,-904500
2022-12-02,77.4 ( 3.61 %),1589,4172400,2625.8,2777,4096200,1475,76200
2022-12-01,74.7 ( 0.13 %),2206,2786500,1263.15,3139,2949300,940,-162800
2022-11-30,74.6 ( 0.4 %),1265,1563700,1236.13,1825,1890500,1036,-326800
2022-11-29,74.3 ( 0 %),1701,1982600,1165.55,1717,2260100,1316,-277500
2022-11-28,74.3 ( 3.19 %),1452,1768800,1218.18,2254,2089800,927,-321000
2022-11-25,72 ( 2.13 %),1228,1847200,1504.23,2425,2442600,1007,-595400
2022-11-24,70.5 ( 0 %),1393,1287600,924.34,1618,1835300,1134,-547700
2022-11-23,70.5 ( 0 %),1040,876200,842.5,1211,1264800,1044,-388600
2022-11-22,70.5 ( 0.57 %),2057,1911300,929.17,2233,2512300,1125,-601000
2022-11-21,70.1 ( -1.96 %),2381,1572300,660.35,1590,1653000,1040,-80700
2022-11-18,71.5 ( 0.7 %),2022,2326600,1150.64,3381,2894500,856,-567900
2022-11-17,71 ( 2.45 %),1921,2509400,1306.3,2735,3263700,1193,-754300
2022-11-16,69.3 ( 5.16 %),3529,4513600,1279,3698,4828400,1306,-314800
2022-11-15,65.9 ( -6.92 %),3474,3334400,959.82,2955,5355200,1812,-2020800
2022-11-14,70.8 ( -2.75 %),2512,2516800,1001.91,2178,2921100,1341,-404300
2022-11-11,72.8 ( -0.27 %),1258,1612600,1281.88,1754,2066800,1178,-454200
2022-11-10,73 ( -1.35 %),2716,2644600,973.71,1976,2765600,1400,-121000
2022-11-09,74 ( 0.95 %),2053,1698300,827.23,1747,1477600,846,220700
2022-11-08,73.3 ( 0.96 %),1758,1931700,1098.81,1423,1555600,1093,376100
2022-11-07,72.6 ( -0.41 %),1603,2470100,1540.92,2104,2534700,1205,-64600
2022-11-04,72.9 ( -1.62 %),3591,3682400,1025.45,1881,2576200,1370,1106200
2022-11-03,74.1 ( 0.14 %),1336,1672700,1252.02,1738,1326600,763,346100
2022-11-02,74 ( -1.99 %),1876,1760400,938.38,1207,1517000,1257,243400
2022-11-01,75.5 ( -0.13 %),2096,897700,428.29,1755,1531900,873,-634200
2022-10-31,75.6 ( 0.8 %),1464,2062200,1408.61,1368,1820400,1331,241800
2022-10-28,75 ( -1.06 %),1908,1846900,967.98,1570,2113500,1346,-266600
2022-10-27,75.8 ( 2.71 %),1425,2133800,1497.4,1914,1823000,952,310800
2022-10-26,73.8 ( 0.82 %),1392,1680400,1207.18,1532,1513000,988,167400
2022-10-25,73.2 ( 2.95 %),2336,3632400,1554.97,2239,2559900,1143,1072500
2022-10-24,71.1 ( -3.79 %),3024,2652800,877.25,1525,2613700,1714,39100
2022-10-21,73.9 ( -5.01 %),3082,2968300,963.11,1806,3024200,1675,-55900
2022-10-20,77.8 ( 3.05 %),2586,2761500,1067.87,3409,3173800,931,-412300
2022-10-19,75.5 ( 0.8 %),1424,1795800,1261.1,2193,2144200,978,-348400
2022-10-18,74.9 ( 1.49 %),1689,1730500,1024.57,1765,1698400,962,32100
2022-10-17,73.8 ( -0.27 %),1784,1848700,1036.27,1261,1342500,1065,506200
2022-10-14,74 ( 1.37 %),1667,1778600,1066.95,1908,2074800,1087,-296200
2022-10-13,73 ( 0.83 %),2142,2108800,984.5,1377,1497300,1087,611500
2022-10-12,72.4 ( 1.97 %),2502,2835200,1133.17,2847,2149800,755,685400
2022-10-11,71 ( -4.05 %),3209,2582100,804.64,1727,2478100,1435,104000
2022-10-10,74 ( 0 %),3062,3252400,1062.18,1963,2622700,1336,629700
2022-10-07,74 ( -3.27 %),3276,3203300,977.81,2281,2998100,1314,205200
2022-10-06,76.5 ( -2.42 %),2621,2076300,792.18,1609,2237100,1390,-160800
2022-10-05,78.4 ( 1.16 %),1831,1770400,966.9,1754,1836900,1047,-66500
2022-10-04,77.5 ( 0.65 %),2454,3077200,1253.95,2186,3250400,1487,-173200
2022-10-03,77 ( -4.35 %),2872,2085600,726.18,1547,2232500,1443,-146900
2022-09-30,80.5 ( 4.55 %),3216,4081700,1269.19,3360,3387000,1008,694700
2022-09-29,77 ( -1.28 %),2403,2324600,967.37,2091,2478000,1185,-153400
2022-09-28,78 ( -3.11 %),2932,3081900,1051.13,1826,3128900,1714,-47000
2022-09-27,80.5 ( -1.23 %),1945,2020900,1039.02,1372,1956500,1426,64400
2022-09-26,81.5 ( -1.09 %),3284,3128800,952.74,2161,2946200,1363,182600
2022-09-23,82.4 ( -0.6 %),2103,1904700,905.71,1211,1736200,1434,168500
2022-09-22,82.9 ( 0.73 %),2615,2536700,970.06,1323,2089700,1580,447000
2022-09-21,82.3 ( -1.32 %),2238,1427000,637.62,1015,1521600,1499,-94600
2022-09-20,83.4 ( 0.36 %),2309,1957200,847.64,1259,1513000,1202,444200
2022-09-19,83.1 ( 0.73 %),3477,3424000,984.76,2267,2972500,1311,451500
2022-09-16,82.5 ( -1.43 %),3501,2101500,600.26,1487,2239200,1506,-137700
2022-09-15,83.7 ( -0.36 %),2083,1593400,764.95,1412,1759400,1246,-166000
2022-09-14,84 ( -0.71 %),3922,2902300,740.01,1438,2494400,1735,407900
2022-09-13,84.6 ( 0 %),1602,1799400,1123.22,1781,2347500,1318,-548100
2022-09-12,84.6 ( 0.36 %),1731,1629100,941.13,1501,2007100,1337,-378000
2022-09-09,84.3 ( 0 %),1655,1933100,1168.04,1733,2298800,1326,-365700
2022-09-08,84.3 ( 0.36 %),2824,2386100,844.94,2075,2144600,1034,241500
2022-09-07,84 ( -2.1 %),4813,3084700,640.91,2034,3392900,1668,-308200
2022-09-06,85.8 ( -0.46 %),2579,1993700,773.05,1921,2258900,1176,-265200
2022-09-05,86.2 ( -0.46 %),2309,1678100,726.76,1828,2276400,1245,-598300
2022-08-31,86.6 ( 0.23 %),2299,2321500,1009.79,1779,2618200,1472,-296700
2022-08-30,86.4 ( -0.12 %),2025,2250900,1111.56,2141,3513300,1641,-1262400
2022-08-29,86.5 ( -0.8 %),4442,3903200,878.7,2550,4175200,1637,-272000
2022-08-26,87.2 ( 1.04 %),2531,2930400,1157.8,3352,4210500,1256,-1280100
2022-08-25,86.3 ( 0.12 %),2747,2114200,769.64,2500,2481600,993,-367400
2022-08-24,86.2 ( 0.23 %),1725,1852400,1073.86,2070,2331300,1126,-478900
2022-08-23,87 ( 0.23 %),2819,2534400,899.04,1465,1691200,1154,843200
2022-08-22,86.8 ( -0.12 %),3072,2650800,862.89,1564,2751700,1759,-100900
2022-08-19,86.9 ( -1.59 %),3894,3041500,781.07,2452,3145900,1283,-104400
2022-08-18,88.3 ( 0 %),2988,3575000,1196.45,4115,4964300,1206,-1389300
2022-08-17,88.3 ( -0.45 %),2986,2381600,797.59,2920,3466600,1187,-1085000
2022-08-16,88.7 ( -0.22 %),2879,2491000,865.23,2789,3446600,1236,-955600
2022-08-15,88.9 ( 2.77 %),3568,5663100,1587.19,4808,5416300,1127,246800
2022-08-12,86.5 ( 0.58 %),2120,2499100,1178.82,1805,2296500,1272,202600
2022-08-11,86 ( 0 %),2109,3187300,1511.28,2725,3642100,1337,-454800
2022-08-10,86 ( -0.23 %),1755,2698200,1537.44,1905,2272900,1193,425300
2022-08-09,86.2 ( 0.23 %),3012,4648000,1543.16,3565,4571200,1282,76800
2022-08-08,86 ( 0.23 %),3354,2775000,827.37,3122,2947500,944,-172500
2022-08-05,85.8 ( -0.35 %),3355,3094700,922.41,3067,3412200,1113,-317500
2022-08-04,86.1 ( 1.53 %),3749,4889300,1304.16,4673,4881400,1045,7900
2022-08-03,84.8 ( -0.24 %),3610,3738200,1035.51,3144,3275500,1042,462700
2022-08-02,85 ( 1.19 %),3603,3847700,1067.92,2411,2825800,1172,1021900
2022-08-01,84 ( 0.6 %),4084,3207500,785.38,1722,3028000,1758,179500
2022-07-29,83.5 ( -1.65 %),4528,4081600,901.41,1527,3180300,2083,901300
2022-07-28,84.9 ( -0.35 %),2575,2480800,963.42,2095,3381900,1614,-901100
2022-07-27,85.2 ( 0.47 %),1388,1466700,1056.7,1228,1501400,1223,-34700
2022-07-26,84.8 ( -0.7 %),1616,2111600,1306.68,2234,3238600,1450,-1127000
2022-07-25,85.4 ( 0.35 %),1820,3526700,1937.75,3178,5398000,1699,-1871300
2022-07-22,85.1 ( 0.12 %),1886,2664400,1412.73,2716,3515800,1294,-851400
2022-07-21,85 ( 0.12 %),2230,3566100,1599.15,4025,4030400,1001,-464300
2022-07-20,84.9 ( 2.29 %),3202,5064200,1581.57,4966,5619700,1132,-555500
2022-07-19,83 ( 0 %),2639,2252200,853.43,2244,2035900,907,216300
2022-07-18,83 ( 0.97 %),1821,2120000,1164.2,3073,2397400,780,-277400
2022-07-15,82.2 ( -0.72 %),3814,2618100,686.44,3248,2777200,855,-159100
2022-07-14,82.8 ( 0.36 %),1705,1956500,1147.51,1799,1737100,966,219400
2022-07-13,82.5 ( -1.2 %),2787,1757600,630.64,1649,3386400,2054,-1628800
2022-07-12,83.5 ( 0.85 %),1556,1535100,986.57,1315,1369000,1041,166100
2022-07-11,82.8 ( -0.96 %),2044,1867100,913.45,1932,2473400,1280,-606300
2022-07-08,83.6 ( 0.6 %),2319,1898900,818.84,1182,1565500,1324,333400
2022-07-07,83.1 ( -0.48 %),2112,2270600,1075.09,1978,2760900,1396,-490300
2022-07-06,83.5 ( -2.22 %),3713,3178300,855.99,2058,3750500,1822,-572200
2022-07-05,85.4 ( -1.5 %),2241,2438300,1088.04,2604,3409700,1309,-971400
2022-07-04,86.7 ( -1.48 %),1981,1943800,981.22,1670,2844200,1703,-900400
2022-07-01,88 ( 2.09 %),3872,3414800,881.92,2516,3612400,1436,-197600
2022-06-30,86.2 ( -4.22 %),3626,3174400,875.46,2180,3936300,1806,-761900
2022-06-29,90 ( 0.33 %),2150,2180600,1014.23,2540,3182000,1253,-1001400
2022-06-28,89.7 ( 3.7 %),2544,5078200,1996.15,3769,4923700,1306,154500
2022-06-27,86.5 ( 1.17 %),2163,2185100,1010.22,2225,2723700,1224,-538600
2022-06-24,85.5 ( 0 %),2383,1746300,732.82,2002,1706100,852,40200
2022-06-23,85.5 ( 1.18 %),4506,3620000,803.37,2514,3214600,1279,405400
2022-06-22,84.5 ( -5.16 %),5474,4238300,774.26,3471,5012800,1444,-774500
2022-06-21,89.1 ( -3.15 %),4257,3857600,906.18,3552,5765600,1623,-1908000
2022-06-20,92 ( 0 %),3639,3973900,1092.03,4731,4774200,1009,-800300
2022-06-17,92 ( 0 %),5630,4724600,839.18,2796,4126500,1476,598100
2022-06-16,92 ( 1.66 %),4004,4309400,1076.27,3867,4811900,1244,-502500
2022-06-15,90.5 ( 1.57 %),3558,2983500,838.53,2711,2924100,1079,59400
2022-06-14,89.1 ( 3.36 %),5827,4692600,805.32,2831,3740500,1321,952100
2022-06-13,86.2 ( -5.07 %),9723,5693800,585.6,3203,6167900,1926,-474100
2022-06-10,110 ( -4.6 %),5718,4427300,774.27,4474,5887300,1316,-1460000
2022-06-09,115.3 ( 0.26 %),3525,3067200,870.13,3280,4157400,1268,-1090200
2022-06-08,115 ( -0.52 %),4514,4135300,916.11,4126,5387000,1306,-1251700
2022-06-07,115.6 ( 2.3 %),6597,6334400,960.19,3968,6157400,1552,177000
2022-06-06,113 ( -0.88 %),3265,3636200,1113.69,3845,6428700,1672,-2792500
2022-06-03,114 ( 2.24 %),3007,2918000,970.4,3537,4165400,1178,-1247400
2022-06-02,111.5 ( -0.27 %),3421,3583400,1047.47,4342,6075000,1399,-2491600
2022-06-01,111.8 ( 1.73 %),3042,4082300,1341.98,3858,4782800,1240,-700500
2022-05-31,109.9 ( -1.26 %),4329,3703600,855.53,2828,4334700,1533,-631100
2022-05-30,111.3 ( -0.45 %),4059,5313800,1309.14,4722,6445000,1365,-1131200
2022-05-27,111.8 ( 5.87 %),3481,5683800,1632.81,7036,6665900,947,-982100
2022-05-26,105.6 ( 0.57 %),2606,2733500,1048.93,3061,3398600,1110,-665100
2022-05-25,105 ( 6.92 %),3736,6237700,1669.62,4938,4770700,966,1467000
2022-05-24,98.2 ( 1.76 %),2267,2404500,1060.65,2495,2677100,1073,-272600
2022-05-23,96.5 ( -1.03 %),2306,1800500,780.79,1922,2395900,1247,-595400
2022-05-20,97.5 ( 0.52 %),2324,2386600,1026.94,2429,2790000,1149,-403400
2022-05-19,97 ( -0.72 %),3743,2874900,768.07,1950,2572400,1319,302500
2022-05-18,97.7 ( -2.01 %),4131,3444500,833.82,2544,3972800,1562,-528300
2022-05-17,99.7 ( 6.97 %),3325,3843200,1155.85,2949,3125000,1060,718200
2022-05-16,93.2 ( -0.43 %),0,0,0,0,0,0,0
2022-05-13,93.6 ( -2.09 %),5531,6667000,1205.39,4700,6702500,1426,-35500
2022-05-12,95.6 ( -6.18 %),3852,3808300,988.66,3359,4351600,1296,-543300
2022-05-11,101.9 ( 3.56 %),2500,2866100,1146.44,2395,2855300,1192,10800
2022-05-10,98.4 ( 4.68 %),5076,5297100,1043.56,3270,4200500,1285,1096600
2022-05-09,94 ( -6.19 %),7176,6872700,957.73,4044,6900600,1706,-27900
2022-05-06,100.2 ( -4.3 %),4401,3863800,877.94,2286,3866500,1691,-2700
2022-05-05,104.7 ( 0.19 %),3653,3688500,1009.72,2621,3665000,1398,23500
2022-05-04,104.5 ( -0.48 %),3579,3033300,847.53,2098,2816300,1342,217000
2022-04-29,105 ( -0.47 %),5616,8257500,1470.35,3018,6411600,2124,1845900
2022-04-28,105.5 ( 2.43 %),3561,4610100,1294.61,3384,4635300,1370,-25200
2022-04-27,103 ( -1.25 %),4971,4728300,951.18,2068,4026500,1947,701800
2022-04-26,104.3 ( 0.87 %),0,0,0,0,0,0,0
2022-04-25,103.4 ( -6.93 %),5999,5677300,946.37,4568,11599400,2539,-5922100
2022-04-22,111.1 ( -0.8 %),7817,9806600,1254.52,4417,8959300,2028,847300
2022-04-21,112 ( 0 %),4270,6908300,1617.87,3835,6560300,1711,348000
2022-04-20,112 ( 0 %),5138,5556400,1081.43,3096,5288100,1708,268300
2022-04-18,115.5 ( 0.43 %),3726,5367400,1440.53,3916,6109900,1560,-742500
2022-04-15,115 ( -1.37 %),4747,4939400,1040.53,3135,6170300,1968,-1230900
2022-04-14,116.6 ( 1.3 %),3848,5169100,1343.32,4896,6880100,1405,-1711000
2022-04-13,115.1 ( 4.83 %),3886,5344600,1375.35,3920,5128300,1308,216300
2022-04-12,0 ( 0 %),4637,5051700,1089.43,2725,4586000,1683,465700
2022-04-08,108.5 ( -4.24 %),5839,6302300,1079.35,3008,6979700,2320,-677400
2022-04-07,113.3 ( 0.27 %),3838,6758000,1760.81,4809,7711400,1604,-953400
2022-04-06,113 ( 3.67 %),3632,7639400,2103.36,4119,6230000,1513,1409400
2022-04-05,109 ( -0.27 %),2263,3076500,1359.48,2529,3469700,1372,-393200
2022-04-04,109.3 ( -1.53 %),3782,4409900,1166.02,4009,5464600,1363,-1054700
2022-04-01,111 ( 3.74 %),3295,7335900,2226.37,5109,6468300,1266,867600
2022-03-31,107 ( 0.94 %),2881,6449400,2238.6,5528,6258300,1132,191100
2022-03-30,106 ( 1.05 %),2954,5099800,1726.4,4919,5942000,1208,-842200
2022-03-29,104.9 ( 6.93 %),4726,12549100,2655.33,8794,10741900,1222,1807200
2022-03-28,98.1 ( 2.51 %),2929,6449500,2201.95,4532,6234400,1376,215100
2022-03-25,95.7 ( -0.31 %),1276,1971000,1544.67,1639,2642100,1612,-671100
2022-03-24,96 ( -0.52 %),1827,2854300,1562.29,2366,3431000,1450,-576700
2022-03-23,96.5 ( 0.1 %),1640,3276800,1998.05,3843,4456800,1160,-1180000
2022-03-22,96.4 ( 1.15 %),3070,3368200,1097.13,4417,4576400,1036,-1208200
2022-03-21,95.3 ( 0.21 %),1160,2480500,2138.36,3030,4454200,1470,-1973700
2022-03-18,95.1 ( 3.37 %),2140,4638200,2167.38,5424,6097600,1124,-1459400
2022-03-17,92 ( 0.44 %),1170,2214400,1892.65,1532,2105300,1374,109100
2022-03-16,91.6 ( 0.66 %),2528,2252000,890.82,1608,2009100,1249,242900
2022-03-15,91 ( -0.87 %),3553,3133300,881.87,1470,3416400,2324,-283100
2022-03-14,91.8 ( -1.5 %),0,0,0,0,0,0,0
2022-03-11,93.2 ( -1.48 %),1793,1661900,926.88,1377,1981800,1439,-319900
2022-03-10,94.6 ( -0.94 %),1347,1227100,910.99,2274,2398300,1055,-1171200
2022-03-09,95.5 ( 0.74 %),1820,2737400,1504.07,4942,5210200,1054,-2472800
2022-03-08,94.8 ( 1.07 %),2012,3505300,1742.2,3586,4238900,1182,-733600
2022-03-07,93.8 ( 0.32 %),1987,2835400,1426.98,1941,2831200,1459,4200
2022-03-04,93.5 ( 0.11 %),1292,2458200,1902.63,2101,2729600,1299,-271400
2022-03-03,93.4 ( 0.32 %),842,1519400,1804.51,2065,2585800,1252,-1066400
2022-03-02,93.1 ( -0.32 %),1329,1629000,1225.73,2314,2092700,904,-463700
2022-03-01,93.4 ( 0.11 %),1014,1551100,1529.68,2388,2672900,1119,-1121800
2022-02-28,93.3 ( 1.08 %),1638,2046200,1249.21,2393,2971100,1242,-924900
2022-02-25,92.3 ( 0.33 %),1091,1515200,1388.82,1796,2420800,1348,-905600
2022-02-24,92 ( -1.08 %),2133,2069500,970.23,2510,3168100,1262,-1098600
2022-02-23,93 ( 0.11 %),1660,1618900,975.24,2171,2409600,1110,-790700
2022-02-22,92.9 ( -0.64 %),1919,1940600,1011.26,1470,2392600,1628,-452000
2022-02-21,93.5 ( 1.41 %),1431,2396200,1674.49,2487,2821400,1134,-425200
2022-02-18,92.2 ( -0.65 %),1262,1264200,1001.74,1405,1497900,1066,-233700
2022-02-17,92.8 ( 1.64 %),888,1360600,1532.21,1508,1770200,1174,-409600
2022-02-16,91.3 ( 0.22 %),804,1079700,1342.91,1577,1589300,1008,-509600
2022-02-15,91.1 ( 0.11 %),1017,1282100,1260.67,1553,1419600,914,-137500
2022-02-14,91 ( -0.66 %),1544,1519200,983.94,1462,1398600,957,120600
2022-02-11,91.6 ( -0.43 %),1125,1456600,1294.76,1519,1839600,1211,-383000
2022-02-10,92 ( 1.43 %),1587,1810900,1141.08,1475,1690500,1146,120400
2022-02-09,90.7 ( 0.11 %),1309,1685000,1287.24,1826,2170900,1189,-485900
2022-02-08,90.6 ( 1.23 %),1186,1503900,1268.04,1882,2150600,1143,-646700
2022-02-07,89.5 ( 0 %),1415,908700,642.19,1126,1102400,979,-193700
2022-01-28,89.5 ( 4.19 %),2068,2329100,1126.26,1923,2075400,1079,253700
2022-01-27,85.9 ( -0.12 %),1687,1468700,870.6,905,1324100,1463,144600
2022-01-26,86 ( -0.58 %),2061,1591900,772.39,1209,1505100,1245,86800
2022-01-25,86.5 ( 1.41 %),0,0,0,0,0,0,0
2022-01-24,85.3 ( -3.29 %),3176,3024200,952.2,1863,2842500,1526,181700
2022-01-21,88.2 ( -0.68 %),2362,1405500,595.05,1079,1399800,1297,5700
2022-01-20,90.9 ( 2.94 %),1960,2862200,1460.31,1982,2134200,1077,728000
2022-01-19,88.4 ( 0.34 %),1835,1212200,660.6,1336,1441300,1079,-229100
2022-01-18,88.1 ( -1.01 %),2371,1907800,804.64,1582,2271600,1436,-363800
2022-01-17,89 ( -2.52 %),2884,2129300,738.31,1849,2419300,1308,-290000
2022-01-14,91.3 ( -0.87 %),1382,1252600,906.37,1274,1508600,1184,-256000
2022-01-13,92.1 ( 2.79 %),2651,3473200,1310.15,2647,3165300,1196,307900
2022-01-12,89.6 ( 0.11 %),5721,3382100,591.17,1793,2552200,1423,829900
2022-01-11,89.5 ( -2.72 %),4952,3515600,709.94,2354,4164300,1769,-648700
2022-01-10,92 ( -1.5 %),3256,2559200,786,2456,2975100,1211,-415900
2022-01-07,93.4 ( -0.11 %),2271,1863800,820.7,1808,1911600,1057,-47800
2022-01-06,93.5 ( -0.11 %),1842,1809400,982.3,2121,2091200,986,-281800
2022-01-05,93.6 ( 0.11 %),1923,2171200,1129.07,2057,2096500,1019,74700
2022-01-04,93.5 ( 0.54 %),1927,2729300,1416.35,1997,2870800,1438,-141500
2021-12-31,93 ( -0.64 %),2325,2307900,992.65,1690,2623900,1553,-316000
2021-12-30,93.6 ( 0 %),1299,1312000,1010.01,1345,1507300,1121,-195300
2021-12-29,93.6 ( -0.95 %),1747,1359500,778.19,1863,1596800,857,-237300
2021-12-28,94.5 ( 0 %),1140,1080600,947.89,1471,1340600,911,-260000
2021-12-27,94.5 ( 0.75 %),1645,1518000,922.8,1345,1542600,1147,-24600
2021-12-24,93.8 ( 0.64 %),2671,1955700,732.2,1624,2159500,1330,-203800
2021-12-23,93.2 ( -1.89 %),3434,3052100,888.79,2418,2731300,1130,320800
2021-12-22,95 ( -0.21 %),2630,2464000,936.88,1921,2718800,1415,-254800
2021-12-21,95.2 ( -0.63 %),2324,2213400,952.41,1514,2146600,1418,66800
2021-12-20,95.8 ( -0.62 %),1860,1751600,941.72,1592,2134300,1341,-382700
2021-12-17,96.4 ( 0.94 %),1605,1998100,1244.92,2442,2581700,1057,-583600
2021-12-16,95.5 ( -0.42 %),2308,2674000,1158.58,2302,3354600,1457,-680600
2021-12-15,95.9 ( 0.21 %),1478,1777000,1202.3,1870,2041000,1091,-264000
2021-12-14,95.7 ( -0.31 %),2287,2190600,957.85,1644,1974400,1201,216200
2021-12-13,96 ( 0.21 %),1693,1891700,1117.37,1770,1918700,1084,-27000
2021-12-10,95.8 ( -1.24 %),2435,2239900,919.88,1973,2134000,1082,105900
2021-12-09,97 ( 1.46 %),1947,2244300,1152.7,1955,1861900,952,382400
2021-12-08,95.6 ( -0.42 %),2122,2021500,952.64,1674,2084700,1245,-63200
2021-12-07,96 ( 1.59 %),3477,2935200,844.18,1788,2124200,1188,811000
2021-12-06,94.5 ( -1.05 %),4172,3625200,868.94,2510,3669800,1462,-44600
2021-12-03,95.5 ( -1.75 %),2961,3029500,1023.13,2075,3200900,1543,-171400
2021-12-02,97.2 ( -1.02 %),1671,2001300,1197.67,1852,2293300,1238,-292000
2021-12-01,98.2 ( 1.13 %),2383,2526000,1060.01,1961,2399200,1223,126800
2021-11-30,97.1 ( -1.02 %),3817,3990200,1045.38,2573,4014700,1560,-24500
2021-11-29,98.1 ( -0.81 %),3190,4455400,1396.68,2358,3253000,1380,1202400
2021-11-26,98.9 ( -1.1 %),2827,3741000,1323.31,3897,4264100,1094,-523100
2021-11-25,100 ( 2.15 %),5708,8958300,1569.43,9756,10074400,1033,-1116100
2021-11-24,97.9 ( 1.35 %),2772,4251500,1533.73,5249,4656900,887,-405400
2021-11-23,96.6 ( 1.68 %),2372,2622200,1105.48,1652,2008200,1216,614000
2021-11-22,95 ( -0.31 %),3753,3023300,805.57,2229,2967600,1331,55700
2021-11-19,95.3 ( -1.24 %),3845,3884000,1010.14,2855,4329700,1517,-445700
2021-11-18,96.5 ( -1.83 %),2537,3103700,1223.37,2713,3723300,1372,-619600
2021-11-17,98.3 ( 0 %),1663,2091200,1257.49,2747,3124200,1137,-1033000
2021-11-16,98.3 ( 1.03 %),3669,6087600,1659.2,6394,6539500,1023,-451900
2021-11-15,97.3 ( -0.71 %),2222,3377900,1520.21,4365,4219500,967,-841600
2021-11-12,98 ( 2.08 %),2836,4023000,1418.55,4304,4142400,962,-119400
2021-11-11,96 ( -1.03 %),3189,3807800,1194.04,3979,3785900,951,21900
2021-11-10,97 ( 0.62 %),0,0,0,0,0,0,0
2021-11-09,96.4 ( -1.03 %),3355,3302000,984.2,3988,3474700,871,-172700
2021-11-08,97.4 ( -0.2 %),2735,2901900,1061.02,4045,4329300,1070,-1427400
2021-11-05,97.6 ( 1.67 %),2834,3686900,1300.95,4031,4204400,1043,-517500
2021-11-04,96 ( -0.1 %),2761,3633300,1315.94,2378,3169000,1333,464300
2021-11-03,96.1 ( 0 %),4209,4164500,989.43,3393,4320200,1273,-155700
2021-11-02,96.1 ( 0.31 %),4128,8450800,2047.19,2912,3632200,1247,4818600
2021-11-01,95.8 ( -1.14 %),4912,4860900,989.6,3424,4762400,1391,98500
2021-10-29,96.9 ( -1.12 %),4138,4229600,1022.14,2856,4337500,1519,-107900
2021-10-28,98 ( -0.2 %),3375,3409800,1010.31,2465,3634100,1474,-224300
2021-10-27,98.2 ( 1.34 %),3112,3773000,1212.4,3773,4660800,1235,-887800
2021-10-26,96.9 ( 2.11 %),4210,3867800,918.72,2820,3554300,1260,313500
2021-10-25,94.9 ( -1.35 %),6969,5313400,762.43,3273,5114400,1563,199000
2021-10-22,96.2 ( -0.52 %),5082,4125800,811.85,2167,3876600,1789,249200
2021-10-21,96.7 ( -0.92 %),4990,4446500,891.08,2258,4436200,1965,10300
2021-10-20,97.6 ( -1.01 %),4002,4066300,1016.07,3294,4109100,1247,-42800
2021-10-19,98.6 ( -0.4 %),2483,2764700,1113.45,2807,3052100,1087,-287400
2021-10-18,99 ( 0.1 %),3378,3841500,1137.21,3071,4180600,1361,-339100
2021-10-15,98.9 ( 0.1 %),2674,2932300,1096.6,2916,3496100,1199,-563800
2021-10-14,98.8 ( -0.6 %),4168,3158500,757.8,2675,3681600,1376,-523100
2021-10-13,99.4 ( 0.4 %),4436,5140400,1158.79,6554,6928100,1057,-1787700
2021-10-12,99 ( -0.2 %),2413,2281200,945.38,3011,2850200,947,-569000
2021-10-11,99.2 ( 0.3 %),3265,3933700,1204.81,4886,4754300,973,-820600
2021-10-08,98.9 ( 4.88 %),8657,14451300,1669.32,15644,15424300,986,-973000
2021-10-07,94.3 ( -0.11 %),2371,2880600,1214.93,3563,3654600,1026,-774000
2021-10-06,94.4 ( 0 %),3338,3224900,966.12,2895,3074600,1062,150300
2021-10-05,94.4 ( -0.21 %),2127,2764300,1299.62,4843,4266400,881,-1502100
2021-10-04,94.6 ( 1.83 %),3283,3929600,1196.95,5026,4532600,902,-603000
2021-10-01,92.9 ( -0.11 %),3556,2694100,757.62,1840,2093000,1138,601100
2021-09-30,93 ( -0.21 %),1735,2222300,1280.86,2582,2917000,1130,-694700
2021-09-29,93.2 ( 0.22 %),2870,2564700,893.62,2223,2503500,1126,61200
2021-09-28,93 ( 0.98 %),3965,3301500,832.66,2363,2327100,985,974400
2021-09-27,92.1 ( -0.65 %),3251,3195000,982.77,2614,3214300,1230,-19300
2021-09-24,92.7 ( -0.43 %),3396,2769500,815.52,2072,2735000,1320,34500
2021-09-23,93.1 ( -0.11 %),2867,3150400,1098.85,2333,2864800,1228,285600
2021-09-22,93.2 ( -0.32 %),4698,4512300,960.47,2131,3240000,1520,1272300
2021-09-21,93.5 ( -0.95 %),7132,5656200,793.07,2940,4549800,1548,1106400
2021-09-20,94.4 ( -1.36 %),4944,4028800,814.89,3350,4766400,1423,-737600
2021-09-17,95.7 ( 1.06 %),5351,5457800,1019.96,6584,7528700,1143,-2070900
2021-09-16,94.7 ( 0.64 %),3083,3502600,1136.1,4676,4673100,999,-1170500
2021-09-15,94.1 ( 0.32 %),2517,3120900,1239.93,3843,3841900,1000,-721000
2021-09-14,93.8 ( 0.86 %),3449,4529700,1313.34,5723,5788200,1011,-1258500
2021-09-13,93 ( -0.53 %),3169,3025300,954.65,3105,3322400,1070,-297100
2021-09-10,93.5 ( 0.32 %),2500,2665100,1066.04,3672,4090600,1114,-1425500
2021-09-09,93.2 ( 0.11 %),3370,3089700,916.82,2571,3138900,1221,-49200
2021-09-08,93.1 ( -0.43 %),3270,3218000,984.1,3170,3229100,1019,-11100
2021-09-07,93.5 ( -1.48 %),3817,3269100,856.46,4623,4741800,1026,-1472700
2021-09-06,94.9 ( 2.71 %),4322,5262900,1217.7,4273,4506300,1055,756600
2021-09-01,92.4 ( 0 %),2598,2903300,1117.51,3633,2987800,822,-84500
2021-08-31,92.4 ( 0.22 %),3779,3875000,1025.4,4354,4216500,968,-341500
2021-08-30,92.2 ( 0.22 %),3116,2783200,893.2,3179,3746800,1179,-963600
2021-08-27,92 ( 0.66 %),4800,3983300,829.85,3729,4255500,1141,-272200
2021-08-26,91.4 ( -0.54 %),4219,3164900,750.15,3912,3476300,889,-311400
2021-08-25,91.9 ( 0 %),4267,3127200,732.88,2821,2827500,1002,299700
2021-08-24,91.9 ( 0.99 %),7644,5829000,762.56,4939,5929500,1201,-100500
2021-08-23,91 ( -1.94 %),7853,5433400,691.89,4715,5916900,1255,-483500
2021-08-20,92.8 ( -1.8 %),10730,6828900,636.43,5027,7082500,1409,-253600
2021-08-19,94.5 ( 0.53 %),5091,4808900,944.59,3919,5472600,1396,-663700
2021-08-18,94 ( 0.21 %),4502,3802100,844.54,3352,3920700,1170,-118600
2021-08-17,93.8 ( -0.85 %),6603,4691100,710.45,2972,4778700,1608,-87600
2021-08-16,94.6 ( -0.42 %),4159,3106200,746.86,2889,3855500,1335,-749300
2021-08-13,95 ( 1.28 %),9608,7465400,777,5447,6027700,1107,1437700
2021-08-12,93.8 ( -2.39 %),18969,13441800,708.62,8106,13522200,1668,-80400
2021-08-11,96.1 ( -1.74 %),9845,7004200,711.45,4808,7836300,1630,-832100
2021-08-10,97.8 ( 0.31 %),4008,4583300,1143.54,5216,5364600,1028,-781300
2021-08-09,97.5 ( 0.93 %),4896,5045800,1030.6,5079,5528500,1089,-482700
2021-08-06,96.6 ( 0 %),5570,5388600,967.43,5460,6624200,1213,-1235600
2021-08-05,96.6 ( 1.05 %),6348,5802200,914.02,4497,4617500,1027,1184700
2021-08-04,95.6 ( -0.21 %),5646,5166600,915.09,4417,5646500,1278,-479900
2021-08-03,95.8 ( 0.21 %),7498,6046700,806.44,4834,6078800,1258,-32100
2021-08-02,95.6 ( 1.7 %),8413,7277200,864.99,7159,7961300,1112,-684100
2021-07-30,94 ( 0.64 %),6671,9106800,1365.13,8035,8251400,1027,855400
2021-07-29,93.4 ( 1.52 %),6535,6957300,1064.62,5622,6655800,1184,301500
2021-07-28,92 ( -1.29 %),8762,6415000,732.14,5011,5901200,1178,513800
2021-07-27,93.2 ( -0.53 %),9282,7742400,834.13,8946,9164900,1024,-1422500
2021-07-26,93.7 ( 3.54 %),8369,11384200,1360.28,11278,11038200,979,346000
2021-07-23,90.5 ( 1.23 %),8509,11055700,1299.29,13842,12720100,919,-1664400
2021-07-22,89.4 ( 3.23 %),8223,8256900,1004.12,9912,8218900,829,38000
2021-07-21,86.6 ( -0.23 %),7356,6478600,880.72,5572,6288000,1128,190600
2021-07-20,86.8 ( 2.48 %),6449,5074200,786.82,4050,4031800,996,1042400
2021-07-19,84.7 ( -2.42 %),8992,5994600,666.66,4180,5198600,1244,796000
2021-07-16,86.8 ( 1.64 %),5310,5296700,997.5,4569,4446200,973,850500
2021-07-15,85.4 ( 0.23 %),7357,5598000,760.91,3311,4108700,1241,1489300
2021-07-14,85.2 ( -2.07 %),6863,4530500,660.13,3321,5023900,1513,-493400
2021-07-13,87 ( 1.05 %),5478,4815800,879.12,3714,4188000,1128,627800
2021-07-12,86.1 ( -4.01 %),14914,11518700,772.34,7189,10617200,1477,901500
2021-07-09,89.7 ( -0.11 %),5802,5253600,905.48,5710,6215300,1088,-961700
2021-07-08,89.8 ( -0.77 %),0,0,0,0,0,0,0
2021-07-07,90.5 ( 4.02 %),9752,9221200,945.57,6743,8153600,1209,1067600
2021-07-06,87 ( -6.15 %),0,0,0,0,0,0,0
2021-07-02,91.9 ( 3.37 %),0,0,0,0,0,0,0
2021-07-01,88.9 ( 1.02 %),2731,2853600,1044.89,3051,3053100,1001,-199500
2021-06-30,88 ( -0.68 %),3456,2692700,779.14,3440,3645300,1060,-952600
2021-06-29,88.6 ( 3.38 %),8174,7527700,920.93,9056,8014700,885,-487000
2021-06-28,85.7 ( 0.59 %),0,0,0,0,0,0,0
2021-06-25,85.2 ( 0.59 %),2372,2395200,1009.78,2912,2751200,945,-356000
2021-06-24,84.7 ( -0.24 %),3736,2935600,785.76,2145,2857100,1332,78500
2021-06-23,84.9 ( -0.59 %),3434,2958900,861.65,2339,3025600,1294,-66700
2021-06-22,0 ( 0 %),2544,2505600,984.91,4032,3884900,964,-1379300
2021-06-21,85.6 ( 2.15 %),5915,6322000,1068.81,6647,7026500,1057,-704500
2021-06-18,83.8 ( 1.45 %),2542,2866700,1127.73,3355,3305000,985,-438300
2021-06-17,82.6 ( -0.6 %),4873,4210000,863.94,1675,3389000,2023,821000
2021-06-16,83.1 ( -0.12 %),4449,3908100,878.42,2994,4425100,1478,-517000
2021-06-15,83.2 ( -0.72 %),3458,2908000,840.95,2750,3396300,1235,-488300
2021-06-14,83.8 ( 0.36 %),4355,3816100,876.26,3113,4016100,1290,-200000
2021-06-11,83.5 ( 1.95 %),4021,3992300,992.86,4029,3891300,966,101000
2021-06-10,81.9 ( 0.24 %),3847,3885400,1009.98,2663,3824900,1436,60500
2021-06-09,81.7 ( 1.11 %),7523,5865800,779.72,3535,4377700,1238,1488100
2021-06-08,80.8 ( -2.3 %),6262,4664600,744.91,3518,5524300,1570,-859700
2021-06-07,82.7 ( -2.36 %),7666,5662600,738.66,3720,6311900,1697,-649300
2021-06-04,84.7 ( -0.59 %),7469,5333700,714.11,6681,4611800,690,721900
2021-06-03,85.2 ( -0.35 %),0,0,0,0,0,0,0
2021-06-02,85.5 ( -1.84 %),6440,4345800,674.81,2880,5523700,1918,-1177900
2021-06-01,87.1 ( -11.03 %),8927,5507000,616.89,2231,6708900,3007,-1201900
2021-05-31,97.9 ( 3.27 %),5452,7720700,1416.12,4949,4721000,954,2999700
2021-05-28,94.8 ( 1.07 %),3871,3983600,1029.09,3676,3472800,945,510800
2021-05-27,93.8 ( -1.57 %),3309,2821000,852.52,3035,3980400,1311,-1159400
2021-05-26,95.3 ( 1.6 %),4038,4291900,1062.88,3289,3991800,1214,300100
2021-05-25,93.8 ( 0.32 %),4970,4606300,926.82,2608,3454900,1325,1151400
2021-05-24,93.5 ( -0.32 %),6315,5652900,895.15,3443,4456900,1294,1196000
2021-05-21,93.8 ( -1.78 %),5581,5163200,925.14,6640,6785200,1022,-1622000
2021-05-20,95.5 ( 5.18 %),4157,5967400,1435.51,3586,5121500,1428,845900
2021-05-19,90.8 ( 4.37 %),4468,5347300,1196.8,4468,4223300,945,1124000
2021-05-18,87 ( 1.52 %),3547,4155500,1171.55,3409,3742100,1098,413400
2021-05-17,85.7 ( 1.06 %),3210,4670700,1455.05,2979,3499600,1175,1171100
2021-05-14,84.8 ( 0.95 %),3362,3564800,1060.32,3250,3715600,1143,-150800
2021-05-13,84 ( -1.64 %),5171,4198700,811.97,1923,4026000,2094,172700
2021-05-12,85.4 ( 0.23 %),4299,3663100,852.08,2009,3038300,1512,624800
2021-05-11,85.2 ( -0.7 %),3041,3457700,1137.03,2882,3959300,1374,-501600
2021-05-10,85.8 ( 3.37 %),5575,8133400,1458.91,4521,7359800,1628,773600
2021-05-07,83 ( 0.36 %),5095,4648200,912.31,3632,5930300,1633,-1282100
2021-05-06,82.7 ( -0.24 %),3753,3342100,890.51,2622,4187600,1597,-845500
2021-05-05,82.9 ( 0 %),3564,4000700,1122.53,4166,5744100,1379,-1743400
2021-05-04,82.9 ( 2.47 %),4959,4695300,946.82,3669,4555900,1242,139400
2021-04-29,80.9 ( 0.12 %),3595,3880100,1079.3,2139,3729800,1744,150300
2021-04-28,80.8 ( 0.12 %),3514,3055600,869.55,1716,2434000,1418,621600
2021-04-27,80.7 ( -0.37 %),3953,3064900,775.34,1931,2681800,1389,383100
2021-04-23,83 ( 3.75 %),4530,5875000,1296.91,3860,4841200,1254,1033800
2021-04-22,0 ( 0 %),3489,4036800,1157.01,3795,5578800,1470,-1542000
2021-04-20,82.9 ( 1.72 %),5912,7778800,1315.76,7279,8400700,1154,-621900
2021-04-19,81.5 ( 2.26 %),3133,3809500,1215.93,2709,4136200,1527,-326700
2021-04-16,79.7 ( -0.37 %),4517,3292500,728.91,2297,3852000,1677,-559500
2021-04-15,80 ( -1.23 %),3630,3265500,899.59,1860,3617200,1945,-351700
2021-04-14,81 ( 0.37 %),4665,4802800,1029.54,1938,4003700,2066,799100
2021-04-13,80.7 ( -1.71 %),2857,2779200,972.77,2398,3821700,1594,-1042500
2021-04-12,82.1 ( 0 %),3568,3524100,987.7,3146,3804700,1209,-280600
2021-04-09,82.1 ( 3.14 %),4660,7521800,1614.12,6023,7222600,1199,299200
2021-04-08,79.6 ( 0 %),1933,2403300,1243.3,2712,4025200,1484,-1621900
2021-04-07,79.6 ( 0.25 %),2778,2609100,939.2,1550,2532800,1634,76300
2021-04-06,79.4 ( -0.25 %),2486,2589300,1041.55,2280,3462900,1519,-873600
2021-04-05,79.6 ( -0.25 %),2318,2265100,977.18,2536,3857400,1521,-1592300
2021-04-02,79.8 ( 0.13 %),2487,2647000,1064.33,3676,4968000,1351,-2321000
2021-04-01,79.7 ( 2.57 %),2979,4053800,1360.79,3614,4160300,1151,-106500
2021-03-31,77.7 ( 0.78 %),2341,2284700,975.95,2269,2825200,1245,-540500
2021-03-30,77.1 ( -0.64 %),2373,2381500,1003.58,1753,2650900,1512,-269400
2021-03-29,77.6 ( 1.97 %),3089,3341800,1081.84,2124,2941300,1385,400500
2021-03-26,76.1 ( -0.65 %),5231,4448900,850.49,2345,4477200,1909,-28300
2021-03-25,76.6 ( -0.52 %),4493,3828000,851.99,2268,4303200,1897,-475200
2021-03-24,77 ( -2.28 %),4723,4643800,983.23,1943,4352700,2240,291100
2021-03-23,78.8 ( 0.13 %),3433,3868900,1126.97,2313,4594700,1986,-725800
2021-03-22,78.7 ( -1.38 %),4712,3486900,740,2033,3852700,1895,-365800
2021-03-19,79.8 ( -1.48 %),4230,3773200,892.01,2157,4125100,1912,-351900
2021-03-18,81 ( 0.25 %),1623,2303400,1419.22,2535,3872000,1527,-1568600
2021-03-17,80.8 ( -0.86 %),2835,2573100,907.62,2821,4061800,1440,-1488700
2021-03-16,81 ( 5.88 %),5854,9311600,1590.64,6845,7853800,1147,1457800
2021-03-15,76.5 ( 0 %),2491,270150,108.45,2868,373880,130,-103730
2021-03-12,76.5 ( -0.26 %),2371,3015900,1271.99,2239,3773100,1685,-757200
2021-03-11,76.7 ( 0.52 %),1790,2085800,1165.25,2360,3394100,1438,-1308300
2021-03-10,76.3 ( 1.73 %),3340,4327700,1295.72,2914,4521500,1552,-193800
2021-03-09,75 ( -1.06 %),0,0,0,0,0,0,0
2021-03-08,75.8 ( -0.13 %),3106,253910,81.75,1543,268860,174,-14950
2021-03-05,75.9 ( 0 %),5100,4891900,959.2,2052,3900500,1901,991400
2021-03-04,75.9 ( -2.32 %),4527,4328100,956.06,2341,5217000,2229,-888900
2021-03-03,77.7 ( -0.26 %),2224,2644200,1188.94,2384,3426700,1437,-782500
2021-03-02,77.9 ( 0 %),2876,306090,106.43,2818,441950,157,-135860
2021-03-01,77.9 ( 2.23 %),3183,4960800,1558.53,3086,3962800,1284,998000
2021-02-26,76.2 ( 0 %),4513,4593600,1017.86,1856,3184500,1716,1409100
2021-02-25,76.2 ( 1.06 %),3562,3826300,1074.2,2237,3524000,1575,302300
2021-02-24,75.4 ( -0.13 %),3932,3845100,977.9,2165,3950300,1825,-105200
2021-02-23,75.5 ( -1.69 %),5456,5102000,935.12,2252,4878300,2166,223700
2021-02-22,76.8 ( 0.26 %),3732,3699900,991.4,2594,3848700,1484,-148800
2021-02-19,76.6 ( -2.05 %),6116,6007300,982.23,2368,6136100,2591,-128800
2021-02-18,78.2 ( 0.39 %),3867,4024500,1040.73,2718,4718100,1736,-693600
2021-02-17,77.9 ( 4.42 %),3218,4547600,1413.18,3150,6188600,1965,-1641000
2021-02-09,74.6 ( 4.63 %),3963,724310,182.77,3197,600090,188,124220
2021-02-08,71.3 ( -2.19 %),5722,656450,114.72,2882,591550,205,64900
2021-02-05,72.9 ( 0.55 %),3045,3631800,1192.71,2930,5088000,1737,-1456200
2021-02-04,72.5 ( 3.57 %),3879,7879400,2031.3,4290,7680900,1790,198500
2021-02-03,70 ( 6.06 %),3581,6690900,1868.44,4499,6643000,1477,47900
2021-02-02,66 ( 3.94 %),2472,4726300,1911.93,2729,4611300,1690,115000
2021-02-01,63.5 ( 1.28 %),2899,3586700,1237.22,2029,3635500,1792,-48800
2021-01-29,62.7 ( 7 %),4911,8883400,1808.88,1883,3776100,2005,5107300
2021-01-28,58.6 ( -6.98 %),4673,6746500,1443.72,3684,9324700,2531,-2578200
2021-01-27,63 ( -4.55 %),2854,3543200,1241.49,1853,4305900,2324,-762700
2021-01-26,66 ( -1.49 %),2698,402940,149.35,1811,478780,264,-75840
2021-01-25,67 ( 0.15 %),2069,458760,221.73,2783,503170,181,-44410
2021-01-22,66.9 ( 1.98 %),1866,393930,211.11,2830,565360,200,-171430
2021-01-21,65.6 ( 3.63 %),2648,4555000,1720.17,1564,3461000,2213,1094000
2021-01-20,63.3 ( 2.1 %),3618,8104200,2239.97,2354,5575000,2368,2529200
2021-01-19,62 ( -6.49 %),3709,4465300,1203.91,2408,6624100,2751,-2158800
2021-01-18,66.3 ( -0.45 %),1504,2034700,1352.86,1441,2795400,1940,-760700
2021-01-15,66.6 ( 0.3 %),1407,2273400,1615.78,1385,3046300,2199,-772900
2021-01-14,66.4 ( -0.15 %),2424,3226900,1331.23,1609,3139000,1951,87900
2021-01-13,66.5 ( 1.06 %),1921,3739900,1946.85,1969,4400600,2235,-660700
2021-01-12,65.8 ( 1.7 %),1949,4155600,2132.17,2157,3628000,1682,527600
2021-01-11,64.7 ( 2.21 %),1655,3419800,2066.34,1601,2913000,1819,506800
2021-01-08,63.3 ( 1.28 %),1814,4108100,2264.66,1985,4062400,2047,45700
2021-01-07,62.5 ( 0.16 %),2732,3351700,1226.83,1495,3534200,2364,-182500
2021-01-06,62.4 ( -0.48 %),1855,2585500,1393.8,1954,4058200,2077,-1472700
2021-01-05,62.7 ( 4.15 %),2104,4457500,2118.58,2703,4237500,1568,220000
2021-01-04,60.2 ( 1.86 %),0,0,0,0,0,0,0
2020-12-31,59.1 ( 1.72 %),0,0,0,0,0,0,0
2020-12-30,58.1 ( -0.85 %),1835,1820950,992.34,2210,2735430,1238,-914480
2020-12-29,58.6 ( 1.21 %),1773,3843860,2168,3230,3946620,1222,-102760
2020-12-28,57.9 ( 0.52 %),2581,3500760,1356.36,2624,3793730,1446,-292970
2020-12-25,57.6 ( 1.05 %),2949,3042440,1031.69,2263,2802970,1239,239470
2020-12-24,57 ( -0.87 %),3436,3681780,1071.53,2384,4651420,1951,-969640
2020-12-23,57.5 ( -1.03 %),2054,2071390,1008.47,2163,2947720,1363,-876330
2020-12-22,58.1 ( 1.04 %),0,0,0,0,0,0,0
2020-12-21,57.5 ( 1.05 %),2010,3241150,1612.51,2845,4003750,1407,-762600
2020-12-18,56.9 ( 0.71 %),2119,2675110,1262.44,2131,2924780,1372,-249670
2020-12-17,56.5 ( -1.05 %),5548,4956820,893.44,1757,5120890,2915,-164070
2020-12-16,57.1 ( 0.71 %),2233,3085590,1381.81,2231,3747860,1680,-662270
2020-12-15,56.7 ( -0.87 %),0,0,0,0,0,0,0
2020-12-14,57.2 ( 0.35 %),1874,2206240,1177.29,2463,3096520,1257,-890280
2020-12-11,57 ( 0.88 %),1986,2948890,1484.84,2068,3082840,1491,-133950
2020-12-10,56.5 ( -1.74 %),3105,3220670,1037.25,2796,4156730,1487,-936060
2020-12-09,57.5 ( 2.31 %),2959,5149040,1740.13,3664,5202950,1420,-53910
2020-12-08,56.2 ( 0.9 %),0,0,0,0,0,0,0
2020-12-07,55.7 ( 0 %),2664,2488810,934.24,2152,3438790,1598,-949980
2020-12-04,55.7 ( 0.18 %),2661,2414320,907.3,1977,3074410,1555,-660090
2020-12-03,55.6 ( 0 %),2799,3041260,1086.55,1576,2844330,1805,196930
2020-12-02,55.6 ( 0.72 %),3273,3533760,1079.67,2064,3539690,1715,-5930
2020-12-01,55.2 ( -0.36 %),5543,5355890,966.24,2200,4728160,2149,627730
2020-11-30,55.4 ( -1.42 %),2766,3822620,1382,2795,5036570,1802,-1213950
2020-11-27,56.2 ( 0.9 %),2121,3426060,1615.3,2654,3795250,1430,-369190
2020-11-26,55.7 ( 0.91 %),2266,2912980,1285.52,2567,3668640,1429,-755660
2020-11-25,55.2 ( -0.72 %),2026,2574940,1270.95,2908,4262890,1466,-1687950
2020-11-23,55.9 ( 1.27 %),3452,4545980,1316.91,3084,4443530,1441,102450
2020-11-20,55.2 ( 0.18 %),2259,2839950,1257.17,3105,4859770,1565,-2019820
2020-11-19,55.1 ( 2.04 %),4821,8304750,1722.62,5069,8207220,1619,97530
2020-11-18,54 ( 0 %),2662,3142630,1180.55,2735,3644260,1332,-501630
2020-11-17,54 ( 1.31 %),3318,4795920,1445.42,2296,4010750,1747,785170
2020-11-16,53.3 ( -0.93 %),4484,5189790,1157.4,3914,6341270,1620,-1151480
2020-11-13,53.8 ( 0.56 %),2472,2514860,1017.34,2735,3302390,1207,-787530
2020-11-12,53.5 ( 0.94 %),2020,2187160,1082.75,1712,2221630,1298,-34470
2020-11-11,53 ( 0 %),2560,2825490,1103.71,1757,3006090,1711,-180600
2020-11-10,53 ( -0.75 %),2432,2428660,998.63,2949,4105210,1392,-1676550
2020-11-09,53.4 ( 1.91 %),2251,2992560,1329.44,2580,3273550,1269,-280990
2020-11-06,52.4 ( 0.77 %),2156,2378410,1103.16,1699,2403980,1415,-25570
2020-11-05,52 ( -1.89 %),2436,2100430,862.25,2231,3070620,1376,-970190
2020-11-04,53 ( 0.38 %),2060,2692970,1307.27,2688,3193520,1188,-500550
2020-11-03,52.8 ( 2.13 %),2926,4508110,1540.71,2551,3991900,1565,516210
2020-11-02,51.7 ( 0.39 %),2062,1703580,826.18,1287,1900050,1476,-196470
2020-10-30,51.5 ( 1.18 %),2983,2811980,942.67,1791,2805820,1567,6160
2020-10-29,50.9 ( 0.39 %),5428,5416070,997.8,2939,4429110,1507,986960
2020-10-28,50.7 ( -2.69 %),0,0,0,0,0,0,0
2020-10-27,52.1 ( -1.33 %),0,0,0,0,0,0,0
2020-10-26,52.8 ( -2.04 %),5160,5237520,1015.02,3224,8314020,2579,-3076500
2020-10-23,53.9 ( -0.19 %),3409,4312010,1264.89,2970,5291830,1782,-979820
2020-10-22,54 ( 2.27 %),2916,4521450,1550.57,3042,3598360,1183,923090
2020-10-21,52.8 ( -0.75 %),4617,5611920,1215.49,3883,6287390,1619,-675470
2020-10-20,53.2 ( -0.19 %),3539,3088950,872.83,2178,3113050,1429,-24100
2020-10-19,53.3 ( 0.19 %),3359,4419020,1315.58,2861,4783130,1672,-364110
2020-10-16,53.2 ( 3.91 %),6341,10664250,1681.79,6211,9433750,1519,1230500
2020-10-15,51.2 ( 0.39 %),3000,3685930,1228.64,2309,3784370,1639,-98440
2020-10-14,51 ( 0.59 %),2716,3991760,1469.72,2852,4789000,1679,-797240
2020-10-13,50.7 ( -0.39 %),2088,2192430,1050.01,1561,2851940,1827,-659510
2020-10-12,50.9 ( 0.2 %),2063,2620970,1270.47,2566,3590350,1399,-969380
2020-10-09,50.8 ( -0.59 %),1891,2298650,1215.57,1834,2811960,1533,-513310
2020-10-08,51.1 ( 1.39 %),2591,4959770,1914.23,4744,6224320,1312,-1264550
2020-10-07,50.4 ( -0.2 %),2599,2725720,1048.76,1941,3287130,1694,-561410
2020-10-06,50.5 ( 0 %),2071,2785830,1345.16,2310,3573070,1547,-787240
2020-10-05,50.5 ( 0.4 %),3360,2971110,884.26,1554,2724530,1753,246580
2020-10-02,50.3 ( -0.98 %),3565,3389170,950.68,2443,4380150,1793,-990980
2020-10-01,50.8 ( 1.6 %),1862,1898070,1019.37,1630,1771770,1087,126300
2020-09-30,50 ( -0.4 %),4680,3966160,847.47,1760,4287570,2436,-321410
2020-09-29,50.2 ( -1.76 %),3059,2829010,924.82,2089,3635010,1740,-806000
2020-09-28,51.1 ( 0.59 %),1870,2305670,1232.98,1904,3132750,1645,-827080
2020-09-25,50.8 ( 0.59 %),2837,2453630,864.87,1419,2389050,1684,64580
2020-09-24,50.5 ( -1.17 %),3826,2891830,755.84,1522,3088180,2029,-196350
2020-09-23,51.1 ( -0.39 %),2468,2692180,1090.83,1790,3534680,1975,-842500
2020-09-22,51.3 ( 0.2 %),0,0,0,0,0,0,0
2020-09-21,51.2 ( 0 %),1994,2456420,1231.91,2689,3175600,1181,-719180
2020-09-18,51.2 ( 2.4 %),2990,5581180,1866.62,4750,6574450,1384,-993270
2020-09-17,50 ( -0.99 %),1874,2595900,1385.22,2055,3073260,1496,-477360
2020-09-16,50.5 ( 1 %),1892,3283200,1735.31,4111,4928010,1199,-1644810
2020-09-15,50 ( 1.42 %),1606,3331440,2074.37,3056,3275520,1072,55920
2020-09-14,49.3 ( 0.31 %),1749,2178000,1245.28,1556,2342780,1506,-164780
2020-09-11,49.15 ( -0.1 %),2255,2053430,910.61,1225,1843670,1505,209760
2020-09-10,49.2 ( 0 %),1734,1663940,959.6,1726,2463310,1427,-799370
2020-09-09,49.2 ( -0.61 %),3162,3182890,1006.61,1499,2882930,1923,299960
2020-09-08,49.5 ( 2.06 %),3050,3477740,1140.24,1941,2753500,1419,724240
2020-09-07,48.5 ( -3 %),3719,3112130,836.82,2290,4185920,1828,-1073790
2020-09-04,50 ( -0.79 %),3441,3118680,906.33,2061,3121060,1514,-2380
2020-09-03,50.4 ( 1 %),1899,3519370,1853.28,3414,4409900,1292,-890530
2020-09-01,49.9 ( 0.81 %),2142,3198200,1493.09,3094,4067950,1315,-869750
2020-08-31,49.5 ( -0.8 %),2482,3130990,1261.48,3329,4256000,1278,-1125010
2020-08-28,49.9 ( 0.1 %),3212,5590710,1740.57,5753,8303580,1443,-2712870
2020-08-27,49.85 ( 3 %),2560,6546670,2557.29,4274,5642610,1320,904060
2020-08-26,48.4 ( -0.92 %),2233,2627240,1176.55,2498,3421620,1370,-794380
2020-08-25,48.85 ( 0.83 %),1990,4568620,2295.79,4397,5828330,1326,-1259710
2020-08-24,48.45 ( 2.22 %),2829,6133390,2168.04,4503,5615020,1247,518370
2020-08-21,47.4 ( 0.74 %),1452,2599610,1790.37,2561,3154980,1232,-555370
2020-08-20,47.05 ( 0.43 %),2283,3318820,1453.71,2714,4205460,1550,-886640
2020-08-19,46.85 ( 0 %),1811,1563970,863.59,1320,2084370,1579,-520400
2020-08-18,46.85 ( -0.32 %),1376,1286700,935.1,1209,1633940,1351,-347240
2020-08-17,47 ( -1.67 %),3138,2137210,681.07,1654,2493320,1507,-356110
2020-08-14,47.8 ( -0.31 %),2086,2725640,1306.63,3416,4462660,1306,-1737020
2020-08-13,47.95 ( 0.95 %),1988,2991050,1504.55,2871,3736380,1301,-745330
2020-08-12,47.5 ( 1.06 %),2258,2567260,1136.96,1780,2469830,1388,97430
2020-08-11,47 ( -0.42 %),2373,2046390,862.36,1960,2584220,1318,-537830
2020-08-10,47.2 ( 0.21 %),2025,2078310,1026.33,2135,3350160,1569,-1271850
2020-08-07,47.1 ( 0.64 %),2169,2520320,1161.97,2673,3175680,1188,-655360
2020-08-06,46.8 ( -0.43 %),2642,2218380,839.66,2280,2619690,1149,-401310
2020-08-05,47 ( 0.97 %),2059,2631140,1277.87,2435,2654550,1090,-23410
2020-08-04,46.55 ( 1.42 %),2393,2144590,896.19,2123,2318330,1092,-173740
2020-08-03,45.9 ( 3.15 %),3201,2900950,906.26,2026,2183300,1078,717650
2020-07-31,44.5 ( -1.44 %),3728,2622280,703.4,1533,2155150,1406,467130
2020-07-30,45.15 ( 1.35 %),2007,1557650,776.11,1363,1342750,985,214900
2020-07-29,44.55 ( -2.52 %),4979,3260640,654.88,1844,2498670,1355,761970
2020-07-28,45.7 ( 4.58 %),4977,3699240,743.27,2131,2701010,1267,998230
2020-07-27,43.7 ( -4.79 %),7755,5624210,725.24,3655,5336030,1460,288180
2020-07-24,45.9 ( -3.87 %),7049,5077810,720.36,2935,5396210,1839,-318400
2020-07-23,47.75 ( 0.74 %),2158,1881240,871.75,1369,1850100,1351,31140
2020-07-22,47.4 ( -0.84 %),2034,1583300,778.42,1341,1875820,1399,-292520
2020-07-21,47.8 ( 0.84 %),2282,2025480,887.59,1347,2068940,1536,-43460
2020-07-20,47.4 ( -1.46 %),0,0,0,0,0,0,0
2020-07-17,48.1 ( -1.03 %),2461,1983800,806.1,1707,2731190,1600,-747390
2020-07-16,48.6 ( 0 %),1694,1869520,1103.61,2135,2834170,1327,-964650
2020-07-15,48.6 ( 0.1 %),1944,2575850,1325.03,3151,3825340,1214,-1249490
2020-07-14,48.55 ( -0.21 %),2351,2817340,1198.36,2499,3411020,1365,-593680
2020-07-13,48.65 ( 1.78 %),2732,4149060,1518.69,4709,5554920,1180,-1405860
2020-07-10,47.8 ( -1.14 %),2588,2080330,803.84,2244,2906170,1295,-825840
2020-07-09,48.35 ( 1.36 %),0,0,0,0,0,0,0
2020-07-08,47.7 ( 0.53 %),2202,2710780,1231.05,3036,3452670,1137,-741890
2020-07-07,47.45 ( 1.39 %),3450,4849550,1405.67,3829,5361760,1400,-512210
2020-07-06,46.8 ( 1.19 %),1698,2060520,1213.5,1842,2386520,1296,-326000
2020-07-03,46.25 ( 0.22 %),1358,1270640,935.67,1674,1787270,1068,-516630
2020-07-02,46.15 ( -0.11 %),1876,1395740,744,1306,1702010,1303,-306270
2020-07-01,46.2 ( 1.2 %),2229,1799920,807.5,1692,1779370,1052,20550
2020-06-30,45.65 ( -0.87 %),3888,2651580,681.99,2693,2997800,1113,-346220
2020-06-29,46.05 ( -1.71 %),3978,2283970,574.15,1689,2202890,1304,81080
2020-06-26,46.85 ( 0.11 %),1695,1277160,753.49,1452,2117330,1458,-840170
2020-06-25,46.8 ( -0.85 %),2272,1568590,690.4,1288,1821490,1414,-252900
2020-06-24,47.2 ( -0.74 %),1609,1044730,649.3,2050,2489210,1214,-1444480
2020-06-23,47.55 ( 1.17 %),2953,3010730,1019.55,3283,3993330,1216,-982600
2020-06-22,47 ( 0 %),2389,1494220,625.46,1371,1856090,1354,-361870
2020-06-19,47 ( 0.86 %),2425,1612870,665.1,1580,1741810,1102,-128940
2020-06-18,46.6 ( 0.54 %),2109,1900620,901.19,1380,1659340,1202,241280
2020-06-17,46.35 ( -0.54 %),2604,1620180,622.19,1360,1935890,1423,-315710
2020-06-16,46.6 ( 1.3 %),2614,2277300,871.19,1925,2304110,1197,-26810
2020-06-15,46 ( -2.13 %),4121,2384260,578.56,2069,3067160,1482,-682900
2020-06-12,47 ( 2.17 %),8278,6836420,825.85,3516,4844480,1378,1991940
2020-06-11,46 ( -5.74 %),7294,5385500,738.35,2907,6576380,2262,-1190880
2020-06-10,48.8 ( -0.31 %),3210,2407230,749.92,1827,2422140,1326,-14910
2020-06-09,48.95 ( -0.81 %),2463,2422530,983.57,2785,3852000,1383,-1429470
2020-06-08,49.35 ( 1.33 %),0,0,0,0,0,0,0
2020-06-05,48.7 ( 0.62 %),4406,4376420,993.29,4759,5895570,1239,-1519150
2020-06-04,48.4 ( -0.51 %),1940,2157950,1112.35,3017,3614960,1198,-1457010
2020-06-03,48.65 ( 1.35 %),2500,3318560,1327.42,3255,4068500,1250,-749940
2020-06-02,48 ( -0.62 %),2984,2157810,723.13,2121,3137740,1479,-979930
2020-06-01,48.3 ( 0.73 %),2320,2444930,1053.85,2226,2846020,1279,-401090
2020-05-29,47.95 ( -0.1 %),4498,2608350,579.89,1688,2979050,1765,-370700
2020-05-28,48 ( 0 %),2998,2919530,973.83,2285,2876040,1259,43490
2020-05-27,48 ( -1.64 %),3208,3001840,935.74,3770,5344030,1418,-2342190
2020-05-26,48.8 ( 0.72 %),3351,3011440,898.67,2351,3209240,1365,-197800
2020-05-25,48.45 ( 0 %),5653,3894780,688.98,2362,3663420,1551,231360
2020-05-22,48.45 ( -1.72 %),3505,2697720,769.68,2361,3836580,1625,-1138860
2020-05-21,49.3 ( 0.82 %),2413,3067980,1271.44,3440,3829200,1113,-761220
2020-05-20,48.9 ( -0.71 %),2823,2277340,806.71,2464,2764330,1122,-486990
2020-05-19,49.25 ( 1.86 %),3076,4581310,1489.37,4534,6476610,1428,-1895300
2020-05-18,48.35 ( 0.73 %),5183,3716920,717.14,3054,3321540,1088,395380
2020-05-15,48 ( -1.44 %),7314,4819720,658.97,2485,4628210,1862,191510
2020-05-14,48.7 ( -1.32 %),6770,4807810,710.16,2089,4653890,2228,153920
2020-05-13,49.35 ( -9.28 %),17638,13537040,767.49,3476,10418120,2997,3118920
2020-05-12,54.4 ( 0.74 %),4588,5392290,1175.3,2841,4517150,1590,875140
2020-05-11,54 ( 0.56 %),0,0,0,0,0,0,0
2020-05-08,53.7 ( 0.37 %),4172,5175970,1240.64,4180,6374740,1525,-1198770
2020-05-07,53.5 ( 1.13 %),4424,3407120,770.14,2602,3912420,1504,-505300
2020-05-06,52.9 ( 3.93 %),4439,6000210,1351.7,4247,5484720,1291,515490
2020-05-05,50.9 ( 0.79 %),2175,1757140,807.88,1346,1557810,1157,199330
2020-05-04,50.5 ( -0.59 %),3418,2006840,587.14,1135,1559630,1374,447210
2020-04-29,50.8 ( 0.2 %),2373,2505250,1055.73,1862,2598190,1395,-92940
2020-04-28,50.7 ( 0 %),2972,2355000,792.4,1263,2005940,1588,349060
2020-04-27,50.7 ( -0.59 %),3118,2704240,867.3,1926,2955680,1535,-251440
2020-04-24,51 ( 0 %),4194,3637040,867.2,1816,2755060,1517,881980
2020-04-23,51 ( -0.2 %),2958,2166250,732.34,2943,3441820,1169,-1275570
2020-04-22,51.1 ( 3.65 %),4983,6037480,1211.62,2404,3799130,1580,2238350
2020-04-21,49.3 ( -3.9 %),6491,5880770,905.99,3796,6876290,1811,-995520
2020-04-20,51.3 ( 0.2 %),4717,4263000,903.75,3095,4361380,1409,-98380
2020-04-17,51.2 ( 1.79 %),4117,4906090,1191.67,2988,4467090,1495,439000
2020-04-16,50.3 ( 0.4 %),3530,2917560,826.5,2610,2779760,1065,137800
2020-04-15,50.1 ( 1.21 %),3923,4071390,1037.83,3253,3882850,1194,188540
2020-04-14,49.5 ( 6.45 %),5488,7392810,1347.09,5175,5945240,1149,1447570
2020-04-13,46.5 ( 0.22 %),3336,2769720,830.25,1845,2526500,1369,243220
2020-04-10,46.4 ( -0.96 %),4159,3324890,799.44,1928,3845850,1995,-520960
2020-04-09,46.85 ( 0 %),3312,3149060,950.8,2681,4077620,1521,-928560
2020-04-08,46.85 ( -0.95 %),3568,3124140,875.6,2059,2809170,1364,314970
2020-04-07,47.3 ( -0.42 %),3728,4205610,1128.11,3072,4768100,1552,-562490
2020-04-06,47.5 ( 6.5 %),4813,4748980,986.7,3331,4325350,1299,423630
2020-04-03,44.6 ( 5.44 %),3468,3608560,1040.53,3085,3414190,1107,194370
2020-04-01,42.3 ( 2.92 %),2639,3177650,1204.11,2200,2721650,1237,456000
2020-03-31,41.1 ( 1.73 %),3439,3467170,1008.19,2782,3189230,1146,277940
2020-03-30,40.4 ( -6.26 %),5030,3926080,780.53,1651,3046770,1845,879310
2020-03-27,43.1 ( -2.49 %),4985,3837470,769.8,1690,4591450,2717,-753980
2020-03-26,44.2 ( -3.91 %),4276,3425990,801.21,1760,4256880,2419,-830890
2020-03-25,46 ( 3.37 %),3026,3235260,1069.15,1969,3557180,1807,-321920
2020-03-24,44.5 ( 0.23 %),3088,3510350,1136.77,2061,4117770,1998,-607420
2020-03-23,44.4 ( -6.92 %),4783,3218090,672.82,1883,6643770,3528,-3425680
2020-03-20,47.7 ( 0 %),2630,2429090,923.61,1192,2474260,2076,-45170
2020-03-19,47.7 ( -1.45 %),2820,2443780,866.59,1077,2702540,2509,-258760
2020-03-18,48.4 ( -0.21 %),3300,3010030,912.13,1536,3229400,2102,-219370
2020-03-17,48.5 ( 1.89 %),3343,5759910,1722.98,1780,4379050,2460,1380860
2020-03-16,47.6 ( -1.14 %),3021,3392900,1123.1,1834,4642370,2531,-1249470
2020-03-13,48.15 ( 0.1 %),4429,5668070,1279.76,2762,5893570,2134,-225500
2020-03-12,48.1 ( -5.31 %),4959,6161860,1242.56,2405,6062630,2521,99230
2020-03-11,50.8 ( -1.74 %),4094,4884150,1193,1408,4203640,2986,680510
2020-03-10,51.7 ( 2.78 %),4057,4061760,1001.17,1662,3095490,1863,966270
2020-03-09,50.3 ( -6.85 %),6375,6165190,967.09,2438,6908160,2834,-742970
2020-03-06,54 ( -1.1 %),3170,2804450,884.68,871,1973690,2266,830760
2020-03-05,54.6 ( -1.62 %),1728,1763950,1020.8,1121,2332160,2080,-568210
2020-03-04,55.5 ( -0.72 %),1930,2780590,1440.72,925,2395190,2589,385400
2020-03-03,55.9 ( 0.36 %),1332,2391270,1795.25,1918,3060100,1595,-668830
2020-03-02,55.7 ( 1.09 %),0,0,0,0,0,0,0
2020-02-28,55.1 ( -1.61 %),2275,3529870,1551.59,1730,3354830,1939,175040
2020-02-27,56 ( 1.82 %),1702,4117000,2418.92,3266,4589210,1405,-472210
2020-02-26,55 ( 1.85 %),2052,5260520,2563.61,2257,4748210,2104,512310
2020-02-25,54 ( 2.86 %),3253,3949510,1214.11,1031,1921900,1864,2027610
2020-02-24,52.5 ( -4.02 %),0,0,0,0,0,0,0
2020-02-21,54.7 ( -1.97 %),0,0,0,0,0,0,0
2020-02-20,55.8 ( 0.18 %),1367,1703020,1245.81,1184,1718890,1452,-15870
2020-02-19,55.7 ( -0.54 %),1221,1289320,1055.95,1305,1762310,1350,-472990
2020-02-18,56 ( 3.32 %),1604,3002300,1871.76,2045,2410730,1179,591570
2020-02-17,54.2 ( -0.55 %),1549,1711770,1105.08,1017,1635260,1608,76510
2020-02-14,54.5 ( 0.37 %),1491,1751800,1174.92,983,1598100,1626,153700
2020-02-13,54.3 ( 0.37 %),1765,1912150,1083.37,1256,1951190,1553,-39040
2020-02-12,54.1 ( 0.93 %),1664,2050510,1232.28,1829,2669340,1459,-618830
2020-02-11,53.6 ( 1.9 %),1596,2413680,1512.33,1534,1947620,1270,466060
2020-02-10,52.6 ( -1.31 %),2233,2042670,914.76,935,1535180,1642,507490
2020-02-07,53.3 ( -0.56 %),2626,2148540,818.18,1173,2780980,2371,-632440
2020-02-06,53.6 ( 3.08 %),3354,4916950,1466,1563,2578440,1650,2338510
2020-02-05,52 ( 0.39 %),2633,2347990,891.75,1402,3104540,2214,-756550
2020-02-04,51.8 ( 0.58 %),3640,4187980,1150.54,1597,3337910,2090,850070
2020-02-03,51.5 ( -0.96 %),4479,7811240,1743.97,3350,5819790,1737,1991450
2020-01-31,52 ( -4.94 %),5385,6227190,1156.4,2654,7512060,2830,-1284870
2020-01-30,54.7 ( -3.19 %),4538,3618450,797.37,1442,4194760,2909,-576310
2020-01-22,56.5 ( 1.8 %),5640,6869620,1218.02,2043,4913660,2405,1955960
2020-01-21,55.5 ( -3.31 %),4811,5993670,1245.83,2298,7962730,3465,-1969060
2020-01-20,57.4 ( -0.35 %),2015,2129180,1056.67,890,2304350,2589,-175170
2020-01-17,57.6 ( -0.69 %),2413,2163370,896.55,1089,2850550,2618,-687180
2020-01-16,58 ( 1.75 %),1917,3041280,1586.48,1715,3512570,2048,-471290
2020-01-15,57 ( 0 %),1702,1384120,813.23,893,2082820,2332,-698700
2020-01-14,57 ( -0.18 %),1354,1262130,932.15,790,1542570,1953,-280440
2020-01-13,57.1 ( -0.7 %),1812,1368650,755.33,669,1527720,2284,-159070
2020-01-10,57.5 ( -0.17 %),1977,1731250,875.7,828,1951290,2357,-220040
2020-01-09,57.6 ( 1.41 %),1513,2218420,1466.24,1714,1926180,1124,292240
2020-01-08,56.8 ( -2.24 %),4531,3158060,696.99,1676,3299490,1969,-141430
2020-01-07,58.1 ( 1.93 %),1366,2061280,1508.99,976,1386880,1421,674400
2020-01-06,57 ( -1.04 %),2107,2289220,1086.48,1199,2079880,1735,209340
2020-01-03,57.6 ( -1.71 %),2796,2661950,952.06,1613,3694180,2290,-1032230
2020-01-02,58.6 ( 0.51 %),1651,1701860,1030.81,1315,1866470,1419,-164610
2019-12-31,58.3 ( -0.51 %),1430,1517370,1061.1,1274,1665160,1307,-147790
2019-12-30,58.6 ( 1.74 %),1938,4545590,2345.51,2151,4261990,1981,283600
2019-12-27,57.6 ( 0.35 %),1412,2015470,1427.39,1066,1819990,1707,195480
2019-12-26,57.4 ( -0.17 %),1482,1834960,1238.16,1700,2831040,1665,-996080
2019-12-25,57.5 ( 1.95 %),1528,2798270,1831.33,2034,2750700,1352,47570
2019-12-24,56.4 ( 0.53 %),1001,1342810,1341.47,944,1292890,1370,49920
2019-12-23,56.1 ( -0.71 %),0,0,0,0,0,0,0
2019-12-20,56.5 ( 1.25 %),1277,1503670,1177.5,1131,1383780,1224,119890
2019-12-19,55.8 ( 0.54 %),1198,1658050,1384.02,986,1345750,1365,312300
2019-12-18,55.5 ( 0.18 %),2047,2685390,1311.87,995,1591280,1599,1094110
2019-12-17,55.4 ( -1.95 %),4097,4014070,979.76,1171,3280300,2801,733770
2019-12-16,56.5 ( -1.05 %),1739,1445170,831.04,1018,2080610,2044,-635440
2019-12-13,57.1 ( 0.18 %),1584,2248040,1419.22,1455,2811660,1932,-563620
2019-12-12,57 ( 0.88 %),1487,1613580,1085.12,1448,2286930,1579,-673350
2019-12-11,56.5 ( 1.8 %),1481,1757360,1186.6,1227,1863790,1519,-106430
2019-12-10,55.5 ( 0.36 %),1518,1882360,1240.03,983,1925700,1959,-43340
2019-12-09,55.3 ( 0.55 %),1064,1246210,1171.25,1221,1928370,1579,-682160
2019-12-06,55 ( 0.18 %),1460,2033060,1392.51,776,1500840,1934,532220
2019-12-05,54.9 ( -0.9 %),1650,1789770,1084.71,1079,2789280,2585,-999510
2019-12-04,55.4 ( 1.65 %),0,0,0,0,0,0,0
2019-12-03,54.5 ( -0.18 %),3216,3561310,1107.37,1588,3261870,2054,299440
2019-12-02,54.6 ( -3.19 %),2635,2699110,1024.33,1231,3690580,2998,-991470
2019-11-29,56.4 ( 0.71 %),1376,2086710,1516.5,1280,2373230,1854,-286520
2019-11-28,56 ( -1.75 %),2535,2270610,895.7,1218,2269600,1863,1010
2019-11-27,57 ( -0.18 %),1390,1303320,937.64,1286,1993000,1550,-689680
2019-11-26,57.1 ( 0.88 %),1574,1939660,1232.31,1269,1953510,1539,-13850
2019-11-25,56.6 ( 1.07 %),1859,2098930,1129.06,1658,1984190,1197,114740
2019-11-22,56 ( 0 %),2961,2966200,1001.76,1633,3067650,1879,-101450
2019-11-21,56 ( -1.41 %),4988,5488960,1100.43,1741,5808800,3336,-319840
2019-11-20,56.8 ( -2.57 %),3842,3439290,895.18,1311,3599170,2745,-159880
2019-11-19,58.3 ( 1.39 %),2135,2316310,1084.92,1376,2555180,1857,-238870
2019-11-18,57.5 ( -1.88 %),4360,4136470,948.73,1916,4927550,2572,-791080
2019-11-15,58.6 ( 0.51 %),4420,4407470,997.17,2107,4873220,2313,-465750
2019-11-14,58.3 ( -3.64 %),6006,7357630,1225.05,2756,8177980,2967,-820350
2019-11-13,60.5 ( -0.82 %),2136,2120310,992.65,1617,2969000,1836,-848690
2019-11-12,61 ( 1.67 %),2336,4704820,2014.05,2336,5143060,2202,-438240
2019-11-11,60 ( 0.67 %),2023,3701670,1829.79,1963,4748220,2419,-1046550
2019-11-08,59.6 ( 0.17 %),1874,2370750,1265.07,1099,1967940,1791,402810
2019-11-07,59.5 ( 0 %),2168,2388530,1101.72,1358,3079190,2267,-690660
2019-11-06,59.5 ( -0.5 %),1893,2634400,1391.65,1572,3476920,2212,-842520
2019-11-05,59.8 ( -0.17 %),2389,2473660,1035.44,1639,3072750,1875,-599090
2019-11-04,59.9 ( 2.39 %),4340,8862810,2042.12,4134,8375580,2026,487230
2019-11-01,58.5 ( 1.04 %),1714,2902720,1693.54,1751,6785900,3875,-3883180
2019-10-31,57.9 ( 0.17 %),1315,2054500,1562.36,1575,3175830,2016,-1121330
2019-10-30,57.8 ( -0.17 %),1558,1976350,1268.52,1245,2351090,1888,-374740
2019-10-29,57.9 ( -0.34 %),1335,1763340,1320.85,1280,2359570,1843,-596230
2019-10-28,58.1 ( 0.17 %),1832,2501170,1365.27,2354,3332500,1416,-831330
2019-10-25,58 ( -0.34 %),1532,2134070,1393,2155,3391380,1574,-1257310
2019-10-24,58.2 ( 3.19 %),1870,3906010,2088.78,2513,3276290,1304,629720
2019-10-23,56.4 ( 0.18 %),1716,1657460,965.89,911,1722810,1891,-65350
2019-10-22,56.3 ( -0.35 %),3204,2867680,895.03,990,2316260,2340,551420
2019-10-21,56.5 ( -1.05 %),2336,2167650,927.93,942,2445750,2596,-278100
2019-10-18,57.1 ( 0.71 %),1878,2401570,1278.79,1167,3086630,2645,-685060
2019-10-17,56.7 ( -1.39 %),2303,2409960,1046.44,1006,2813280,2797,-403320
2019-10-16,57.5 ( 0.17 %),1015,1543610,1520.8,1550,2402470,1550,-858860
2019-10-15,57.4 ( -0.52 %),1314,1445110,1099.78,1329,1980460,1490,-535350
2019-10-14,57.7 ( 2.12 %),1670,3710170,2221.66,2269,4173210,1839,-463040
2019-10-11,56.5 ( 0.18 %),1200,1506580,1255.48,1092,2069410,1895,-562830
2019-10-10,56.4 ( 0 %),1268,1445300,1139.83,1114,1643920,1476,-198620
2019-10-09,56.4 ( 0.53 %),2019,2075490,1027.98,1127,1786850,1585,288640
2019-10-08,56.1 ( 1.08 %),3255,2628080,807.4,1466,3154430,2152,-526350
2019-10-07,55.5 ( -2.29 %),4391,3275980,746.07,1572,3612040,2298,-336060
2019-10-04,56.8 ( -0.7 %),2563,2121130,827.6,965,2430570,2519,-309440
2019-10-03,57.2 ( 0 %),5533,4882570,882.45,1302,4305410,3307,577160
2019-10-02,57.2 ( -2.22 %),3874,3717930,959.71,1588,4178740,2631,-460810
2019-10-01,58.5 ( 1.39 %),2592,3441710,1327.82,1368,2642000,1931,799710
2019-09-30,57.7 ( -1.37 %),3190,3286070,1030.12,2135,4434390,2077,-1148320
2019-09-27,58.5 ( 1.39 %),2124,3759240,1769.89,2939,4006870,1363,-247630
2019-09-26,57.7 ( 0.52 %),1578,1815530,1150.53,1399,2234670,1597,-419140
2019-09-25,57.4 ( 2.14 %),2592,3416910,1318.25,1382,2143920,1551,1272990
2019-09-24,56.2 ( -0.53 %),4940,4876760,987.2,1484,3949050,2661,927710
2019-09-23,56.5 ( -2.92 %),4280,3036620,709.49,1469,3847770,2619,-811150
2019-09-20,58.2 ( 0.69 %),1909,2173150,1138.37,1580,2766130,1751,-592980
2019-09-19,57.8 ( 2.48 %),2410,2946870,1222.77,1403,2462870,1755,484000
2019-09-18,56.4 ( -2.08 %),3888,3751060,964.78,2079,4492650,2161,-741590
2019-09-17,57.6 ( -0.17 %),2447,2205950,901.49,1403,2240890,1597,-34940
2019-09-16,57.7 ( 1.58 %),2412,2495330,1034.55,1492,2602320,1744,-106990
2019-09-13,56.8 ( 0.53 %),3177,3615760,1138.11,1883,3613320,1919,2440
2019-09-12,56.5 ( 4.44 %),4327,7335160,1695.21,3426,5306040,1549,2029120
2019-09-11,54.1 ( 0.19 %),1576,2100030,1332.51,1247,2419910,1941,-319880
2019-09-10,54 ( 0.37 %),2022,3372360,1667.83,2026,3640440,1797,-268080
2019-09-09,53.8 ( 1.7 %),1934,4024250,2080.79,2591,4604370,1777,-580120
2019-09-06,52.9 ( 0.57 %),1823,2110210,1157.55,999,2453710,2456,-343500
2019-09-05,52.6 ( -1.13 %),1946,2126960,1092.99,1077,2351670,2184,-224710
2019-09-04,53.2 ( -0.93 %),1907,2466930,1293.62,1839,3400680,1849,-933750
2019-09-03,53.7 ( 1.13 %),1678,2458650,1465.23,1801,3024210,1679,-565560
2019-08-30,53.1 ( 0.76 %),1372,1505850,1097.56,1160,1585410,1367,-79560
2019-08-29,52.7 ( 1.15 %),2048,1907220,931.26,1100,1805470,1641,101750
2019-08-28,52.1 ( -1.33 %),2940,3033410,1031.77,1333,2575080,1932,458330
2019-08-27,52.8 ( -1.68 %),2461,2594150,1054.1,1545,3065760,1984,-471610
2019-08-26,53.7 ( -1.29 %),2489,3290290,1321.93,1424,3024420,2124,265870
2019-08-23,54.4 ( 2.64 %),3051,4073660,1335.19,1497,3093620,2067,980040
2019-08-22,53 ( -1.12 %),2290,3228780,1409.95,1884,3770890,2002,-542110
2019-08-21,53.6 ( -0.74 %),3099,3755670,1211.9,1937,3785830,1954,-30160
2019-08-20,54 ( 3.05 %),2086,4283210,2053.31,1652,3354660,2031,928550
2019-08-19,52.4 ( 0.77 %),4098,6457760,1575.83,2057,4621520,2247,1836240
2019-08-16,52 ( -1.89 %),3954,6107020,1544.52,2909,6785690,2333,-678670
2019-08-15,53 ( -0.38 %),3081,4201730,1363.76,1379,3351260,2430,850470
2019-08-14,53.2 ( 1.33 %),2161,3612860,1671.85,2110,3903340,1850,-290480
2019-08-13,52.5 ( 0.38 %),2925,3828450,1308.87,1913,3472630,1815,355820
2019-08-12,52.3 ( 2.35 %),2317,3519980,1519.2,1977,2869130,1451,650850
2019-08-09,51.1 ( 1.59 %),1861,3234990,1738.31,1888,2858900,1514,376090
2019-08-08,50.3 ( 1.11 %),2051,3230440,1575.06,1661,3310660,1993,-80220
2019-08-07,49.75 ( 1.63 %),1348,2670950,1981.42,1195,2096100,1754,574850
2019-08-06,48.95 ( -0.1 %),2172,2595250,1194.87,1175,2181390,1857,413860
2019-08-05,49 ( 0.41 %),2341,3615040,1544.23,1901,3823540,2011,-208500
2019-08-02,48.8 ( 0.93 %),1962,2916430,1486.46,1039,2198760,2116,717670
2019-08-01,48.35 ( -0.1 %),1196,1439580,1203.66,823,1907000,2317,-467420
2019-07-31,48.4 ( 1.26 %),1760,2077000,1180.11,850,1837560,2162,239440
2019-07-30,47.8 ( -1.65 %),1788,2770700,1549.61,1216,3387140,2785,-616440
2019-07-29,48.6 ( -0.41 %),1363,2457530,1803.03,933,2330840,2498,126690
2019-07-26,48.8 ( 0.31 %),1379,2439160,1768.79,923,1743910,1889,695250
2019-07-25,48.65 ( 0.1 %),1364,2075930,1521.94,1217,2321480,1908,-245550
2019-07-24,48.6 ( -0.41 %),2090,2810740,1344.85,1634,3793570,2322,-982830
2019-07-23,48.8 ( 0.93 %),1065,2255860,2118.18,1144,1826070,1596,429790
2019-07-22,48.35 ( 0.31 %),1504,3291320,2188.38,1530,3063790,2002,227530
2019-07-19,48.2 ( 2.99 %),1647,5150120,3126.97,2095,3869740,1847,1280380
2019-07-18,46.8 ( -0.53 %),1417,1736810,1225.7,737,2072390,2812,-335580
2019-07-17,47.05 ( -0.53 %),1407,2091670,1486.62,1161,2539270,2187,-447600
2019-07-16,47.3 ( 0 %),1272,1920540,1509.86,1264,2570290,2033,-649750
2019-07-15,47.3 ( 0.64 %),1406,2440830,1736.01,1315,2577680,1960,-136850
2019-07-12,47 ( 0 %),1230,2134820,1735.63,1505,2574500,1711,-439680
2019-07-11,47 ( -0.11 %),1076,1433800,1332.53,1174,2151820,1833,-718020
2019-07-10,47.05 ( 0.64 %),1240,1975980,1593.53,1687,2766120,1640,-790140
2019-07-09,46.75 ( 0.97 %),1476,2106550,1427.2,1111,2640520,2377,-533970
2019-07-08,46.3 ( -0.64 %),1952,2812990,1441.08,1194,2708220,2268,104770
2019-07-05,46.6 ( -0.75 %),1575,1961760,1245.56,1066,2903410,2724,-941650
2019-07-04,46.95 ( 0.32 %),0,0,0,0,0,0,0
2019-07-03,46.8 ( -0.21 %),1379,2075050,1504.75,1305,2442230,1871,-367180
2019-07-02,46.9 ( -0.42 %),1379,2075050,1504.75,1305,2442230,1871,-367180
2019-07-01,47.1 ( 3.52 %),1713,3942980,2301.8,2530,3618700,1430,324280
2019-06-28,45.5 ( 0.22 %),0,0,0,0,0,0,0
2019-06-27,45.4 ( -1.63 %),1583,1925540,1216.39,908,2414830,2660,-489290
2019-06-26,46.15 ( -0.75 %),1582,1668570,1054.72,1236,2259040,1828,-590470
2019-06-25,46.5 ( 2.99 %),2555,6413580,2510.21,1981,4237930,2139,2175650
2019-06-24,45.15 ( -0.55 %),822,1092220,1328.73,773,1794550,2322,-702330
2019-06-21,45.4 ( 0 %),1055,1211910,1148.73,1141,2092490,1834,-880580
2019-06-20,45.4 ( 1.68 %),1379,2075050,1504.75,1305,2442230,1871,-367180
2019-06-19,44.65 ( 1.36 %),1098,1042010,949.01,621,1188430,1914,-146420
2019-06-18,44.05 ( 0 %),1258,1428950,1135.89,497,1864070,3751,-435120
2019-06-17,44.05 ( -0.79 %),1506,1882460,1249.97,700,2805950,4008,-923490
2019-06-14,44.4 ( -0.34 %),986,1133370,1149.46,477,1526520,3200,-393150
2019-06-13,44.55 ( -1.11 %),1305,1382970,1059.75,639,2225280,3482,-842310
2019-06-12,45.05 ( -0.33 %),1485,3003370,2022.47,904,2931720,3243,71650
2019-06-11,45.2 ( 0.22 %),1312,2288050,1743.94,992,2816090,2839,-528040
2019-06-10,45.1 ( -0.22 %),1421,1629310,1146.59,1308,3215870,2459,-1586560
2019-06-07,45.2 ( 1.57 %),1410,2525100,1790.85,1034,2241620,2168,283480
2019-06-06,44.5 ( 2.06 %),1341,1513630,1128.73,938,1841490,1963,-327860
2019-06-05,43.6 ( 0.69 %),1149,1068910,930.3,450,935850,2080,133060
2019-06-04,43.3 ( -0.46 %),1334,1001810,750.98,464,985780,2125,16030
2019-06-03,43.5 ( -1.36 %),0,0,0,0,0,0,0
2019-05-31,44.1 ( -1.01 %),857,913480,1065.9,602,1130290,1878,-216810
2019-05-30,44.55 ( 1.02 %),1617,2200920,1361.11,763,1509830,1979,691090
2019-05-29,44.1 ( -1.67 %),2326,2256690,970.2,854,2482440,2907,-225750
2019-05-28,44.85 ( -0.88 %),1188,927200,780.47,672,1048100,1560,-120900
2019-05-27,45.25 ( -0.77 %),2004,2124310,1060.03,824,2024820,2457,99490
2019-05-24,45.6 ( -0.22 %),1297,1661380,1280.94,810,2293390,2831,-632010
2019-05-23,45.7 ( 0.99 %),1456,2455200,1686.26,762,1882970,2471,572230
2019-05-22,45.25 ( -1.42 %),1559,2317840,1486.75,1115,2706820,2428,-388980
2019-05-21,45.9 ( 1.44 %),1323,1785230,1349.38,866,1746390,2017,38840
2019-05-20,45.25 ( 1.8 %),1816,3178890,1750.49,672,2204390,3280,974500
2019-05-17,44.45 ( -10.47 %),2983,2574790,863.15,644,2091810,3248,482980
2019-05-16,49.65 ( -1.49 %),1432,2648260,1849.34,1067,3651960,3423,-1003700
2019-05-15,50.4 ( 0.4 %),999,2248640,2250.89,958,2803270,2926,-554630
2019-05-14,50.2 ( 1.41 %),1230,2328780,1893.32,1021,2838170,2780,-509390
2019-05-13,49.5 ( 1.02 %),951,1206300,1268.45,748,1679490,2245,-473190
2019-05-10,49 ( 0.82 %),958,1654060,1726.58,587,1704740,2904,-50680
2019-05-09,48.6 ( -2.11 %),1226,1226890,1000.73,626,1867900,2984,-641010
2019-05-08,49.65 ( -0.1 %),1112,1607420,1445.52,484,1521710,3144,85710
2019-05-07,49.7 ( 1.95 %),1209,2949970,2440.01,648,1868860,2884,1081110
2019-05-06,48.75 ( -2.5 %),1775,2358200,1328.56,650,2271130,3494,87070
2019-05-03,50 ( 0.3 %),716,1887740,2636.51,776,2133280,2749,-245540
2019-05-02,49.85 ( 0.61 %),948,1276650,1346.68,803,1910220,2379,-633570
2019-04-26,49.55 ( 1.54 %),860,1599940,1860.4,951,1600180,1683,-240
2019-04-25,48.8 ( 0.51 %),827,1576530,1906.32,942,1845120,1959,-268590
2019-04-24,48.55 ( 1.36 %),658,1538310,2337.86,665,1330930,2001,207380
2019-04-23,47.9 ( 0 %),948,1060930,1119.12,411,820330,1996,240600
2019-04-22,47.9 ( -1.14 %),969,1207040,1245.66,590,1480880,2510,-273840
2019-04-19,48.45 ( -0.1 %),606,680390,1122.76,513,1034410,2016,-354020
2019-04-18,48.5 ( 0 %),1030,1455290,1412.9,823,1913520,2325,-458230
2019-04-17,48.5 ( 1.25 %),1419,2924320,2060.83,1246,3055600,2452,-131280
2019-04-16,47.9 ( -0.62 %),0,0,0,0,0,0,0
2019-04-12,48.2 ( 2.55 %),803,1849790,2303.6,843,1483400,1760,366390
2019-04-11,47 ( 0.21 %),379,659120,1739.1,349,774040,2218,-114920
2019-04-10,46.9 ( -0.85 %),729,1343400,1842.8,601,1366950,2274,-23550
2019-04-09,47.3 ( -1.05 %),771,1430280,1855.1,974,2209220,2268,-778940
2019-04-08,47.8 ( 0 %),515,902820,1753.05,637,1127490,1770,-224670
2019-04-05,47.8 ( 0 %),627,1173820,1872.12,826,1279220,1549,-105400
2019-04-04,47.8 ( 1.27 %),1214,2969160,2445.77,1501,2839240,1892,129920
2019-04-03,47.2 ( 2.61 %),867,2196170,2533.07,934,1436390,1538,759780
2019-04-02,46 ( 0.44 %),883,2190990,2481.3,1161,2273480,1958,-82490
2019-04-01,45.8 ( 0.66 %),421,693680,1647.7,582,694480,1193,-800
2019-03-29,45.5 ( 0.78 %),360,846740,2352.06,429,799250,1863,47490
2019-03-28,45.15 ( 0.33 %),411,563010,1369.85,369,568800,1541,-5790
2019-03-27,45 ( 0.56 %),404,833210,2062.4,343,826840,2411,6370
2019-03-26,44.75 ( 0.79 %),394,822090,2086.52,367,702320,1914,119770
2019-03-25,44.4 ( -1.44 %),694,1307610,1884.16,516,1135570,2201,172040
2019-03-22,45.05 ( -0.11 %),588,1093210,1859.2,484,1076060,2223,17150
2019-03-21,45.1 ( -0.77 %),596,1059240,1777.25,533,1345660,2525,-286420
2019-03-20,45.45 ( -0.55 %),643,1261140,1961.34,450,1320820,2935,-59680
2019-03-19,45.7 ( -1.08 %),661,1253520,1896.4,540,1528010,2830,-274490
2019-03-18,46.2 ( 0.43 %),735,1819790,2475.9,802,1657830,2067,161960
2019-03-15,46 ( -0.54 %),835,1522840,1823.76,698,1823840,2613,-301000
2019-03-14,46.25 ( 0.11 %),641,921140,1437.04,660,1023050,1550,-101910
2019-03-13,46.2 ( -0.65 %),1051,1723210,1639.59,1007,1989820,1976,-266610
2019-03-12,46.5 ( 4.49 %),1068,2864680,2682.28,964,2240740,2324,623940
2019-03-11,44.5 ( -0.34 %),411,697570,1697.25,359,651080,1814,46490
2019-03-08,44.65 ( -0.22 %),439,1155070,2631.14,451,1127060,2499,28010
2019-03-07,44.75 ( 0.34 %),376,690470,1836.36,450,872720,1939,-182250
2019-03-06,44.6 ( -0.67 %),546,1031970,1890.05,405,1001780,2474,30190
2019-03-05,44.9 ( -0.22 %),584,1243590,2129.43,658,1317590,2002,-74000
2019-03-04,45 ( 0.9 %),583,1507600,2585.93,640,1224480,1913,283120
2019-03-01,44.6 ( 0.9 %),549,1041400,1896.9,325,950740,2925,90660
2019-02-28,44.2 ( -2 %),778,1969760,2531.83,682,2423240,3553,-453480
2019-02-27,45.1 ( -0.22 %),520,762070,1465.52,468,959700,2051,-197630
2019-02-26,45.2 ( -0.66 %),750,1358740,1811.65,772,1552920,2012,-194180
2019-02-25,45.5 ( 0.66 %),732,1588220,2169.7,1076,2170270,2017,-582050
2019-02-22,45.2 ( 0.89 %),694,2137970,3080.65,961,2075150,2159,62820
2019-02-21,44.8 ( -0.11 %),582,1141210,1960.84,611,1325110,2169,-183900
2019-02-20,44.85 ( 1.01 %),511,1096480,2145.75,730,1282130,1756,-185650
2019-02-19,44.4 ( 0 %),809,2391120,2955.65,1066,2765330,2594,-374210
2019-02-18,44.4 ( 0.45 %),488,746150,1529,582,742160,1275,3990
2019-02-15,44.2 ( -0.11 %),611,1218430,1994.16,537,1041830,1940,176600
2019-02-14,44.25 ( -0.67 %),488,937630,1921.37,839,1458640,1739,-521010
2019-02-13,44.55 ( 1.48 %),684,1871780,2736.52,1051,1975740,1880,-103960
2019-02-12,43.9 ( -0.57 %),628,1136080,1809.04,774,1370590,1771,-234510
2019-02-11,44.15 ( 3.64 %),1125,1597450,1419.96,939,1429800,1523,167650
2019-02-01,42.6 ( -1.39 %),694,1188990,1713.24,252,745440,2958,443550
2019-01-31,43.2 ( 0 %),476,718490,1509.43,496,887470,1789,-168980
2019-01-30,43.2 ( 1.65 %),543,1132530,2085.69,752,959340,1276,173190
2019-01-29,42.5 ( 0.95 %),519,1175840,2265.59,310,629290,2030,546550
2019-01-28,42.1 ( -0.71 %),379,436010,1150.42,331,576250,1741,-140240
2019-01-25,42.4 ( -0.12 %),343,801870,2337.81,391,580120,1484,221750
2019-01-24,42.45 ( 0.24 %),285,392980,1378.88,402,486270,1210,-93290
2019-01-23,42.35 ( 0 %),472,664700,1408.26,288,413270,1435,251430
2019-01-22,42.35 ( -0.35 %),303,292740,966.14,349,512500,1468,-219760
2019-01-21,42.5 ( 1.19 %),255,411860,1615.14,408,533630,1308,-121770
2019-01-18,42 ( 0 %),355,419890,1182.79,316,588260,1862,-168370
2019-01-17,42 ( -1.29 %),323,509510,1577.43,405,679410,1678,-169900
2019-01-16,42.55 ( -0.58 %),351,381290,1086.3,524,567980,1084,-186690
2019-01-15,42.8 ( 0.71 %),416,769080,1848.75,588,749110,1274,19970
2019-01-14,42.5 ( 0.71 %),390,952430,2442.13,459,693700,1511,258730
2019-01-11,42.2 ( 0.12 %),480,1006010,2095.85,608,1022440,1682,-16430
2019-01-10,42.15 ( -0.59 %),368,482860,1312.12,402,523070,1301,-40210
2019-01-09,42.4 ( 0.95 %),448,700670,1564,616,694020,1127,6650
2019-01-08,42 ( 0.48 %),345,503260,1458.72,429,555050,1294,-51790
2019-01-07,41.8 ( 1.7 %),351,698960,1991.34,618,808400,1308,-109440
2019-01-04,41.1 ( 0.74 %),596,698300,1171.64,389,517940,1331,180360
2019-01-03,40.8 ( -0.97 %),979,1207120,1233.01,439,1077590,2455,129530
2019-01-02,41.2 ( -2.37 %),984,1113440,1131.54,378,833870,2206,279570
2018-12-28,42.2 ( 0.96 %),464,1032040,2224.22,490,707710,1444,324330
2018-12-27,41.8 ( 0.97 %),607,782830,1289.67,523,873550,1670,-90720
2018-12-26,41.4 ( -0.24 %),542,550440,1015.57,422,606300,1437,-55860
2018-12-25,41.5 ( -1.19 %),1182,1317010,1114.22,564,1027060,1821,289950
2018-12-24,42 ( -1.18 %),403,339020,841.24,332,407500,1227,-68480
2018-12-21,42.5 ( 1.07 %),698,1073110,1537.41,378,573600,1517,499510
2018-12-20,42.05 ( -0.12 %),707,878630,1242.76,340,642900,1891,235730
2018-12-19,42.1 ( 0.24 %),865,962160,1112.32,476,766320,1610,195840
2018-12-18,42 ( -2.33 %),1481,1828240,1234.46,568,1661930,2926,166310
2018-12-17,43 ( -2.6 %),1003,1162520,1159.04,395,1163650,2946,-1130
2018-12-14,44.15 ( -1.01 %),666,1213240,1821.68,478,1500900,3140,-287660
2018-12-13,44.6 ( 0.34 %),743,1349690,1816.54,782,1601400,2048,-251710
2018-12-12,44.45 ( 0.91 %),677,1098040,1621.92,450,1175330,2612,-77290
2018-12-11,44.05 ( -0.34 %),628,826430,1315.97,322,808130,2510,18300
2018-12-10,44.2 ( -2 %),890,1027660,1154.67,433,1431090,3305,-403430
2018-12-07,45.1 ( 1.58 %),677,1513270,2235.26,836,1339040,1602,174230
2018-12-06,44.4 ( -0.45 %),677,1007410,1488.05,549,981920,1789,25490
2018-12-05,44.6 ( -0.78 %),633,1257050,1985.86,668,1143280,1711,113770
2018-12-04,44.95 ( 0.11 %),779,1506310,1933.65,1148,1837630,1601,-331320
2018-12-03,44.9 ( 4.66 %),839,1851220,2206.46,1203,1575400,1310,275820
2018-11-30,42.9 ( 0 %),409,875090,2139.58,359,759910,2117,115180
2018-11-29,42.9 ( 0.23 %),424,1727190,4073.56,654,1370900,2096,356290
2018-11-28,42.8 ( 0.12 %),320,618040,1931.38,308,544070,1766,73970
2018-11-27,42.75 ( 0.71 %),530,987410,1863.04,354,708040,2000,279370
2018-11-26,42.45 ( -1.39 %),754,1170620,1552.55,332,806650,2430,363970
2018-11-23,43.05 ( -0.81 %),470,775130,1649.21,428,740830,1731,34300
2018-11-22,43.4 ( 0 %),431,920920,2136.71,540,759230,1406,161690
2018-11-21,43.4 ( 0 %),847,1387850,1638.55,473,788400,1667,599450
2018-11-20,43.4 ( 0.58 %),562,1960370,3488.2,673,1058250,1572,902120
2018-11-19,43.15 ( 0.94 %),428,1212520,2832.99,649,835420,1287,377100
2018-11-16,42.75 ( 1.3 %),519,2075140,3998.34,686,1082680,1578,992460
2018-11-15,42.2 ( -0.12 %),525,1416890,2698.84,562,904290,1609,512600
2018-11-14,42.25 ( 1.44 %),544,1644470,3022.92,753,1194750,1587,449720
2018-11-13,41.65 ( -0.72 %),536,1246010,2324.65,391,831030,2125,414980
2018-11-12,41.95 ( 1.7 %),502,749940,1493.9,481,505120,1050,244820
2018-11-09,41.25 ( -2.14 %),867,1024100,1181.2,381,1078230,2830,-54130
2018-11-08,42.15 ( 0.72 %),437,959260,2195.1,422,750210,1778,209050
2018-11-07,41.85 ( -0.71 %),729,723550,992.52,426,902170,2118,-178620
2018-11-06,42.15 ( -0.94 %),722,717190,993.34,369,819790,2222,-102600
2018-11-05,42.55 ( -0.82 %),561,1176770,2097.63,415,606180,1461,570590
2018-11-02,42.9 ( 2.39 %),630,2699490,4284.9,670,953230,1423,1746260
2018-11-01,41.9 ( -0.12 %),524,1222590,2333.19,628,966000,1538,256590
2018-10-31,41.95 ( 2.32 %),597,1230320,2060.84,436,597370,1370,632950
2018-10-30,41 ( 0 %),406,585100,1441.13,310,474350,1530,110750
2018-10-29,41 ( 0.49 %),635,1264920,1992,558,853300,1529,411620
2018-10-26,40.8 ( -0.61 %),794,1449890,1826.06,596,1394020,2339,55870
2018-10-25,41.05 ( -1.79 %),1343,2146310,1598.15,563,1245200,2212,901110
2018-10-24,41.8 ( -0.95 %),833,1218030,1462.22,426,1084080,2545,133950
2018-10-23,42.2 ( -2.2 %),1204,1868740,1552.11,577,1720910,2983,147830
2018-10-22,43.15 ( 0.35 %),580,834980,1439.62,453,768950,1697,66030
2018-10-19,43 ( -1.38 %),1114,3048340,2736.39,380,1309010,3445,1739330
2018-10-18,43.6 ( 0 %),664,1262580,1901.48,610,1280800,2100,-18220
2018-10-17,43.6 ( 0.81 %),501,884030,1764.53,586,1105670,1887,-221640
2018-10-16,43.25 ( 0.58 %),1037,1375150,1326.08,384,896010,2333,479140
2018-10-15,43 ( -1.83 %),767,934710,1218.66,414,871760,2106,62950
2018-10-12,43.8 ( 2.58 %),1530,2893590,1891.24,807,1778300,2204,1115290
2018-10-11,42.7 ( -5.74 %),1907,3278170,1719.02,898,3419600,3808,-141430
2018-10-10,45.3 ( 1.34 %),771,1161490,1506.47,495,1469730,2969,-308240
2018-10-09,44.7 ( -0.67 %),848,823780,971.44,394,1112440,2823,-288660
2018-10-08,45 ( -1.32 %),829,779930,940.81,487,1130620,2322,-350690
2018-10-05,45.6 ( -0.55 %),563,912050,1619.98,554,1218160,2199,-306110
2018-10-04,45.85 ( 0.77 %),510,951550,1865.78,540,1339160,2480,-387610
2018-10-03,45.5 ( 0.44 %),636,735430,1156.34,368,999440,2716,-264010
2018-10-02,45.3 ( -1.52 %),872,1196390,1372.01,666,1976160,2967,-779770
2018-10-01,46 ( -0.65 %),580,753390,1298.95,639,1451700,2272,-698310
2018-09-28,46.3 ( 0.22 %),490,914740,1866.82,788,1387680,1761,-472940
2018-09-27,46.2 ( 0.33 %),479,1138840,2377.54,819,1854100,2264,-715260
2018-09-26,46.05 ( 0.33 %),838,1882830,2246.81,998,1796460,1800,86370
2018-09-25,45.9 ( -0.43 %),541,1045190,1931.96,760,1492930,1964,-447740
2018-09-24,46.1 ( 0.44 %),767,1754060,2286.91,945,1775550,1879,-21490
2018-09-21,45.9 ( 0 %),1199,2396690,1998.91,1119,2243970,2005,152720
2018-09-20,45.9 ( 0.99 %),933,2253160,2414.96,1293,2116890,1637,136270
2018-09-19,45.45 ( 1.45 %),950,2368230,2492.87,1378,2097030,1522,271200
2018-09-18,44.8 ( 1.59 %),821,1587330,1933.41,824,1188400,1442,398930
2018-09-17,44.1 ( -1.01 %),854,1053500,1233.61,645,1126740,1747,-73240
2018-09-14,44.55 ( 2.65 %),1437,4100180,2853.29,1758,4525180,2574,-425000
2018-09-13,43.4 ( 0.81 %),709,1134940,1600.76,927,1644110,1774,-509170
2018-09-12,43.05 ( -0.23 %),678,817230,1205.35,692,1242450,1795,-425220
2018-09-11,43.15 ( 1.41 %),809,1491190,1843.25,545,987790,1812,503400
2018-09-10,42.55 ( -1.05 %),772,602260,780.13,373,793970,2129,-191710
2018-09-07,43 ( 1.53 %),802,892070,1112.31,466,952110,2043,-60040
2018-09-06,42.35 ( -2.19 %),1407,1660720,1180.33,747,1841770,2466,-181050
2018-09-05,43.3 ( -1.81 %),930,1202360,1292.86,607,1639910,2702,-437550
2018-09-04,44.1 ( -0.23 %),715,1042210,1457.64,770,1330210,1728,-288000
2018-08-31,44.2 ( 0.11 %),1148,1779540,1550.12,1124,1944150,1730,-164610
2018-08-30,44.15 ( -0.11 %),742,1229320,1656.77,479,1047940,2188,181380
2018-08-29,44.2 ( 0 %),760,1269500,1670.39,641,1375450,2146,-105950
2018-08-28,44.2 ( -0.45 %),766,1490350,1945.63,799,1744830,2184,-254480
2018-08-27,44.4 ( -0.11 %),766,1329190,1735.23,746,1541270,2066,-212080
2018-08-24,44.45 ( 0.11 %),707,980670,1387.09,761,1230820,1617,-250150
2018-08-23,44.4 ( 0.79 %),730,1781090,2439.85,948,1906320,2011,-125230
2018-08-22,44.05 ( 0.8 %),812,1758190,2165.26,1228,2077150,1691,-318960
2018-08-21,43.7 ( 0 %),756,1102010,1457.69,758,1535670,2026,-433660
2018-08-20,43.7 ( 0.46 %),650,1432390,2203.68,950,1665640,1753,-233250
2018-08-17,43.5 ( 1.16 %),733,1694230,2311.36,794,1825590,2299,-131360
2018-08-16,43 ( 0.46 %),1414,2172010,1536.07,731,2388600,3268,-216590
2018-08-15,43.8 ( -1.13 %),1310,2351120,1794.75,1513,3265200,2158,-914080
2018-08-14,44.3 ( 1.96 %),1253,2517790,2009.41,1513,2824010,1866,-306220
2018-08-13,43.45 ( 0.81 %),1030,1514600,1470.49,1130,1906860,1687,-392260
2018-08-10,43.1 ( 0.7 %),969,1565590,1615.68,1161,1683750,1450,-118160
2018-08-09,42.8 ( 0.71 %),1055,2036460,1930.29,1281,2325580,1815,-289120
2018-08-08,42.5 ( 1.31 %),1001,1495890,1494.4,664,1202170,1810,293720
2018-08-07,41.95 ( -0.71 %),1211,1066770,880.9,528,1118930,2119,-52160
2018-08-06,42.25 ( -0.82 %),732,604030,825.18,517,819660,1585,-215630
2018-08-03,42.6 ( -0.23 %),816,1134530,1390.36,817,1599120,1957,-464590
2018-08-02,42.7 ( 1.67 %),1275,1513760,1187.26,555,1108300,1997,405460
2018-08-01,42 ( -1.87 %),2310,3322080,1438.13,789,3499120,4435,-177040
2018-07-31,42.8 ( -1.15 %),1449,2217430,1530.32,865,2595320,3000,-377890
2018-07-30,43.3 ( 0 %),979,1895140,1935.79,783,1740450,2223,154690
2018-07-27,43.3 ( 1.76 %),923,2615910,2834.14,1511,2415400,1599,200510
2018-07-26,42.55 ( 0.35 %),846,2587590,3058.62,910,1521040,1671,1066550
2018-07-25,42.4 ( 0.47 %),1189,2596450,2183.73,1519,2085910,1373,510540
2018-07-24,42.2 ( 0.48 %),1122,2584930,2303.86,1058,1769730,1673,815200
2018-07-23,42 ( 0.96 %),911,1886540,2070.85,962,2050230,2131,-163690
2018-07-20,41.6 ( -2.12 %),1342,1479060,1102.13,623,1183610,1900,295450
2018-07-19,42.5 ( -0.93 %),870,1190870,1368.82,808,1210860,1499,-19990
2018-07-18,42.9 ( 2.39 %),962,1751900,1821.1,922,1654290,1794,97610
2018-07-17,41.9 ( 2.44 %),982,2189660,2229.8,957,1628420,1702,561240
2018-07-16,40.9 ( 0.74 %),832,1129230,1357.25,841,1470050,1748,-340820
2018-07-13,40.6 ( 4.64 %),874,1781320,2038.12,1199,1663540,1387,117780
2018-07-12,38.8 ( -1.02 %),1095,1484900,1356.07,563,1188960,2112,295940
2018-07-11,39.2 ( -2.97 %),974,1346270,1382.21,584,1314690,2251,31580
2018-07-10,40.4 ( 0.62 %),494,504410,1021.07,490,595000,1214,-90590
2018-07-09,40.15 ( -1.59 %),702,835220,1189.77,659,1134440,1721,-299220
2018-07-06,40.8 ( 3.29 %),977,1735570,1776.43,990,1663930,1681,71640
2018-07-05,39.5 ( -1.25 %),937,1445850,1543.06,758,1319820,1741,126030
2018-07-04,40 ( 2.56 %),1215,1912300,1573.91,805,1593900,1980,318400
2018-07-03,39 ( -2.99 %),1297,1912210,1474.33,1088,2144810,1971,-232600
2018-07-02,40.2 ( -3.13 %),1337,1598060,1195.26,861,1639860,1905,-41800
2018-06-29,41.5 ( -2.35 %),1186,1215320,1024.72,637,1324130,2079,-108810
2018-06-28,42.5 ( -4.06 %),1637,1681800,1027.37,681,1874420,2752,-192620
2018-06-27,44.3 ( -0.45 %),683,541650,793.05,454,681810,1502,-140160
2018-06-26,44.5 ( -1.33 %),728,594100,816.07,458,578140,1262,15960
2018-06-25,45.1 ( 0.22 %),640,1106340,1728.66,641,971930,1516,134410
2018-06-22,45 ( 1.35 %),934,1037000,1110.28,491,651890,1328,385110
2018-06-21,44.4 ( -2.2 %),801,727050,907.68,560,910580,1626,-183530
2018-06-20,45.4 ( 2.02 %),910,1246360,1369.63,684,1260310,1843,-13950
2018-06-19,44.5 ( -1.98 %),2060,2850250,1383.62,1200,3201930,2668,-351680
2018-06-18,45.4 ( -2.37 %),1114,1433690,1286.97,669,1398060,2090,35630
2018-06-15,46.5 ( -0.21 %),840,944370,1124.25,491,806420,1642,137950
2018-06-14,46.6 ( -0.43 %),797,1093170,1371.61,645,941940,1460,151230
2018-06-13,46.8 ( 1.08 %),1080,1101030,1019.47,632,988020,1563,113010
2018-06-12,46.3 ( -2.53 %),1743,2072640,1189.12,1120,2067680,1846,4960
2018-06-11,47.5 ( -0.94 %),1140,1307100,1146.58,651,1236830,1900,70270
2018-06-08,47.95 ( 0.31 %),1263,2230000,1765.64,927,1679150,1811,550850
2018-06-07,47.8 ( -1.44 %),1614,1777290,1101.17,944,2151610,2279,-374320
2018-06-06,48.5 ( 1.46 %),1382,1972870,1427.55,949,1668520,1758,304350
2018-06-05,47.8 ( 1.16 %),1561,2436810,1561.06,1020,2269980,2225,166830
2018-06-04,47.25 ( 1.72 %),1504,2212510,1471.08,973,1881990,1934,330520
2018-06-01,46.45 ( 0.98 %),1765,2878580,1630.92,1017,2103360,2068,775220
2018-05-31,46 ( 1.21 %),1442,2228720,1545.58,933,1766670,1894,462050
2018-05-30,45.45 ( -4.11 %),2091,2584080,1235.81,869,3203430,3686,-619350
2018-05-29,47.4 ( 4.18 %),2441,4619760,1892.57,1302,3636410,2793,983350
2018-05-28,45.5 ( -6.95 %),1740,2623560,1507.79,1053,4383060,4162,-1759500
2018-05-25,48.9 ( -3.04 %),1573,1491980,948.49,691,1526750,2209,-34770
2018-05-24,59.5 ( -1.82 %),1175,1718930,1462.92,1025,2589200,2526,-870270
2018-05-23,60.6 ( 1.51 %),1033,2179080,2109.47,994,1992500,2005,186580
2018-05-22,59.7 ( -2.13 %),1318,2180070,1654.07,1137,2260820,1988,-80750
2018-05-21,61 ( 0.33 %),1090,2115310,1940.65,1720,3005930,1748,-890620
2018-05-18,60.8 ( 0.33 %),1412,1567230,1109.94,757,1805840,2386,-238610
2018-05-17,60.6 ( 0.17 %),957,1681770,1757.34,838,1585530,1892,96240
2018-05-16,60.5 ( -1.47 %),1026,1411980,1376.2,712,1375390,1932,36590
2018-05-15,61.4 ( -0.32 %),1212,1763920,1455.38,1288,2478280,1924,-714360
2018-05-11,59.5 ( 2.06 %),713,3404120,4774.36,972,1735470,1785,1668650
2018-05-10,58.3 ( -0.17 %),899,2619460,2913.75,1017,2294120,2256,325340
2018-05-09,58.4 ( -1.02 %),997,1622210,1627.09,746,2168150,2906,-545940
2018-05-08,0 ( 0 %),1303,1891740,1451.83,856,2526870,2952,-635130
2018-05-07,59.6 ( 1.36 %),1116,1332020,1193.57,640,1505200,2352,-173180
2018-05-04,58.8 ( 1.38 %),1204,2233860,1855.37,940,2176710,2316,57150
2018-05-03,58 ( 1.75 %),1529,5283990,3455.85,1171,3702160,3162,1581830
2018-05-02,57 ( 0 %),929,2290170,2465.2,916,2054870,2243,235300
2018-04-27,57 ( 3.64 %),1631,3328040,2040.49,1083,3002650,2773,325390
2018-04-26,55 ( -2.48 %),1736,3265300,1880.93,1119,3647600,3260,-382300
2018-04-24,56.4 ( -2.76 %),1721,2770660,1609.91,955,2969210,3109,-198550
2018-04-23,58 ( -5.38 %),1596,2329050,1459.3,982,2610830,2659,-281780
2018-04-20,61.3 ( 0.99 %),1200,2030430,1692.02,822,1827130,2223,203300
2018-04-19,60.7 ( -2.1 %),1558,3919350,2515.63,1176,3635410,3091,283940
2018-04-18,62 ( 0 %),892,2118330,2374.81,1038,2664040,2567,-545710
2018-04-17,62 ( 1.47 %),1220,2807700,2301.39,862,2123700,2464,684000
2018-04-16,61.1 ( -1.45 %),1429,2803580,1961.92,879,2251400,2561,552180
2018-04-13,62 ( -2.52 %),1939,3683910,1899.9,1215,3886990,3199,-203080
2018-04-12,63.6 ( 0.95 %),1522,2721130,1787.86,1267,2646210,2089,74920
2018-04-11,63 ( -2.17 %),2463,5836970,2369.86,2326,6256830,2690,-419860
2018-04-10,64.4 ( 1.58 %),2914,7462750,2561,2900,8256970,2847,-794220
2018-04-09,63.4 ( 1.12 %),1451,3359080,2315.01,1704,3423470,2009,-64390
2018-04-06,62.7 ( -0.48 %),2661,5522970,2075.52,2738,7826780,2859,-2303810
2018-04-05,63 ( 2.11 %),1698,5382660,3170,2973,5521530,1857,-138870
2018-04-04,61.7 ( 0.82 %),1281,3968800,3098.2,2652,5165130,1948,-1196330
2018-04-03,61.2 ( -0.49 %),940,1722180,1832.11,1216,2085290,1715,-363110
2018-04-02,61.5 ( 1.32 %),1307,3382980,2588.36,1762,3699510,2100,-316530
2018-03-30,60.7 ( 2.02 %),1182,4129420,3493.59,2146,4411560,2056,-282140
2018-03-29,59.5 ( 1.02 %),705,1848720,2622.3,917,1720140,1876,128580
2018-03-28,58.9 ( -1.01 %),1101,1183660,1075.08,745,1394640,1872,-210980
2018-03-27,59.5 ( 0.51 %),851,1509640,1773.96,896,2398800,2677,-889160
2018-03-26,59.2 ( 1.02 %),1180,1774680,1503.97,876,1858700,2122,-84020
2018-03-23,58.6 ( -2.5 %),3146,5518410,1754.1,1309,4853880,3708,664530
2018-03-22,60.1 ( -1.48 %),1403,2141850,1526.62,976,2572900,2636,-431050
2018-03-21,61 ( -0.49 %),1047,1603490,1531.51,1448,3029280,2092,-1425790
2018-03-20,61.3 ( 1.32 %),1891,4329350,2289.45,2322,5476980,2359,-1147630
2018-03-19,60.5 ( 0.67 %),1310,2147170,1639.06,1152,2507520,2177,-360350
2018-03-16,60.1 ( -0.83 %),1728,2393130,1384.91,1083,2639440,2437,-246310
2018-03-15,60.6 ( -0.33 %),1104,2181250,1975.77,966,2350340,2433,-169090
2018-03-14,60.8 ( 1.16 %),2169,3945840,1819.2,1373,3561560,2594,384280
2018-03-13,60.1 ( -2.12 %),3668,6243860,1702.25,1796,7011440,3904,-767580
2018-03-12,61.4 ( -0.32 %),1222,2318010,1896.9,1375,4049580,2945,-1731570
2018-03-09,61.6 ( -0.96 %),1489,3443210,2312.43,1444,4202900,2911,-759690
2018-03-08,62.2 ( 0 %),1200,2514420,2095.35,983,2681100,2727,-166680
2018-03-07,62.2 ( -1.74 %),1730,3417160,1975.24,1624,5359370,3300,-1942210
2018-03-06,63.3 ( 2.93 %),1804,4588630,2543.59,2029,5235150,2580,-646520
2018-03-05,61.5 ( 0.65 %),2937,9377850,3193,3905,10131490,2594,-753640
2018-03-02,61.1 ( 0.49 %),1486,3303360,2222.99,1591,3378260,2123,-74900
2018-03-01,60.8 ( 1.67 %),1946,3901090,2004.67,1810,3859160,2132,41930
2018-02-28,59.8 ( 0 %),1869,3240980,1734.07,1235,3759670,3044,-518690
2018-02-27,59.8 ( -0.99 %),1799,2515150,1398.08,1282,3232440,2521,-717290
2018-02-26,60.4 ( -0.17 %),1677,3468780,2068.44,2131,4927030,2312,-1458250
2018-02-23,60.5 ( 3.6 %),1166,2861910,2454.47,1534,2827240,1843,34670
2018-02-22,58.4 ( -1.68 %),1555,2266110,1457.31,1011,2985080,2953,-718970
2018-02-21,59.4 ( 0.68 %),1403,2204460,1571.25,1131,3129300,2767,-924840
2018-02-13,59 ( 3.33 %),1288,2334430,1812.45,1141,2810140,2463,-475710
2018-02-12,57.1 ( 3.82 %),1228,2216890,1805.29,771,2019760,2620,197130
2018-02-09,55 ( -0.36 %),2314,5399990,2333.62,1052,4097300,3895,1302690
2018-02-08,55.2 ( -2.47 %),1735,2797160,1612.2,1157,4046390,3497,-1249230
2018-02-07,56.6 ( 4.43 %),2219,3473710,1565.44,1051,3216880,3061,256830
2018-02-06,54.2 ( -5.08 %),3133,8058160,2572.03,2297,9383570,4085,-1325410
2018-02-05,57.1 ( -6.39 %),2438,6022480,2470.25,1611,5808380,3605,214100
2018-02-02,61 ( -0.97 %),1715,2603070,1517.83,1042,3180150,3052,-577080
2018-02-01,61.6 ( -2.07 %),1719,3000200,1745.32,1559,4655380,2986,-1655180
2018-01-31,62.9 ( -1.72 %),3097,5641090,1821.47,3129,8535750,2728,-2894660
2018-01-30,64 ( 6.14 %),2505,8119150,3241.18,1698,5644920,3324,2474230
2018-01-29,60.3 ( -0.82 %),1421,2148750,1512.14,1383,3193840,2309,-1045090
2018-01-26,60.8 ( -0.49 %),1456,2387340,1639.66,1499,3991110,2663,-1603770
2018-01-25,61.1 ( 0.33 %),2298,8724390,3796.51,2486,8011560,3223,712830
2018-01-22,60.9 ( 3.4 %),1452,3984920,2744.44,1848,4216320,2282,-231400
2018-01-19,58.9 ( -0.17 %),1386,3023270,2181.29,1089,3187300,2927,-164030
2018-01-18,59 ( 0 %),2406,6203050,2578.16,1852,6067170,3276,135880
2018-01-17,59 ( -3.28 %),2029,3156810,1555.85,1416,4200880,2967,-1044070
2018-01-16,61 ( 0 %),1416,2467830,1742.82,1433,3399260,2372,-931430
2018-01-15,61 ( 1.33 %),1833,3903890,2129.78,1473,3692730,2507,211160
2018-01-12,60.2 ( -2.11 %),2437,4017840,1648.68,1749,5381500,3077,-1363660
2018-01-11,61.5 ( 0 %),2209,4422510,2002.04,1463,4069680,2782,352830
2018-01-10,61.5 ( -0.97 %),2368,4372280,1846.4,1795,4814700,2682,-442420
2018-01-09,62.1 ( 1.97 %),2488,6602320,2653.67,2127,6285770,2955,316550
2018-01-08,60.9 ( 1.5 %),2104,4564270,2169.33,1413,3812050,2698,752220
2018-01-05,60 ( -1.64 %),2228,4580350,2055.81,1843,5225970,2836,-645620
2018-01-04,61 ( 2.01 %),1854,4680340,2524.46,2010,4235580,2107,444760
2018-01-03,59.8 ( 0 %),1833,4003610,2184.18,2422,6077590,2509,-2073980
2018-01-02,59.8 ( 4.73 %),2493,7324120,2937.87,3152,7861380,2494,-537260
2017-12-29,57.1 ( -0.17 %),998,2368080,2372.83,1364,3360780,2464,-992700
2017-12-28,57.2 ( 0.88 %),1408,3620730,2571.54,1285,3290400,2561,330330
2017-12-27,56.7 ( -0.7 %),1522,2767470,1818.31,1322,3670110,2776,-902640
2017-12-26,57.1 ( -0.87 %),1338,2324270,1737.12,1217,2949150,2423,-624880
2017-12-25,57.6 ( 0.88 %),1510,3494510,2314.25,1732,4490370,2593,-995860
2017-12-22,57.1 ( 1.24 %),1109,2776520,2503.62,1379,2917400,2116,-140880
2017-12-21,56.4 ( 0.18 %),1450,3187070,2197.98,1507,3953450,2623,-766380
2017-12-20,56.3 ( 1.99 %),1793,3679300,2052.04,1503,3397600,2261,281700
2017-12-19,55.2 ( -1.95 %),2236,3425670,1532.05,1493,4414870,2957,-989200
2017-12-18,56.3 ( -0.35 %),1416,2818810,1990.69,1436,3453530,2405,-634720
2017-12-15,56.5 ( 1.07 %),1483,2854730,1924.97,1418,2998450,2115,-143720
2017-12-14,55.9 ( 2.19 %),1167,2362680,2024.58,1046,2239110,2141,123570
2017-12-13,54.7 ( 1.86 %),1288,2735680,2123.98,1160,2991450,2579,-255770
2017-12-12,53.7 ( 0.37 %),2399,5551450,2314.07,1840,4938610,2684,612840
2017-12-11,53.5 ( -3.6 %),2123,3821120,1799.87,1355,4350440,3211,-529320
2017-12-08,55.5 ( -1.07 %),2265,3543030,1564.25,1263,3745530,2966,-202500
2017-12-07,56.1 ( -1.23 %),1930,2941470,1524.08,1173,3093240,2637,-151770
2017-12-06,56.8 ( -0.87 %),3243,6462410,1992.73,1651,5454310,3304,1008100
2017-12-05,57.3 ( -2.55 %),2233,4787540,2143.99,1901,6156640,3239,-1369100
2017-12-04,58.8 ( 0.68 %),1480,3431570,2318.63,1502,3842580,2558,-411010
2017-12-01,58.4 ( 0 %),2046,3630910,1774.64,1315,3217240,2447,413670
2017-11-30,58.4 ( -1.52 %),2330,4206110,1805.2,2053,5882990,2866,-1676880
2017-11-29,59.3 ( 3.13 %),2271,6567920,2892.08,2627,6613120,2517,-45200
2017-11-28,57.5 ( -1.2 %),2140,3553570,1660.55,1438,4319280,3004,-765710
2017-11-27,58.2 ( 0.52 %),1647,3755830,2280.41,1907,5067240,2657,-1311410
2017-11-24,57.9 ( 0.52 %),1975,4093450,2072.63,1435,3934890,2742,158560
2017-11-23,57.6 ( -0.69 %),2613,4940970,1890.92,2197,6105260,2779,-1164290
2017-11-22,58 ( 1.4 %),2281,4910160,2152.63,1597,3962340,2481,947820
2017-11-21,57.2 ( -1.21 %),3180,5295370,1665.21,2064,5526240,2677,-230870
2017-11-20,57.9 ( 2.12 %),3005,7114460,2367.54,1920,5871300,3058,1243160
2017-11-17,56.7 ( -0.53 %),3633,6528760,1797.07,2214,7298040,3296,-769280
2017-11-16,57 ( 0.18 %),3290,5741800,1745.23,2423,7044180,2907,-1302380
2017-11-15,56.9 ( 5.57 %),2725,8268840,3034.44,2235,5988280,2679,2280560
2017-11-14,53.9 ( -0.19 %),2942,6709760,2280.68,2043,7710170,3774,-1000410
2017-11-13,54 ( 3.45 %),3036,7433960,2448.6,2186,6786360,3104,647600
2017-11-10,52.2 ( -0.76 %),1175,2034480,1731.47,1025,3030810,2957,-996330
2017-11-09,52.6 ( -0.75 %),1572,3065880,1950.31,1287,3474750,2700,-408870
2017-11-08,53 ( 3.52 %),1885,5242370,2781.1,1837,4505470,2453,736900
2017-11-07,51.2 ( -0.39 %),803,1848820,2302.39,908,2387110,2629,-538290
2017-11-06,51.4 ( 0.78 %),874,2240450,2563.44,1199,3090130,2577,-849680
2017-11-03,51 ( 0.99 %),1002,1997070,1993.08,836,1964360,2350,32710
2017-11-02,50.5 ( -0.59 %),797,1899610,2383.45,1285,2884020,2244,-984410
2017-11-01,50.8 ( 0.79 %),549,1753760,3194.46,901,2279610,2530,-525850
2017-10-31,50.4 ( 0.8 %),954,2912980,3053.44,1279,3024910,2365,-111930
2017-10-30,50 ( -0.4 %),1062,2427010,2285.32,961,2635090,2742,-208080
2017-10-27,50.2 ( 1.21 %),732,1227040,1676.28,466,1157080,2483,69960
2017-10-26,49.6 ( -0.2 %),922,1560500,1692.52,583,2027590,3478,-467090
2017-10-25,49.7 ( 0.81 %),842,1497630,1778.66,447,1141740,2554,355890
2017-10-24,49.3 ( 0 %),925,1310990,1417.29,573,1516850,2647,-205860
2017-10-23,49.3 ( -1.99 %),939,1774930,1890.23,697,1851580,2656,-76650
2017-10-20,50.3 ( -0.59 %),817,1715330,2099.55,492,1378050,2801,337280
2017-10-19,50.6 ( 0.2 %),1012,2056700,2032.31,760,1972770,2596,83930
2017-10-18,50.5 ( -1.94 %),1014,1881910,1855.93,914,2364880,2587,-482970
2017-10-17,51.5 ( 0.19 %),772,1526730,1977.63,788,1773720,2251,-246990
2017-10-16,51.4 ( 0.39 %),970,2132770,2198.73,1157,2467330,2133,-334560
2017-10-13,51.2 ( 0.39 %),948,1683980,1776.35,965,1916330,1986,-232350
2017-10-12,51 ( 2.2 %),1146,3544600,3093.02,1590,3967740,2495,-423140
2017-10-11,49.9 ( 1.22 %),1566,3621080,2312.31,2026,4018800,1984,-397720
2017-10-10,49.3 ( 1.02 %),623,1692180,2716.18,804,1816530,2259,-124350
2017-10-09,48.8 ( 0.1 %),435,919580,2113.98,522,1120390,2146,-200810
2017-10-06,48.75 ( 0.93 %),414,997210,2408.72,619,1197460,1935,-200250
2017-10-05,48.3 ( 0.52 %),710,1224820,1725.1,595,1212200,2037,12620
2017-10-04,48.05 ( 0.42 %),650,928280,1428.12,382,989040,2589,-60760
2017-10-03,47.85 ( -0.73 %),965,1586700,1644.25,564,1749290,3102,-162590
2017-10-02,48.2 ( -1.13 %),737,1312950,1781.48,498,1583190,3179,-270240
2017-09-29,48.75 ( -0.41 %),487,1063760,2184.31,409,913120,2233,150640
2017-09-28,48.95 ( -0.1 %),556,1126700,2026.44,618,1449960,2346,-323260
2017-09-27,49 ( 0 %),651,1313020,2016.93,708,1709290,2414,-396270
2017-09-26,49 ( 0.31 %),862,1494250,1733.47,477,1350290,2831,143960
2017-09-25,48.85 ( -1.21 %),676,1061910,1570.87,544,1400560,2575,-338650
2017-09-22,49.45 ( 0.1 %),1146,1918260,1673.87,1161,2644180,2278,-725920
2017-09-21,49.4 ( 1.54 %),1503,3718720,2474.2,1401,3784330,2701,-65610
2017-09-20,48.65 ( 0.52 %),600,1010230,1683.72,537,1236410,2302,-226180
2017-09-19,48.4 ( 0.1 %),700,1316060,1880.09,733,1635000,2231,-318940
2017-09-18,48.35 ( 0.31 %),760,1368700,1800.92,566,1452540,2566,-83840
2017-09-15,48.2 ( -0.31 %),841,1338110,1591.09,409,1477310,3612,-139200
2017-09-14,48.35 ( -0.82 %),845,1244240,1472.47,689,1784750,2590,-540510
2017-09-13,48.75 ( 1.35 %),1476,2698080,1827.97,1088,3198930,2940,-500850
2017-09-12,48.1 ( 1.58 %),692,1388300,2006.21,475,1364370,2872,23930
2017-09-11,47.35 ( -0.73 %),749,1246150,1663.75,442,1299970,2941,-53820
2017-09-08,47.7 ( -0.42 %),531,851820,1604.18,326,1034600,3174,-182780
2017-09-07,47.9 ( -0.62 %),461,747650,1621.8,350,923550,2639,-175900
2017-09-06,48.2 ( -0.62 %),686,816750,1190.6,409,1040380,2544,-223630
2017-09-05,48.5 ( -0.21 %),448,711350,1587.83,354,983170,2777,-271820
2017-09-01,48.6 ( 0.21 %),393,589460,1499.9,416,805760,1937,-216300
2017-08-31,48.5 ( 1.46 %),907,1935770,2134.26,756,1987630,2629,-51860
2017-08-30,47.8 ( 0.1 %),333,495630,1488.38,310,853860,2754,-358230
2017-08-29,47.75 ( 0.32 %),661,1268170,1918.56,413,1524960,3692,-256790
2017-08-28,47.6 ( 0.21 %),478,1025100,2144.56,307,1044860,3403,-19760
2017-08-25,47.5 ( -0.42 %),375,607710,1620.56,312,904100,2898,-296390
2017-08-24,47.7 ( 1.06 %),447,856090,1915.19,383,904730,2362,-48640
2017-08-23,47.2 ( 0.21 %),508,999290,1967.11,322,1018980,3165,-19690
2017-08-22,47.1 ( -1.36 %),547,628450,1148.9,328,979190,2985,-350740
2017-08-21,47.75 ( 0.53 %),491,619270,1261.24,293,911400,3111,-292130
2017-08-18,47.5 ( 0.21 %),617,843630,1367.31,264,675550,2559,168080
2017-08-17,47.4 ( -0.42 %),811,1043020,1286.09,432,1409110,3262,-366090
2017-08-16,48.6 ( -0.61 %),914,1208800,1322.54,351,1737340,4950,-528540
2017-08-15,48.9 ( -0.61 %),790,1313500,1662.66,497,1561340,3142,-247840
2017-08-14,49.2 ( -0.51 %),693,1021750,1474.39,637,2058000,3231,-1036250
2017-08-11,49.45 ( 1.12 %),533,990170,1857.73,413,1025900,2484,-35730
2017-08-10,48.9 ( 1.03 %),799,1782620,2231.06,426,1273110,2989,509510
2017-08-09,48.4 ( -1.12 %),1314,2997740,2281.39,634,2279840,3596,717900
2017-08-08,48.95 ( -1.81 %),1086,1854550,1707.69,649,2044140,3150,-189590
2017-08-07,49.85 ( -0.5 %),675,1113690,1649.91,592,1195240,2019,-81550
2017-08-04,50.1 ( 0 %),739,1491630,2018.44,624,1330980,2133,160650
2017-08-03,50.1 ( 1.42 %),1453,2939990,2023.39,1150,3338460,2903,-398470
2017-08-02,49.4 ( 0.82 %),1164,3095320,2659.21,1315,3561780,2709,-466460
2017-08-01,49 ( 1.34 %),770,2185030,2837.7,1178,3003800,2550,-818770
2017-07-31,48.35 ( -0.41 %),440,958370,2178.11,524,1297400,2476,-339030
2017-07-28,48.55 ( 0.73 %),561,2211490,3942.05,942,2967080,3150,-755590
2017-07-27,48.2 ( 0.84 %),664,1850190,2786.43,1069,2121870,1985,-271680
2017-07-26,47.8 ( 2.36 %),0,0,0,0,0,0,0
2017-07-25,46.7 ( 0.43 %),661,1105800,1672.92,356,991380,2785,114420
2017-07-24,46.5 ( 0.65 %),452,923230,2042.54,421,913000,2169,10230
2017-07-21,46.2 ( -1.28 %),425,1004650,2363.88,360,1162490,3229,-157840
2017-07-20,46.8 ( -0.21 %),832,2063680,2480.38,472,1349400,2859,714280
2017-07-19,46.9 ( -1.88 %),516,1310990,2540.68,526,1889060,3591,-578070
2017-07-18,47.8 ( -0.42 %),481,1452200,3019.13,560,1551830,2771,-99630
2017-07-17,48 ( -1.44 %),475,1318720,2776.25,614,1513560,2465,-194840
2017-07-14,48.7 ( -0.31 %),393,930160,2366.82,721,1319540,1830,-389380
2017-07-13,48.85 ( 1.88 %),403,1513400,3755.33,914,1605150,1756,-91750
2017-07-12,47.95 ( 0.74 %),682,1660050,2434.09,645,1163790,1804,496260
2017-07-11,47.6 ( -1.24 %),783,1557360,1988.97,790,1759300,2227,-201940
2017-07-10,48.2 ( -0.82 %),843,2496630,2961.6,1476,2732410,1851,-235780
2017-07-07,48.6 ( 1.46 %),943,3549240,3763.78,1862,3712990,1994,-163750
2017-07-06,47.9 ( 2.57 %),593,2735780,4613.46,1055,2738740,2596,-2960
2017-07-05,46.7 ( 0.21 %),348,889260,2555.34,430,1065420,2478,-176160
2017-07-04,46.6 ( 0.43 %),413,1465380,3548.14,548,1426070,2602,39310
2017-07-03,46.4 ( -0.96 %),553,1093510,1977.41,454,1126630,2482,-33120
2017-06-30,46.85 ( 0.75 %),737,1731950,2350,519,1781780,3433,-49830
2017-06-29,46.5 ( 0.32 %),521,1214680,2331.44,488,1265380,2593,-50700
2017-06-28,46.35 ( 1.42 %),707,1583670,2239.99,509,1468370,2885,115300
2017-06-27,45.7 ( -2.14 %),2020,3497760,1731.56,875,4085910,4670,-588150
2017-06-26,46.7 ( -1.58 %),1086,1952020,1797.44,637,2068630,3247,-116610
2017-06-23,47.45 ( -0.32 %),713,1290730,1810.28,477,1472110,3086,-181380
2017-06-22,47.6 ( 0.21 %),963,1898280,1971.21,761,2116230,2781,-217950
2017-06-21,47.5 ( 2.93 %),913,4087760,4477.28,873,2463250,2822,1624510
2017-06-20,46.15 ( -0.32 %),685,1844720,2693.02,542,1341890,2476,502830
2017-06-19,46.3 ( 1.31 %),804,2006060,2495.1,605,1706460,2821,299600
2017-06-16,45.7 ( 0.66 %),483,2410190,4990.04,597,1157900,1940,1252290
2017-06-15,45.4 ( 0.44 %),575,1415640,2461.98,475,1071330,2255,344310
2017-06-14,45.2 ( -0.33 %),946,1521920,1608.79,536,1680240,3135,-158320
2017-06-13,45.35 ( 1.45 %),863,2683890,3109.95,934,3049990,3266,-366100
2017-06-12,44.7 ( -1 %),648,1202800,1856.17,478,1055990,2209,146810
2017-06-09,45.15 ( 2.15 %),895,3182970,3556.39,869,2517380,2897,665590
2017-06-08,44.2 ( 0.34 %),784,1384870,1766.42,520,1210800,2328,174070
2017-06-07,44.05 ( -0.56 %),746,1360980,1824.37,764,1798530,2354,-437550
2017-06-06,44.3 ( 2.43 %),881,2812810,3192.75,1133,2441040,2154,371770
2017-06-05,43.25 ( 0 %),434,2626750,6052.42,574,1157350,2016,1469400
2017-06-02,43.25 ( -0.46 %),647,1785100,2759.04,607,1540640,2538,244460
2017-06-01,43.45 ( 1.05 %),479,1551980,3240.04,568,1315810,2317,236170
2017-05-31,43 ( 0 %),723,2420270,3347.54,810,1850650,2285,569620
2017-05-30,43 ( 0.94 %),1076,4808170,4468.56,947,2616840,2763,2191330
2017-05-29,42.6 ( 1.19 %),611,3235820,5295.94,498,1051910,2112,2183910
2017-05-26,42.1 ( -1.17 %),1026,1792430,1747.01,510,1407720,2760,384710
2017-05-25,42.6 ( 1.84 %),1515,3590000,2369.64,698,2508120,3593,1081880
2017-05-24,49.1 ( 0.51 %),774,3745530,4839.19,965,2389870,2477,1355660
2017-05-23,48.85 ( 0.72 %),836,4909870,5873.05,1089,3246760,2981,1663110
2017-05-22,48.5 ( 0.21 %),691,2206700,3193.49,847,2840750,3354,-634050
2017-05-19,48.4 ( 1.04 %),623,1185710,1903.23,538,1273490,2367,-87780
2017-05-18,47.9 ( 0.21 %),632,1588220,2513.01,705,1541860,2187,46360
2017-05-17,47.8 ( 0.63 %),545,989880,1816.29,375,898840,2397,91040
2017-05-16,47.5 ( -0.63 %),555,809930,1459.33,493,1197970,2430,-388040
2017-05-15,47.8 ( -0.42 %),501,743300,1483.63,409,874620,2138,-131320
2017-05-12,48 ( -0.21 %),432,1031810,2388.45,599,1100560,1837,-68750
2017-05-11,48.1 ( 0 %),544,1071550,1969.76,639,1547260,2421,-475710
2017-05-10,48.1 ( -0.41 %),683,2212700,3239.68,1027,2746290,2674,-533590
2017-05-09,48.3 ( 2.77 %),665,1960430,2948.02,827,1701900,2058,258530
2017-05-08,47 ( -0.21 %),363,602880,1660.83,386,693260,1796,-90380
2017-05-05,47.1 ( 0.21 %),247,479450,1941.09,362,691030,1909,-211580
2017-05-04,47 ( 0 %),516,1060050,2054.36,574,1391290,2424,-331240
2017-05-03,47 ( 1.18 %),454,1154660,2543.3,468,1307290,2793,-152630
2017-04-28,46.45 ( -0.11 %),395,744040,1883.65,356,925380,2599,-181340
2017-04-27,46.5 ( 1.09 %),653,2867820,4391.76,513,1767830,3446,1099990
2017-04-26,46 ( 0.77 %),354,1086650,3069.63,341,937860,2750,148790
2017-04-25,45.65 ( -0.22 %),438,794130,1813.08,335,1056920,3155,-262790
2017-04-24,45.75 ( -0.22 %),456,665730,1459.93,270,1311690,4858,-645960
2017-04-21,45.85 ( 0 %),355,677470,1908.37,380,1037870,2731,-360400
2017-04-20,45.85 ( -0.33 %),348,761370,2187.84,303,1093990,3611,-332620
2017-04-19,46 ( 0 %),456,1351540,2963.9,432,1832110,4241,-480570
2017-04-18,46 ( 0.66 %),460,1053390,2289.98,353,967300,2740,86090
2017-04-17,45.7 ( -0.76 %),480,1458980,3039.54,449,1779920,3964,-320940
2017-04-14,46.05 ( -2.54 %),943,1962550,2081.18,507,2220130,4379,-257580
2017-04-13,47.25 ( -0.63 %),346,766610,2215.64,439,1469770,3348,-703160
2017-04-12,47.55 ( 1.28 %),571,1757410,3077.78,887,1927250,2173,-169840
2017-04-11,46.95 ( -0.11 %),355,606310,1707.92,475,1016010,2139,-409700
2017-04-10,47 ( 0 %),363,620510,1709.39,460,1025820,2230,-405310
2017-04-07,47 ( 0.97 %),414,1328390,3208.67,574,1330210,2317,-1820
2017-04-05,46.55 ( -0.96 %),402,835060,2077.26,440,1336470,3037,-501410
2017-04-04,47 ( 1.29 %),602,1743030,2895.4,542,1438830,2655,304200
2017-04-03,46.4 ( -1.9 %),999,2332340,2334.67,729,3032670,4160,-700330
2017-03-31,47.3 ( 0.42 %),504,1777860,3527.5,764,2103570,2753,-325710
2017-03-30,47.1 ( -0.84 %),566,969960,1713.71,634,1917650,3025,-947690
2017-03-29,47.5 ( 0.21 %),479,1256150,2622.44,631,1498690,2375,-242540
2017-03-28,47.4 ( -0.42 %),707,1641710,2322.08,928,2427990,2616,-786280
2017-03-27,47.6 ( -0.21 %),653,1431810,2192.66,677,1852610,2736,-420800
2017-03-24,47.7 ( -0.62 %),1236,2896340,2343.32,1565,3974050,2539,-1077710
2017-03-23,48 ( 4.12 %),873,2897240,3318.72,635,2947390,4642,-50150
2017-03-22,46.1 ( -1.07 %),617,1810480,2934.33,566,2116420,3739,-305940
2017-03-21,46.6 ( 0 %),842,2449780,2909.48,1006,2874900,2858,-425120
2017-03-20,46.6 ( 1.53 %),856,2590530,3026.32,887,2154000,2428,436530
2017-03-17,45.9 ( 0.44 %),470,1436260,3055.87,694,1717350,2475,-281090
2017-03-16,45.7 ( 0.33 %),514,945770,1840.02,385,988320,2567,-42550
2017-03-15,45.55 ( -0.33 %),511,1011010,1978.49,412,1238990,3007,-227980
2017-03-14,45.7 ( -0.11 %),479,1040750,2172.76,580,1978190,3411,-937440
2017-03-13,45.75 ( -0.54 %),371,895890,2414.8,531,1154310,2174,-258420
2017-03-10,46 ( 1.1 %),537,2027630,3775.85,874,1978240,2263,49390
2017-03-09,45.5 ( -0.66 %),405,882200,2178.27,373,966610,2591,-84410
2017-03-08,45.8 ( 0 %),387,924900,2389.92,459,999010,2176,-74110
2017-03-07,45.8 ( -0.33 %),423,884340,2090.64,457,1037480,2270,-153140
2017-03-06,45.95 ( 0.66 %),385,823940,2140.1,532,1025950,1928,-202010
2017-03-03,45.65 ( 0.44 %),505,970640,1922.06,413,731730,1772,238910
2017-03-02,45.45 ( -0.55 %),534,989830,1853.61,417,1755520,4210,-765690
2017-03-01,45.7 ( -0.33 %),613,1297820,2117.16,524,1292950,2467,4870
2017-02-28,45.85 ( -1.5 %),584,1178770,2018.44,766,1985370,2592,-806600
2017-02-27,46.55 ( 1.2 %),969,2756570,2844.76,1401,3337780,2382,-581210
2017-02-24,46 ( 0 %),512,1272420,2485.2,787,1742190,2214,-469770
2017-02-23,46 ( 0.44 %),597,1435580,2404.66,927,2267350,2446,-831770
2017-02-22,45.8 ( 0.88 %),701,1871120,2669.22,1180,2347520,1989,-476400
2017-02-21,45.4 ( 0.78 %),897,1801330,2008.17,803,1759100,2191,42230
2017-02-20,45.05 ( -0.55 %),586,1040600,1775.77,502,1281900,2554,-241300
2017-02-17,45.3 ( 0 %),721,1126140,1561.91,576,1384730,2404,-258590
2017-02-16,45.3 ( -1.52 %),875,1603710,1832.81,811,2234610,2755,-630900
2017-02-15,46 ( -0.86 %),916,1669480,1822.58,1004,2263230,2254,-593750
2017-02-14,46.4 ( 3.57 %),1046,2914030,2785.88,1172,2527160,2156,386870
2017-02-13,44.8 ( 0.79 %),582,1628040,2797.32,598,1348070,2254,279970
2017-02-10,44.45 ( -0.22 %),549,955050,1739.62,410,1141500,2784,-186450
2017-02-09,44.55 ( -0.11 %),424,1174960,2771.13,487,1355930,2784,-180970
2017-02-08,44.6 ( 0.22 %),435,972700,2236.09,470,1134310,2413,-161610
2017-02-07,44.5 ( 0.45 %),635,1590360,2504.5,459,1386580,3021,203780
2017-02-06,44.3 ( -0.89 %),603,1121400,1859.7,353,888140,2516,233260
2017-02-03,44.7 ( -0.45 %),484,820630,1695.52,433,767360,1772,53270
2017-02-02,44.9 ( -0.44 %),562,790250,1406.14,387,834280,2156,-44030
2017-01-25,45.1 ( 0.89 %),299,829730,2775.02,455,750500,1649,79230
2017-01-24,44.7 ( 0.56 %),311,978510,3146.33,326,617560,1894,360950
2017-01-23,44.45 ( 0.57 %),306,1041710,3404.28,369,978290,2651,63420
2017-01-20,44.2 ( 0.91 %),562,1439950,2562.19,454,1038040,2286,401910
2017-01-19,43.8 ( 0 %),512,987180,1928.09,480,1104700,2301,-117520
2017-01-18,43.8 ( -1.35 %),451,780380,1730.33,423,1116330,2639,-335950
2017-01-17,44.4 ( 0.91 %),443,811600,1832.05,521,1166660,2239,-355060
2017-01-16,44 ( -2 %),760,1334670,1756.14,657,1577060,2400,-242390
2017-01-13,44.9 ( -2.29 %),1267,2297330,1813.2,1258,3142470,2498,-845140
2017-01-12,45.95 ( -0.33 %),470,898250,1911.17,600,1377470,2296,-479220
2017-01-11,46.1 ( 0.22 %),556,1262650,2270.95,904,1799310,1990,-536660
2017-01-10,46 ( 1.77 %),825,2135170,2588.08,1022,1570930,1537,564240
2017-01-09,45.2 ( 0.56 %),474,987280,2082.87,570,1015840,1782,-28560
2017-01-06,44.95 ( -0.33 %),662,1431530,2162.43,715,1549600,2167,-118070
2017-01-05,45.1 ( -0.33 %),611,1007530,1648.99,648,1394590,2152,-387060
2017-01-04,45.25 ( 0.89 %),705,1889150,2679.65,927,1929260,2081,-40110
2017-01-03,44.85 ( 1.93 %),702,1638550,2334.12,1019,1784730,1751,-146180
2016-12-30,44 ( 1.27 %),812,2618330,3224.54,999,2378520,2381,239810
2016-12-29,43.45 ( -0.34 %),364,748450,2056.18,475,886500,1866,-138050
2016-12-28,43.6 ( 1.04 %),467,1411410,3022.29,809,1670390,2065,-258980
2016-12-27,43.15 ( 1.05 %),613,1414790,2307.98,746,1392660,1867,22130
2016-12-26,42.7 ( 0.12 %),266,425810,1600.79,262,475050,1813,-49240
2016-12-23,42.65 ( 0.24 %),325,476390,1465.82,294,582920,1983,-106530
2016-12-22,42.55 ( 0.12 %),534,1060810,1986.54,614,1268780,2066,-207970
2016-12-21,42.5 ( -0.12 %),318,578560,1819.37,343,720040,2099,-141480
2016-12-20,42.55 ( -0.35 %),297,486590,1638.35,393,676540,1721,-189950
2016-12-19,42.7 ( 1.43 %),293,548360,1871.54,380,515860,1358,32500
2016-12-16,42.1 ( 0.6 %),371,731490,1971.67,268,524610,1958,206880
2016-12-15,41.85 ( -0.36 %),360,662640,1840.67,228,492380,2160,170260
2016-12-14,42 ( 0.48 %),506,988570,1953.7,246,641480,2608,347090
2016-12-13,41.8 ( -0.95 %),405,660890,1631.83,254,749280,2950,-88390
2016-12-12,42.2 ( -1.63 %),401,788800,1967.08,344,830020,2413,-41220
2016-12-09,42.9 ( 1.54 %),334,811940,2430.96,461,732830,1590,79110
2016-12-08,42.25 ( 0.36 %),310,620400,2001.29,219,326980,1493,293420
2016-12-07,42.1 ( -0.47 %),435,586800,1348.97,250,494240,1977,92560
2016-12-06,42.3 ( -0.7 %),361,635480,1760.33,402,793660,1974,-158180
2016-12-05,42.6 ( -0.81 %),419,661700,1579.24,337,914310,2713,-252610
2016-12-02,42.95 ( -0.58 %),283,411530,1454.17,298,714700,2398,-303170
2016-12-01,43.2 ( -0.35 %),320,747010,2334.41,344,620030,1802,126980
2016-11-30,43.35 ( 0.46 %),367,641370,1747.6,304,503940,1658,137430
2016-11-29,43.15 ( -0.8 %),497,903300,1817.51,339,708340,2089,194960
2016-11-28,43.5 ( -1.02 %),336,602550,1793.3,362,665620,1839,-63070
2016-11-25,43.95 ( -0.9 %),417,675640,1620.24,560,1127560,2014,-451920
2016-11-24,44.35 ( 0.91 %),675,1728610,2560.9,960,1903690,1983,-175080
2016-11-23,43.95 ( 1.97 %),656,1663090,2535.2,985,1495610,1518,167480
2016-11-22,43.1 ( 0 %),393,742910,1890.36,420,848230,2020,-105320
2016-11-21,43.1 ( 0 %),281,658140,2342.14,434,826890,1905,-168750
2016-11-18,43.1 ( 1.17 %),426,789440,1853.15,364,490210,1347,299230
2016-11-17,42.6 ( -1.05 %),316,488140,1544.75,297,616880,2077,-128740
2016-11-16,43.05 ( -0.35 %),367,760650,2072.62,455,1000830,2200,-240180
2016-11-15,43.2 ( 1.05 %),378,617480,1633.54,352,728200,2069,-110720
2016-11-14,42.75 ( -0.58 %),385,652010,1693.53,359,703590,1960,-51580
2016-11-11,43 ( 0.7 %),390,851530,2183.41,603,987390,1637,-135860
2016-11-10,42.7 ( 1.18 %),346,782620,2261.91,377,523070,1387,259550
2016-11-09,42.2 ( -1.52 %),1237,2750410,2223.45,573,1620240,2828,1130170
2016-11-08,42.85 ( 0.12 %),297,603570,2032.22,401,709950,1770,-106380
2016-11-07,42.8 ( 1.54 %),418,623800,1492.34,378,554790,1468,69010
2016-11-04,42.15 ( 0.36 %),360,552690,1535.25,310,500750,1615,51940
2016-11-03,42 ( -1.41 %),822,1533430,1865.49,500,1329100,2658,204330
2016-11-02,42.6 ( -1.62 %),496,804190,1621.35,360,1062590,2952,-258400
2016-11-01,43.3 ( -0.46 %),312,520290,1667.6,275,626830,2279,-106540
2016-10-31,43.5 ( -0.23 %),307,516120,1681.17,415,939860,2265,-423740
2016-10-28,43.6 ( 0.93 %),439,1151410,2622.8,456,1102890,2419,48520
2016-10-27,43.2 ( 0.47 %),422,801000,1898.1,349,741090,2123,59910
2016-10-26,43 ( -0.46 %),433,728310,1682.01,330,870000,2636,-141690
2016-10-25,43.2 ( 0 %),556,1192680,2145.11,635,1360890,2143,-168210
2016-10-24,43.2 ( -0.46 %),602,1054400,1751.5,458,1099960,2402,-45560
2016-10-21,43.4 ( -0.23 %),337,617950,1833.68,369,792760,2148,-174810
2016-10-20,43.5 ( -0.8 %),571,771400,1350.96,403,1095520,2718,-324120
2016-10-19,43.85 ( 0.57 %),411,893210,2173.26,508,1035320,2038,-142110
2016-10-18,43.6 ( 0.46 %),616,1084470,1760.5,418,964300,2307,120170
2016-10-17,43.4 ( -1.03 %),741,1242850,1677.26,375,1204920,3213,37930
2016-10-14,43.85 ( -0.34 %),606,989940,1633.56,434,1070980,2468,-81040
2016-10-13,44 ( 0.46 %),599,1104200,1843.41,471,829290,1761,274910
2016-10-12,43.8 ( -1.57 %),815,1234820,1515.12,553,1674780,3029,-439960
2016-10-11,44.5 ( 2.06 %),1121,2685730,2395.83,708,2193990,3099,491740
2016-10-10,43.6 ( -3.22 %),1197,2613170,2183.1,684,3073180,4493,-460010
2016-10-07,45.05 ( -2.28 %),1779,3867120,2173.76,1147,4021010,3506,-153890
2016-10-06,46.1 ( -1.5 %),638,1349490,2115.19,628,1874460,2985,-524970
2016-10-05,46.8 ( 0 %),426,982360,2306.01,515,1243680,2415,-261320
2016-10-04,46.8 ( 0.32 %),1066,3422240,3210.36,833,3106190,3729,316050
2016-10-03,46.65 ( 0 %),830,1907390,2298.06,634,1796880,2834,110510
2016-09-30,46.65 ( -1.48 %),1171,2536480,2166.08,801,2929260,3657,-392780
2016-09-29,47.35 ( -1.15 %),1006,2794750,2778.08,950,3187050,3355,-392300
2016-09-28,47.9 ( 0.21 %),829,2601210,3137.77,1057,3238490,3064,-637280
2016-09-27,47.8 ( 0 %),1044,3177450,3043.53,883,3241060,3671,-63610
2016-09-26,47.8 ( 0.84 %),911,3391510,3722.84,1127,3364950,2986,26560
2016-09-23,47.4 ( 1.72 %),1240,4017240,3239.71,1438,4183330,2909,-166090
2016-09-22,46.6 ( 2.42 %),1205,4820630,4000.52,1459,3949320,2707,871310
2016-09-21,45.5 ( -0.33 %),617,1415840,2294.72,706,1722380,2440,-306540
2016-09-20,45.65 ( 0.77 %),744,2166620,2912.12,949,2579110,2718,-412490
2016-09-19,45.3 ( 0.67 %),645,1600110,2480.79,744,1972250,2651,-372140
2016-09-16,45 ( 0.45 %),772,1878290,2433.02,472,1337510,2834,540780
2016-09-15,44.8 ( -1.54 %),704,1692280,2403.81,542,1804320,3329,-112040
2016-09-14,45.5 ( 0.66 %),599,2175900,3632.55,835,2256520,2702,-80620
2016-09-13,45.2 ( 0.44 %),928,2027330,2184.62,706,2029040,2874,-1710
2016-09-12,45 ( -1.53 %),753,1994810,2649.15,682,2009230,2946,-14420
2016-09-09,45.7 ( 0.22 %),1098,2930240,2668.71,1218,3548890,2914,-618650
2016-09-08,45.6 ( 3.4 %),1638,5410880,3303.35,1879,5151930,2742,258950
2016-09-07,44.1 ( -0.23 %),996,2577600,2587.95,690,2177290,3155,400310
2016-09-06,44.2 ( -0.67 %),756,1972480,2609.1,870,2620660,3012,-648180
2016-09-05,44.5 ( 0 %),593,1511340,2548.63,880,2190610,2489,-679270
2016-09-01,44.5 ( 1.37 %),1335,3464890,2595.42,1588,4090340,2576,-625450
2016-08-31,43.9 ( 3.05 %),1440,5673260,3939.76,2007,5191400,2587,481860
2016-08-30,42.6 ( 0 %),562,1263870,2248.88,479,1103250,2303,160620
2016-08-29,42.6 ( -0.93 %),641,1440940,2247.96,1004,2399720,2390,-958780
2016-08-26,43 ( 1.42 %),1244,3714940,2986.29,1607,4142950,2578,-428010
2016-08-25,42.4 ( 0.95 %),505,1403710,2779.62,575,1218670,2119,185040
2016-08-24,42 ( 0.72 %),550,1335870,2428.85,665,1703000,2561,-367130
2016-08-23,41.7 ( 0.48 %),519,991020,1909.48,341,892280,2617,98740
2016-08-22,41.5 ( 0.24 %),545,1422810,2610.66,480,1699690,3541,-276880
2016-08-19,42.4 ( -1.62 %),518,1011570,1952.84,634,1770250,2792,-758680
2016-08-18,43.1 ( -0.23 %),703,2244340,3192.52,1157,2738530,2367,-494190
2016-08-17,43.2 ( 1.17 %),703,2105430,2994.92,1139,2500150,2195,-394720
2016-08-16,42.7 ( 2.64 %),745,3487500,4681.21,1469,3356130,2285,131370
2016-08-15,41.6 ( 0 %),301,618470,2054.72,404,712300,1763,-93830
2016-08-12,41.6 ( -0.48 %),441,895060,2029.61,725,1532950,2114,-637890
2016-08-11,41.8 ( 1.7 %),481,1335980,2777.51,672,1056140,1572,279840
2016-08-10,41.1 ( 0.49 %),406,805230,1983.33,340,759420,2234,45810
2016-08-09,40.9 ( 0.74 %),356,758400,2130.34,314,685820,2184,72580
2016-08-08,40.6 ( 0.25 %),343,684690,1996.18,334,765110,2291,-80420
2016-08-05,40.5 ( 0.25 %),361,971920,2692.3,308,688790,2236,283130
2016-08-04,40.4 ( -0.25 %),304,497790,1637.47,300,753430,2511,-255640
2016-08-03,40.5 ( -0.25 %),423,806750,1907.21,299,797490,2667,9260
2016-08-02,40.6 ( -1.22 %),588,1173170,1995.19,405,1227010,3030,-53840
2016-08-01,41.1 ( 0.24 %),344,634810,1845.38,383,780600,2038,-145790
2016-07-29,41 ( -0.73 %),401,426490,1063.57,294,710540,2417,-284050
2016-07-28,41.3 ( 0 %),441,965150,2188.55,432,941560,2180,23590
2016-07-27,41.3 ( 0.98 %),542,1074420,1982.32,533,1192120,2237,-117700
2016-07-26,40.9 ( -0.49 %),546,848320,1553.7,345,831730,2411,16590
2016-07-25,41.1 ( -0.48 %),437,626270,1433.11,314,740950,2360,-114680
2016-07-22,41.3 ( -0.72 %),791,1785640,2257.45,558,1441400,2583,344240
2016-07-21,41.6 ( 0 %),506,880400,1739.92,481,962360,2001,-81960
2016-07-20,41.6 ( -0.72 %),640,1159730,1812.08,502,1128520,2248,31210
2016-07-19,41.9 ( -1.64 %),1141,1645120,1441.82,626,1926420,3077,-281300
2016-07-18,42.6 ( 0 %),603,1044200,1731.67,466,969810,2081,74390
2016-07-15,42.6 ( -0.93 %),625,1241260,1986.02,864,1461500,1692,-220240
2016-07-14,43 ( 0.23 %),952,2651820,2785.53,2089,3710730,1776,-1058910
2016-07-13,42.9 ( 0.7 %),481,1460920,3037.26,755,1787490,2368,-326570
2016-07-12,42.6 ( 0 %),731,1415740,1936.72,453,1288670,2845,127070
2016-07-11,42.6 ( -2.29 %),556,1556600,2799.64,830,2308120,2781,-751520
2016-07-08,43.6 ( 0.69 %),878,2871570,3270.58,1298,3323360,2560,-451790
2016-07-07,43.3 ( 2.36 %),984,3214180,3266.44,1325,3061410,2310,152770
2016-07-06,42.3 ( 0.24 %),523,1265290,2419.29,482,1150530,2387,114760
2016-07-05,42.2 ( -0.71 %),549,1238930,2256.7,685,1564810,2284,-325880
2016-07-04,42.5 ( 1.43 %),525,1339780,2551.96,913,1786930,1957,-447150
2016-07-01,41.9 ( 0.24 %),385,1075970,2794.73,663,1462620,2206,-386650
2016-06-30,41.8 ( -0.48 %),430,994570,2312.95,891,2007530,2253,-1012960
2016-06-29,42 ( 1.94 %),677,1836450,2712.63,1070,2218200,2073,-381750
2016-06-28,41.2 ( 0 %),420,728340,1734.14,469,1042700,2223,-314360
2016-06-27,41.2 ( 0.73 %),645,1362540,2112.47,529,930280,1759,432260
2016-06-24,40.9 ( -2.39 %),1784,4025340,2256.36,921,3713080,4032,312260
2016-06-23,41.9 ( -1.18 %),661,1170910,1771.42,572,1588130,2776,-417220
2016-06-22,42.4 ( -0.7 %),294,698680,2376.46,497,882150,1775,-183470
2016-06-21,42.7 ( 0 %),928,1994380,2149.12,1542,3275470,2124,-1281090
2016-06-20,42.7 ( 5.69 %),1074,3258250,3033.75,1126,2653920,2357,604330
2016-06-17,40.4 ( 0 %),284,535340,1885,279,487700,1748,47640
2016-06-16,40.4 ( 0.25 %),355,796900,2244.79,338,661740,1958,135160
2016-06-15,40.3 ( -0.49 %),418,719550,1721.41,288,754780,2621,-35230
2016-06-14,40.5 ( 0.25 %),335,525870,1569.76,259,504360,1947,21510
2016-06-13,40.4 ( -0.25 %),378,550140,1455.4,267,495560,1856,54580
2016-06-10,40.5 ( 0 %),490,926250,1890.31,345,902800,2617,23450
2016-06-09,40.5 ( -0.49 %),384,649310,1690.91,299,725370,2426,-76060
2016-06-08,40.7 ( 0.49 %),446,895910,2008.77,339,817620,2412,78290
2016-06-07,40.5 ( 0.25 %),631,949350,1504.52,281,1014260,3609,-64910
2016-06-06,40.4 ( -0.74 %),664,1151470,1734.14,450,1450240,3223,-298770
2016-06-03,40.7 ( -0.25 %),397,581530,1464.81,350,863300,2467,-281770
2016-06-02,40.8 ( 0 %),383,721040,1882.61,314,723900,2305,-2860
2016-06-01,40.8 ( 0 %),383,989510,2583.58,364,991480,2724,-1970
2016-05-31,40.8 ( -0.73 %),397,744240,1874.66,443,1336540,3017,-592300
2016-05-30,41.1 ( 0.24 %),503,812610,1615.53,447,1017810,2277,-205200
2016-05-27,41 ( 1.39 %),986,1302480,1320.97,515,982000,1907,320480
2016-05-26,47.5 ( -0.42 %),502,1798220,3582.11,674,2869750,4258,-1071530
2016-05-25,47.7 ( 0 %),469,1104540,2355.1,468,1517440,3242,-412900
2016-05-24,47.7 ( -0.21 %),397,698380,1759.14,414,1046140,2527,-347760
2016-05-23,47.8 ( -0.21 %),332,596890,1797.86,435,1076260,2474,-479370
2016-05-20,47.9 ( 0.42 %),417,922610,2212.49,371,1271480,3427,-348870
2016-05-19,47.7 ( 0 %),308,364790,1184.38,366,928420,2537,-563630
2016-05-18,47.7 ( 0.21 %),690,1277300,1851.16,729,2007070,2753,-729770
2016-05-17,47.6 ( 0.63 %),465,740910,1593.35,417,891500,2138,-150590
2016-05-16,47.3 ( -0.21 %),441,578710,1312.27,310,924350,2982,-345640
2016-05-13,47.4 ( 0 %),431,781680,1813.64,351,861870,2455,-80190
2016-05-12,47.4 ( -0.63 %),398,727640,1828.24,395,1004130,2542,-276490
2016-05-11,47.7 ( 0.85 %),407,1021430,2509.66,399,773060,1937,248370
2016-05-10,47.3 ( 0.21 %),552,1083700,1963.22,371,1009620,2721,74080
2016-05-09,47.2 ( -0.63 %),548,849460,1550.11,495,1325060,2677,-475600
2016-05-06,47.5 ( -0.63 %),637,1087740,1707.6,464,1472310,3173,-384570
2016-05-05,47.8 ( -0.62 %),603,1302960,2160.8,671,2035630,3034,-732670
2016-05-04,48.1 ( -1.03 %),808,1486360,1839.55,532,1500460,2820,-14100
2016-04-29,48.6 ( 0.41 %),521,1082950,2078.6,609,1495080,2455,-412130
2016-04-28,48.4 ( 1.47 %),1853,6030150,3254.26,1544,5108870,3309,921280
2016-04-27,47.7 ( -0.42 %),353,1057710,2996.35,415,1090000,2627,-32290
2016-04-26,47.9 ( 0 %),345,543060,1574.09,335,728900,2176,-185840
2016-04-25,47.9 ( 0.21 %),394,1232150,3127.28,557,1134340,2037,97810
2016-04-22,47.8 ( 1.06 %),472,1522200,3225,459,1215840,2649,306360
2016-04-21,47.3 ( 0.42 %),260,873170,3358.35,319,862230,2703,10940
2016-04-20,47.1 ( 0.21 %),362,1220390,3371.24,358,1225130,3422,-4740
2016-04-19,47 ( -0.42 %),311,829260,2666.43,373,906280,2430,-77020
2016-04-15,47.2 ( -0.63 %),437,940190,2151.46,339,1282250,3782,-342060
2016-04-14,47.5 ( -0.21 %),314,874190,2784.04,349,1037520,2973,-163330
2016-04-13,47.6 ( -0.21 %),270,791050,2929.81,336,967430,2879,-176380
2016-04-12,47.7 ( -0.42 %),356,556510,1563.23,355,907850,2557,-351340
2016-04-11,47.9 ( 0.63 %),546,1201930,2201.34,502,1304710,2599,-102780
2016-04-08,47.6 ( -0.42 %),234,559290,2390.13,381,664440,1744,-105150
2016-04-07,47.8 ( 0.84 %),337,877900,2605.04,401,882230,2200,-4330
2016-04-06,47.4 ( 0.85 %),354,655250,1850.99,264,506290,1918,148960
2016-04-05,47 ( 0.43 %),355,739830,2084.03,240,589180,2455,150650
2016-04-04,46.8 ( 0 %),365,741250,2030.82,294,614880,2091,126370
2016-04-01,46.8 ( -0.64 %),508,879090,1730.49,349,954500,2735,-75410
2016-03-31,47.1 ( -0.84 %),394,875390,2221.8,375,944050,2517,-68660
2016-03-30,47.5 ( 0 %),505,1307620,2589.35,336,1011620,3011,296000
2016-03-29,47.5 ( -1.04 %),578,964040,1667.89,385,1159310,3011,-195270
2016-03-28,48 ( 0.21 %),406,741130,1825.44,316,709470,2245,31660
2016-03-25,47.9 ( -1.03 %),804,1801130,2240.21,520,1946000,3742,-144870
2016-03-24,48.4 ( -0.62 %),421,1062350,2523.4,469,1547230,3299,-484880
2016-03-23,48.7 ( 0 %),514,1158620,2254.12,422,1262220,2991,-103600
2016-03-22,48.7 ( -1.02 %),476,1032980,2170.13,525,1356900,2585,-323920
2016-03-21,49.2 ( -0.2 %),484,972530,2009.36,616,1487400,2415,-514870
2016-03-18,49.3 ( 1.65 %),944,4008330,4246.11,1682,4959100,2948,-950770
2016-03-17,48.5 ( 0 %),397,975950,2458.31,536,1433510,2674,-457560
2016-03-16,48.5 ( 0 %),376,855770,2275.98,376,1133710,3015,-277940
2016-03-15,48.5 ( -0.41 %),539,1134090,2104.06,680,1457260,2143,-323170
2016-03-14,48.7 ( 0.41 %),676,1576030,2331.41,938,2146480,2288,-570450
2016-03-11,48.5 ( 0.62 %),469,1407710,3001.51,795,1553290,1954,-145580
2016-03-10,48.2 ( 0.42 %),344,560640,1629.77,329,744710,2264,-184070
2016-03-09,48 ( 0 %),493,902210,1830.04,346,824440,2383,77770
2016-03-08,48 ( -1.23 %),892,1459030,1635.68,572,1823600,3188,-364570
2016-03-07,48.6 ( -0.82 %),490,1272080,2596.08,782,1688690,2159,-416610
2016-03-04,49 ( 0.41 %),472,1784480,3780.68,940,1693240,1801,91240
2016-03-03,48.8 ( 0.21 %),526,1439570,2736.83,1078,2114570,1962,-675000
2016-03-02,48.7 ( 1.04 %),649,1772120,2730.54,816,1718470,2106,53650
2016-03-01,48.2 ( 0.84 %),842,2059940,2446.48,942,2102320,2232,-42380
2016-02-29,47.8 ( 0.21 %),365,1006250,2756.85,503,1081110,2149,-74860
2016-02-26,47.7 ( 0.21 %),490,725420,1480.45,392,870910,2222,-145490
2016-02-25,47.6 ( -0.42 %),500,1677680,3355.36,644,1549820,2407,127860
2016-02-24,47.8 ( 0 %),614,1403520,2285.86,429,1217510,2838,186010
2016-02-23,47.8 ( -0.83 %),553,1073480,1941.19,602,1494450,2482,-420970
2016-02-22,48.2 ( 1.05 %),454,1456920,3209.07,491,984480,2005,472440
2016-02-19,47.7 ( -0.83 %),407,950700,2335.87,377,1112260,2950,-161560
2016-02-18,48.1 ( 1.26 %),516,1771880,3433.88,663,1451990,2190,319890
2016-02-17,47.5 ( 0.42 %),581,1229850,2116.78,704,1746470,2481,-516620
2016-02-16,47.3 ( 1.28 %),318,614360,1931.95,514,776720,1511,-162360
2016-02-15,46.7 ( -0.43 %),296,659520,2228.11,250,605880,2424,53640
2016-02-05,46.9 ( 0.86 %),290,1015620,3502.14,303,699600,2309,316020
2016-02-04,46.5 ( -0.21 %),211,522040,2474.12,326,721800,2214,-199760
2016-02-03,46.6 ( 0.87 %),472,1348790,2857.61,554,1128600,2037,220190
2016-02-02,46.2 ( -0.86 %),271,528630,1950.66,371,603230,1626,-74600
2016-02-01,46.6 ( 0.43 %),344,1114060,3238.55,605,1199250,1982,-85190
2016-01-29,46.4 ( 0.87 %),303,942770,3111.45,433,955420,2207,-12650
2016-01-28,46 ( -0.65 %),341,805760,2362.93,415,1027020,2475,-221260
2016-01-27,46.3 ( 0.87 %),239,716640,2998.49,453,874310,1930,-157670
2016-01-26,45.9 ( -2.55 %),615,1171710,1905.22,506,1425060,2816,-253350
2016-01-25,47.1 ( 5.13 %),679,1769010,2605.32,622,1309850,2106,459160
2016-01-22,44.8 ( -0.22 %),589,1022620,1736.2,451,1216940,2698,-194320
2016-01-21,44.9 ( 0 %),511,1295510,2535.24,404,1092720,2705,202790
2016-01-20,44.9 ( -0.44 %),468,1197370,2558.48,510,1296770,2543,-99400
2016-01-19,45.1 ( 0.45 %),718,1580100,2200.7,455,1515850,3332,64250
2016-01-18,44.9 ( -2.6 %),1181,3158640,2674.55,878,3525210,4015,-366570
2016-01-15,46.1 ( -0.22 %),367,810960,2209.7,445,1015030,2281,-204070
2016-01-14,46.2 ( -0.43 %),448,1005160,2243.66,402,905580,2253,99580
2016-01-13,46.4 ( -1.07 %),506,909690,1797.81,573,1156770,2019,-247080
2016-01-12,46.9 ( 2.18 %),599,1252310,2090.67,456,958050,2101,294260
2016-01-11,45.9 ( -0.86 %),688,1285880,1869.01,521,1419870,2725,-133990
2016-01-08,46.3 ( -1.49 %),1195,2776250,2323.22,838,2742500,3273,33750
2016-01-07,47 ( -1.88 %),1128,2460920,2181.67,821,2785890,3393,-324970
2016-01-06,47.9 ( 0.21 %),390,967460,2480.67,376,832230,2213,135230
2016-01-05,47.8 ( 0 %),614,1385430,2256.4,536,1323300,2469,62130
2016-01-04,47.8 ( -1.04 %),589,1003060,1702.99,519,1222800,2356,-219740
2015-12-31,48.3 ( 0 %),431,994610,2307.68,637,1634560,2566,-639950
2015-12-30,48.3 ( 0 %),591,1393400,2357.7,651,1821660,2798,-428260
2015-12-29,48.3 ( 0.42 %),605,1379140,2279.57,433,928560,2144,450580
2015-12-28,48.1 ( 0.63 %),702,1355000,1930.2,532,1279890,2406,75110
2015-12-25,47.8 ( 0 %),438,773130,1765.14,340,661050,1944,112080
2015-12-24,47.8 ( -0.21 %),423,896860,2120.24,342,873810,2555,23050
2015-12-23,47.9 ( -0.42 %),698,1376980,1972.75,452,1062040,2350,314940
2015-12-22,48.1 ( -0.82 %),547,1077130,1969.16,371,1074770,2897,2360
2015-12-21,48.5 ( -0.82 %),561,1002150,1786.36,428,1106200,2585,-104050
2015-12-18,48.9 ( -0.61 %),535,1310220,2449.01,618,1771280,2866,-461060
2015-12-17,49.2 ( 0.82 %),653,1840420,2818.41,856,1836630,2146,3790
2015-12-16,48.8 ( 0.62 %),871,2458220,2822.3,1057,2358440,2231,99780
2015-12-15,48.5 ( 1.46 %),515,1195230,2320.83,568,1131020,1991,64210
2015-12-14,47.8 ( -0.42 %),463,868430,1875.66,346,843090,2437,25340
2015-12-11,48 ( 0.42 %),521,1122310,2154.15,627,1086600,1733,35710
2015-12-10,47.8 ( -0.83 %),518,1170340,2259.34,512,1297970,2535,-127630
2015-12-09,48.2 ( -1.63 %),603,1190720,1974.66,898,1991250,2217,-800530
2015-12-08,49 ( 3.16 %),1103,2626620,2381.34,834,1826450,2190,800170
2015-12-07,47.5 ( -0.84 %),783,1655670,2114.52,552,1572900,2849,82770
2015-12-04,47.9 ( -1.24 %),1032,1553760,1505.58,617,1749680,2836,-195920
2015-12-03,48.5 ( 0.21 %),461,818690,1775.9,469,939270,2003,-120580
2015-12-02,48.4 ( 0.41 %),674,1348590,2000.88,543,1347040,2481,1550
2015-12-01,48.2 ( -0.21 %),697,1313100,1883.93,647,1664560,2573,-351460
2015-11-30,48.3 ( -1.23 %),928,2052920,2212.2,775,2414590,3116,-361670
2015-11-27,48.9 ( -0.2 %),1266,2954140,2333.44,1211,3363120,2777,-408980
2015-11-26,49 ( -2 %),759,1378010,1815.56,872,2696460,3092,-1318450
2015-11-25,50 ( 1.83 %),1432,3057170,2134.9,988,2681300,2714,375870
2015-11-24,49.1 ( -0.81 %),2218,4808390,2167.89,1458,5019540,3443,-211150
2015-11-23,49.5 ( -2.94 %),1156,2598290,2247.66,1043,3659040,3508,-1060750
2015-11-20,51 ( -0.97 %),1134,2583100,2277.87,1007,2969330,2949,-386230
2015-11-19,51.5 ( -0.96 %),962,2183600,2269.85,922,3099940,3362,-916340
2015-11-18,52 ( 0 %),1185,3320430,2802.05,1062,3584430,3375,-264000
2015-11-17,52 ( -3.7 %),1315,3356140,2552.2,1312,4431180,3377,-1075040
2015-11-16,54 ( -0.92 %),1570,4452870,2836.22,1617,5003670,3094,-550800
2015-11-13,54.5 ( 2.83 %),1611,5564700,3454.19,1808,5573740,3083,-9040
2015-11-12,53 ( 4.95 %),1864,6625930,3554.68,1582,5581610,3528,1044320
2015-11-11,50.5 ( -0.98 %),1187,3549230,2990.08,1037,3694860,3563,-145630
2015-11-10,51 ( -0.97 %),1509,4256610,2820.82,1217,4040060,3320,216550
2015-11-09,51.5 ( -1.9 %),1593,4286950,2691.12,1227,4313570,3516,-26620
2015-11-06,52.5 ( -1.87 %),2085,5612310,2691.76,1745,5867310,3362,-255000
2015-11-05,53.5 ( 2.88 %),1850,5493830,2969.64,1329,4016980,3023,1476850
2015-11-04,52 ( -0.95 %),1433,3247130,2265.97,1396,4150380,2973,-903250
2015-11-03,52.5 ( 6.06 %),2074,6878390,3316.49,1741,5381400,3091,1496990
2015-11-02,49.5 ( 0.41 %),1518,4072720,2682.95,1726,5249300,3041,-1176580
2015-10-30,49.3 ( 0 %),1007,1877590,1864.54,943,2441270,2589,-563680
2015-10-29,49.3 ( 1.02 %),1146,2684500,2342.5,1286,3570830,2777,-886330
2015-10-28,48.8 ( 1.67 %),1221,4029110,3299.84,1255,3896900,3105,132210
2015-10-27,48 ( 0.84 %),768,2765090,3600.38,951,2714360,2854,50730
2015-10-26,47.6 ( 1.06 %),1270,3986290,3138.81,1634,5227730,3199,-1241440
2015-10-23,47.1 ( 0.43 %),369,1208670,3275.53,557,1719420,3087,-510750
2015-10-22,46.9 ( -0.21 %),346,907630,2623.21,375,1343130,3582,-435500
2015-10-21,47 ( -0.63 %),418,1029510,2462.94,617,2219140,3597,-1189630
2015-10-20,47.3 ( 0.42 %),883,2858000,3236.69,1089,4063820,3732,-1205820
2015-10-19,47.1 ( 0.86 %),718,2329930,3245.03,892,2607230,2923,-277300
2015-10-16,46.7 ( 0.21 %),314,1029780,3279.55,529,1772410,3350,-742630
2015-10-15,46.6 ( -0.21 %),348,729870,2097.33,662,1975530,2984,-1245660
2015-10-14,46.7 ( 2.64 %),1241,4080140,3287.78,2075,7113960,3428,-3033820
2015-10-13,45.5 ( -0.66 %),390,798380,2047.13,310,651420,2101,146960
2015-10-12,45.8 ( 0 %),266,785890,2954.47,441,875060,1984,-89170
2015-10-09,45.8 ( 0 %),359,1170340,3260,766,1638820,2139,-468480
2015-10-08,45.8 ( 1.33 %),303,932550,3077.72,427,847890,1986,84660
2015-10-07,45.2 ( -1.74 %),350,605420,1729.77,441,989160,2243,-383740
2015-10-06,46 ( 2.22 %),485,1432730,2954.08,693,1497140,2160,-64410
2015-10-05,45 ( 0.9 %),270,802570,2972.48,344,593680,1726,208890
2015-10-02,44.6 ( 0 %),150,371150,2474.33,228,357610,1568,13540
2015-10-01,44.6 ( 0.22 %),158,337660,2137.09,212,367720,1735,-30060
2015-09-30,44.5 ( 0 %),258,369160,1430.85,226,431310,1908,-62150
2015-09-29,44.5 ( 0 %),213,466640,2190.8,279,455150,1631,11490
2015-09-28,44.5 ( -0.89 %),239,399050,1669.67,244,625140,2562,-226090
2015-09-25,44.9 ( -0.44 %),274,416350,1519.53,245,568370,2320,-152020
2015-09-24,45.1 ( 0.45 %),252,615720,2443.33,343,634320,1849,-18600
2015-09-23,44.9 ( -0.66 %),381,746430,1959.13,327,808300,2472,-61870
2015-09-22,45.2 ( -0.66 %),344,566220,1645.99,445,803620,1806,-237400
2015-09-21,45.5 ( 2.02 %),446,1171480,2626.64,518,965620,1864,205860
2015-09-18,44.6 ( 1.83 %),465,1365540,2936.65,557,1171770,2104,193770
2015-09-17,43.8 ( 0.23 %),228,272340,1194.47,222,287270,1294,-14930
2015-09-16,43.7 ( 0 %),260,250000,961.54,169,335300,1984,-85300
2015-09-15,43.7 ( 0 %),271,227610,839.89,163,194980,1196,32630
2015-09-14,43.7 ( -0.68 %),239,331470,1386.9,234,412880,1764,-81410
2015-09-11,44 ( -0.45 %),218,294410,1350.5,271,536110,1978,-241700
2015-09-10,44.2 ( 0.23 %),314,410600,1307.64,229,383090,1673,27510
2015-09-09,44.1 ( 0.46 %),314,505110,1608.63,370,708690,1915,-203580
2015-09-08,43.9 ( 0.69 %),298,455470,1528.42,228,456340,2001,-870
2015-09-07,43.6 ( -0.46 %),312,265760,851.79,213,438080,2057,-172320
2015-09-04,43.8 ( 0.23 %),265,382670,1444.04,190,417830,2199,-35160
2015-09-03,43.7 ( -0.91 %),376,700210,1862.26,266,657930,2473,42280
2015-09-01,44.1 ( -0.23 %),426,520870,1222.7,229,610730,2667,-89860
2015-08-31,44.2 ( -1.12 %),415,675100,1626.75,406,855700,2108,-180600
2015-08-28,44.7 ( 0.9 %),518,1336560,2580.23,485,1495710,3084,-159150
2015-08-27,44.3 ( 0.45 %),563,1100150,1954.09,493,1583960,3213,-483810
2015-08-26,44.1 ( 2.8 %),836,1805710,2159.94,514,1540460,2997,265250
2015-08-25,42.9 ( 1.18 %),1010,2699380,2672.65,691,2139390,3096,559990
2015-08-24,42.4 ( -6.19 %),1100,2624160,2385.6,816,2944170,3608,-320010
2015-08-21,45.2 ( -0.66 %),1088,2241370,2060.08,577,1648540,2857,592830
2015-08-20,45.5 ( -1.3 %),543,694320,1278.67,333,822800,2471,-128480
2015-08-19,46.1 ( 1.1 %),793,1570760,1980.78,537,1439020,2680,131740
2015-08-18,46.6 ( 0.87 %),658,1633720,2482.86,413,1302710,3154,331010
2015-08-17,46.2 ( -1.28 %),678,1156130,1705.21,483,1464790,3033,-308660
2015-08-14,46.8 ( -0.43 %),784,1570180,2002.78,360,1123800,3122,446380
2015-08-13,47 ( -1.26 %),918,2171380,2365.34,519,2215500,4269,-44120
2015-08-12,47.6 ( -1.45 %),949,2178720,2295.81,570,2131250,3739,47470
2015-08-11,48.3 ( -0.41 %),596,1372990,2303.67,796,1935290,2431,-562300
2015-08-10,48.5 ( 2.54 %),730,2356660,3228.3,913,1771460,1940,585200
2015-08-07,47.3 ( 1.07 %),466,1247300,2676.61,462,934900,2024,312400
2015-08-06,46.8 ( -1.27 %),439,896180,2041.41,382,1109360,2904,-213180
2015-08-05,47.4 ( 0.85 %),442,1030940,2332.44,322,599180,1861,431760
2015-08-04,47 ( 1.08 %),523,1355630,2592.03,524,978690,1868,376940
2015-08-03,46.5 ( -1.69 %),889,2110340,2373.84,538,1683990,3130,426350
2015-07-31,47.3 ( 0 %),582,1197310,2057.23,414,975120,2355,222190
2015-07-30,47.3 ( -1.25 %),680,1427890,2099.84,423,1486290,3514,-58400
2015-07-29,47.9 ( -0.62 %),681,1774510,2605.74,742,2150520,2898,-376010
2015-07-28,48.2 ( -1.63 %),511,937450,1834.54,776,1725290,2223,-787840
2015-07-27,49 ( 2.94 %),976,2900180,2971.5,1428,3289170,2303,-388990
2015-07-24,47.6 ( 1.28 %),518,1973480,3809.81,1103,2444320,2216,-470840
2015-07-23,47 ( 1.08 %),872,3052700,3500.8,1427,3597020,2521,-544320
2015-07-22,46.5 ( 1.97 %),460,947090,2058.89,481,632780,1316,314310
2015-07-21,45.6 ( -1.3 %),739,1244530,1684.07,571,1506200,2638,-261670
2015-07-20,46.2 ( -0.43 %),477,816340,1711.4,347,914140,2634,-97800
2015-07-17,46.4 ( 0 %),339,664450,1960.03,347,859770,2478,-195320
2015-07-16,46.4 ( 0 %),634,1127560,1778.49,344,1102160,3204,25400
2015-07-15,46.4 ( -1.07 %),540,951440,1761.93,393,1364540,3472,-413100
2015-07-14,46.9 ( 0 %),450,722290,1605.09,440,1103280,2507,-380990
2015-07-13,46.9 ( 0.64 %),420,1139220,2712.43,539,1275420,2366,-136200
2015-07-10,46.6 ( -0.21 %),673,1381580,2052.87,396,1421980,3591,-40400
2015-07-09,46.7 ( 0 %),695,1809520,2603.63,340,1440180,4236,369340
2015-07-08,46.7 ( -1.89 %),807,2244950,2781.85,640,2527010,3948,-282060
2015-07-07,47.6 ( 0.21 %),627,1800660,2871.87,802,2046450,2552,-245790
2015-07-06,47.5 ( 1.06 %),523,1773050,3390.15,700,1575630,2251,197420
2015-07-03,47 ( -0.42 %),576,1260520,2188.4,575,1543730,2685,-283210
2015-07-02,47.2 ( 0.85 %),532,1768340,3323.95,790,1875350,2374,-107010
2015-07-01,46.8 ( 0.86 %),571,1507990,2640.96,528,1393490,2639,114500
2015-06-30,46.4 ( -0.85 %),742,1532080,2064.8,440,1599930,3636,-67850
2015-06-29,46.8 ( 1.08 %),659,1680230,2549.67,828,2097730,2533,-417500
2015-06-26,46.3 ( 2.89 %),1388,6011910,4331.35,2069,6738180,3257,-726270
2015-06-25,45 ( -0.44 %),303,1076090,3551.45,325,1031790,3175,44300
2015-06-24,45.2 ( -0.66 %),311,910220,2926.75,377,896660,2378,13560
2015-06-23,45.5 ( -0.22 %),314,1201350,3825.96,551,1305850,2370,-104500
2015-06-22,45.6 ( 1.79 %),635,2383310,3753.24,808,2010570,2488,372740
2015-06-19,44.8 ( 0.67 %),334,1459050,4368.41,461,1101050,2388,358000
2015-06-18,44.5 ( 0.23 %),304,1030450,3389.64,348,742430,2133,288020
2015-06-17,44.4 ( -0.22 %),408,961480,2356.57,297,900180,3031,61300
2015-06-16,44.5 ( -1.11 %),473,829570,1753.85,353,1038860,2943,-209290
2015-06-15,45 ( -0.22 %),359,737170,2053.4,372,841740,2263,-104570
2015-06-12,45.1 ( 0.67 %),431,1170510,2715.8,583,1312120,2251,-141610
2015-06-11,44.8 ( 0.45 %),342,1022320,2989.24,385,890260,2312,132060
2015-06-10,44.6 ( 0.68 %),395,693330,1755.27,308,581240,1887,112090
2015-06-09,44.3 ( 0 %),496,1089030,2195.62,456,1165100,2555,-76070
2015-06-08,44.3 ( -1.12 %),591,933730,1579.92,472,1384260,2933,-450530
2015-06-05,44.8 ( 0.9 %),411,1018160,2477.27,380,1042180,2743,-24020
2015-06-04,44.4 ( 0.45 %),312,479760,1537.69,312,692770,2220,-213010
2015-06-03,44.2 ( 1.14 %),694,1395900,2011.38,373,1066630,2860,329270
2015-06-02,43.7 ( -1.35 %),739,1163600,1574.56,393,1182980,3010,-19380
2015-06-01,44.3 ( -1.56 %),744,1011760,1359.89,271,1259900,4649,-248140
2015-05-29,45 ( -0.88 %),568,645570,1136.57,255,871840,3419,-226270
2015-05-28,45.4 ( 1.34 %),1247,1897650,1521.77,516,2338420,4532,-440770
2015-05-27,52.5 ( -0.94 %),578,2475450,4282.79,726,2892930,3985,-417480
2015-05-26,53 ( -1.85 %),455,1346730,2959.85,941,3168350,3367,-1821620
2015-05-25,54 ( 3.85 %),633,3447190,5445.8,868,2587350,2981,859840
2015-05-22,52 ( -0.95 %),486,1849220,3804.98,710,1854920,2613,-5700
2015-05-21,52.5 ( 2.94 %),763,3810430,4994.01,987,3110520,3151,699910
2015-05-20,51 ( 3.66 %),615,2607930,4240.54,736,2099810,2853,508120
2015-05-19,49.2 ( 0.82 %),279,672630,2410.86,227,464770,2047,207860
2015-05-18,48.8 ( -0.61 %),248,754720,3043.23,272,726370,2670,28350
2015-05-15,49.1 ( -0.41 %),259,568460,2194.83,204,428740,2102,139720
2015-05-14,49.3 ( 0.2 %),404,1063840,2633.27,301,774310,2572,289530
2015-05-13,49.2 ( 0 %),409,978880,2393.35,295,837860,2840,141020
2015-05-12,49.2 ( -1.01 %),335,616870,1841.4,218,574310,2634,42560
2015-05-11,49.7 ( -0.4 %),264,488960,1852.12,256,668180,2610,-179220
2015-05-08,49.9 ( 0 %),207,546750,2641.3,319,707250,2217,-160500
2015-05-07,49.9 ( 0.6 %),250,644780,2579.12,371,849800,2291,-205020
2015-05-06,49.6 ( -0.8 %),358,967290,2701.93,320,900650,2815,66640
2015-05-05,50 ( 1.21 %),450,1387020,3082.27,331,922300,2786,464720
2015-05-04,49.4 ( -4.08 %),505,1425630,2823.03,586,1940260,3311,-514630
2015-04-27,51.5 ( 1.98 %),421,1451600,3447.98,712,1669210,2344,-217610
2015-04-24,50.5 ( 0 %),233,769640,3303.18,390,806930,2069,-37290
2015-04-23,50.5 ( 1 %),313,1025530,3276.45,531,1411730,2659,-386200
2015-04-22,50 ( 0 %),274,928750,3389.6,562,1625190,2892,-696440
2015-04-21,50 ( -0.99 %),300,485930,1619.77,437,994550,2276,-508620
2015-04-20,50.5 ( -0.98 %),324,690140,2130.06,527,1283810,2436,-593670
2015-04-17,51 ( 4.51 %),892,2389960,2679.33,1181,2877850,2437,-487890
2015-04-16,48.8 ( -0.2 %),188,249150,1325.27,235,394440,1678,-145290
2015-04-15,48.9 ( 0.41 %),235,496550,2112.98,183,401570,2194,94980
2015-04-14,48.7 ( -1.02 %),167,285950,1712.28,221,497340,2250,-211390
2015-04-13,49.2 ( 0 %),146,277810,1902.81,215,349690,1626,-71880
2015-04-10,49.2 ( 0.61 %),243,611410,2516.09,261,535170,2050,76240
2015-04-09,48.9 ( 0 %),188,454700,2418.62,158,431570,2731,23130
2015-04-08,48.9 ( 0 %),131,286610,2187.86,182,329030,1808,-42420
2015-04-07,48.9 ( 0.82 %),183,383300,2094.54,168,297410,1770,85890
2015-04-06,48.5 ( -0.61 %),205,298790,1457.51,205,419050,2044,-120260
2015-04-03,48.8 ( 1.46 %),195,349860,1794.15,164,278200,1696,71660
2015-04-02,48.1 ( 0.84 %),257,379350,1476.07,158,332360,2104,46990
2015-04-01,47.7 ( -1.45 %),309,434610,1406.5,198,462810,2337,-28200
2015-03-31,48.4 ( 0 %),290,383730,1323.21,171,421410,2464,-37680
2015-03-30,48.4 ( -1.63 %),272,659930,2426.21,257,780740,3038,-120810
2015-03-27,49.2 ( -0.2 %),164,391100,2384.76,256,460260,1798,-69160
2015-03-26,49.3 ( 0.2 %),214,598550,2796.96,235,519150,2209,79400
2015-03-25,49.2 ( 0.2 %),210,601180,2862.76,226,465510,2060,135670
2015-03-24,49.1 ( -0.61 %),374,633290,1693.29,230,654280,2845,-20990
2015-03-23,49.4 ( -0.8 %),201,455830,2267.81,310,745560,2405,-289730
2015-03-20,49.8 ( 0.61 %),255,629200,2467.45,346,757630,2190,-128430
2015-03-19,49.5 ( -0.2 %),204,456340,2236.96,356,793010,2228,-336670
2015-03-18,49.6 ( -0.8 %),217,439010,2023.09,385,770580,2002,-331570
2015-03-17,50 ( 1.21 %),289,1178690,4078.51,680,1423080,2093,-244390
2015-03-16,49.4 ( 0.41 %),171,386160,2258.25,247,415010,1680,-28850
2015-03-13,49.2 ( 0 %),225,457240,2032.18,233,559100,2400,-101860
2015-03-12,49.2 ( -0.61 %),255,544570,2135.57,208,653680,3143,-109110
2015-03-11,49.5 ( -0.4 %),184,595980,3239.02,247,621150,2515,-25170
2015-03-10,49.7 ( 1.02 %),269,989050,3676.77,268,776580,2898,212470
2015-03-09,49.2 ( -1.6 %),281,604060,2149.68,378,884160,2339,-280100
2015-03-06,50 ( 0 %),258,678870,2631.28,415,773710,1864,-94840
2015-03-05,50 ( 0 %),390,885550,2270.64,634,1129820,1782,-244270
2015-03-04,50 ( 2.25 %),619,1890260,3053.73,780,1420050,1821,470210
2015-03-03,48.9 ( 0.82 %),191,624700,3270.68,232,391170,1686,233530
2015-03-02,48.5 ( -0.61 %),310,701650,2263.39,229,675920,2952,25730
2015-02-27,48.8 ( -0.41 %),276,501630,1817.5,310,713150,2300,-211520
2015-02-26,49 ( 1.03 %),219,607900,2775.8,257,388990,1514,218910
2015-02-25,48.5 ( -0.21 %),315,892800,2834.29,336,850420,2531,42380
2015-02-24,48.6 ( 1.25 %),249,565210,2269.92,261,539740,2068,25470
2015-02-13,48 ( 0.42 %),190,458080,2410.95,208,369780,1778,88300
2015-02-12,47.8 ( 0.63 %),250,687750,2751,302,776460,2571,-88710
2015-02-11,47.5 ( 0.85 %),187,393320,2103.32,120,260460,2170,132860
2015-02-10,47.1 ( -0.21 %),207,360260,1740.39,178,449040,2523,-88780
2015-02-09,47.2 ( -0.21 %),169,245690,1453.79,234,441390,1886,-195700
2015-02-06,47.3 ( 0.21 %),153,305400,1996.08,195,403850,2071,-98450
2015-02-05,47.2 ( 0.64 %),247,511640,2071.42,232,454730,1960,56910
2015-02-04,46.9 ( -0.21 %),266,637270,2395.75,231,702210,3040,-64940
2015-02-03,47 ( -0.84 %),223,346690,1554.66,186,382920,2059,-36230
2015-02-02,47.4 ( -0.21 %),208,398420,1915.48,199,582370,2926,-183950
2015-01-30,47.5 ( -0.84 %),338,878830,2600.09,252,997310,3958,-118480
2015-01-29,47.9 ( 0 %),235,470570,2002.43,205,582360,2841,-111790
2015-01-28,47.9 ( -0.21 %),277,527570,1904.58,194,552580,2848,-25010
2015-01-27,48 ( -0.83 %),281,618750,2201.96,284,818590,2882,-199840
2015-01-26,48.4 ( 0 %),238,700650,2943.91,300,724120,2414,-23470
2015-01-23,48.4 ( 0.41 %),267,680580,2548.99,260,650930,2504,29650
2015-01-22,48.2 ( -0.41 %),245,463120,1890.29,262,783610,2991,-320490
2015-01-21,48.4 ( 0.83 %),285,1122890,3939.96,510,1231460,2415,-108570
2015-01-20,48 ( 0 %),287,597320,2081.25,235,729490,3104,-132170
2015-01-19,48 ( -1.03 %),315,467720,1484.83,251,789610,3146,-321890
2015-01-16,48.5 ( -0.41 %),161,304460,1891.06,269,583310,2168,-278850
2015-01-15,48.7 ( 0.21 %),255,504660,1979.06,302,667070,2209,-162410
2015-01-14,48.6 ( -0.21 %),261,630280,2414.87,332,832550,2508,-202270
2015-01-13,48.7 ( 0.21 %),245,522600,2133.06,312,669930,2147,-147330
2015-01-12,48.6 ( 0.62 %),349,1126690,3228.34,690,1279810,1855,-153120
2015-01-09,48.3 ( 0.84 %),273,602660,2207.55,335,711450,2124,-108790
2015-01-08,47.9 ( -1.03 %),284,377110,1327.85,229,567970,2480,-190860
2015-01-07,48.4 ( 0.62 %),336,629630,1873.9,472,839600,1779,-209970
2015-01-06,48.1 ( 0.63 %),275,723770,2631.89,254,524480,2065,199290
2015-01-05,47.8 ( -0.42 %),300,493430,1644.77,299,522310,1747,-28880
2014-12-31,48 ( 3.67 %),321,795880,2479.38,503,696950,1386,98930
2014-12-30,46.3 ( 0.87 %),297,744110,2505.42,190,484580,2550,259530
2014-12-29,45.9 ( -0.65 %),233,397600,1706.44,225,459370,2042,-61770
2014-12-26,46.2 ( -0.65 %),314,653800,2082.17,206,532060,2583,121740
2014-12-25,46.5 ( -0.85 %),206,300550,1458.98,154,281300,1827,19250
2014-12-24,46.9 ( 0 %),246,328010,1333.37,269,415580,1545,-87570
2014-12-23,46.9 ( 1.3 %),288,579960,2013.75,366,494600,1351,85360
2014-12-22,46.3 ( 1.54 %),260,563850,2168.65,239,486300,2035,77550
2014-12-19,45.6 ( -1.3 %),376,623860,1659.2,315,774110,2457,-150250
2014-12-18,46.2 ( 2.21 %),396,944180,2384.29,345,591990,1716,352190
2014-12-17,45.2 ( -4.24 %),703,1745890,2483.49,450,1626030,3613,119860
2014-12-16,47.2 ( -1.26 %),318,819980,2578.55,302,996040,3298,-176060
2014-12-15,47.8 ( -0.62 %),209,472660,2261.53,201,521380,2594,-48720
2014-12-12,48.1 ( 1.48 %),335,960970,2868.57,301,506530,1683,454440
2014-12-11,47.4 ( -0.63 %),329,694420,2110.7,199,568820,2858,125600
2014-12-10,47.7 ( 1.06 %),522,1020350,1954.69,294,668750,2275,351600
2014-12-09,47.2 ( -2.28 %),460,1107060,2406.65,414,1460090,3527,-353030
2014-12-08,48.3 ( -0.82 %),291,424070,1457.29,241,603000,2502,-178930
2014-12-05,48.7 ( 0.21 %),318,587450,1847.33,299,559150,1870,28300
2014-12-04,48.6 ( 0.83 %),360,722790,2007.75,357,650870,1823,71920
2014-12-03,48.2 ( 1.05 %),388,718530,1851.88,300,463230,1544,255300
2014-12-02,47.7 ( -0.21 %),471,704160,1495.03,256,600820,2347,103340
2014-12-01,47.8 ( -0.62 %),439,683530,1557.02,263,701170,2666,-17640
2014-11-28,48.1 ( -1.23 %),599,794400,1326.21,292,1051960,3603,-257560
2014-11-27,48.7 ( -0.2 %),407,542880,1333.86,293,699570,2388,-156690
2014-11-26,48.8 ( -0.81 %),323,484210,1499.1,313,581710,1858,-97500
2014-11-25,49.2 ( 0.82 %),332,517310,1558.16,224,354460,1582,162850
2014-11-24,48.8 ( -0.61 %),484,793340,1639.13,272,586280,2155,207060
2014-11-21,49.1 ( 0.2 %),461,780050,1692.08,337,893010,2650,-112960
2014-11-20,49 ( 0 %),479,649610,1356.18,232,765640,3300,-116030
2014-11-19,49 ( -0.2 %),613,956080,1559.67,290,1182740,4078,-226660
2014-11-18,49.1 ( -1.6 %),459,476690,1038.54,325,922930,2840,-446240
2014-11-17,49.9 ( -0.2 %),305,545200,1787.54,312,880520,2822,-335320
2014-11-14,50 ( -0.99 %),461,834450,1810.09,403,1047900,2600,-213450
2014-11-13,50.5 ( 0 %),327,679750,2078.75,447,953720,2134,-273970
2014-11-12,50.5 ( -0.98 %),259,415030,1602.43,388,810840,2090,-395810
2014-11-11,51 ( 0.99 %),254,517270,2036.5,386,702780,1821,-185510
2014-11-10,50.5 ( 0 %),360,827450,2298.47,412,957740,2325,-130290
2014-11-07,50.5 ( 1 %),337,463730,1376.05,263,704350,2678,-240620
2014-11-06,50 ( -0.99 %),393,612790,1559.26,327,923780,2825,-310990
2014-11-05,50.5 ( -0.98 %),354,758690,2143.19,378,965470,2554,-206780
2014-11-04,51 ( -0.97 %),294,622400,2117.01,485,1242540,2562,-620140
2014-11-03,51.5 ( 0.98 %),305,877500,2877.05,541,910930,1684,-33430
2014-10-31,51 ( 2 %),267,807330,3023.71,411,735500,1790,71830
2014-10-30,50 ( 0 %),319,999970,3134.7,552,1099120,1991,-99150
2014-10-29,50 ( 2.04 %),383,905690,2364.73,386,705100,1827,200590
2014-10-28,49 ( 0.62 %),478,886990,1855.63,283,548420,1938,338570
2014-10-27,48.7 ( -2.21 %),541,889120,1643.48,413,1083690,2624,-194570
2014-10-24,49.8 ( -0.2 %),468,847240,1810.34,394,1008940,2561,-161700
2014-10-23,49.9 ( -1.19 %),413,880790,2132.66,423,1369320,3237,-488530
2014-10-22,50.5 ( 1 %),369,913420,2475.39,338,827990,2450,85430
2014-10-21,50 ( 0 %),445,625770,1406.22,342,776090,2269,-150320
2014-10-20,50 ( -0.99 %),372,712730,1915.94,408,1163910,2853,-451180
2014-10-17,50.5 ( 1.61 %),767,1562170,2036.73,486,1604740,3302,-42570
2014-10-16,49.7 ( -4.42 %),1034,2139230,2068.89,705,2905850,4122,-766620
2014-10-15,52 ( 0 %),710,1309620,1844.54,498,1644590,3302,-334970
2014-10-14,52 ( -2.8 %),399,833970,2090.15,598,1816810,3038,-982840
2014-10-13,53.5 ( 2.88 %),474,1360870,2871.03,411,1090820,2654,270050
2014-10-10,52 ( -0.95 %),737,1786110,2423.49,469,1843730,3931,-57620
2014-10-09,52.5 ( -0.94 %),598,1419850,2374.33,489,1895390,3876,-475540
2014-10-08,53 ( -0.93 %),566,1210860,2139.33,510,1707640,3348,-496780
2014-10-07,53.5 ( 0 %),527,1840270,3491.97,642,2005690,3124,-165420
2014-10-06,53.5 ( 0 %),623,1387380,2226.93,491,1617150,3294,-229770
2014-10-03,53.5 ( -0.93 %),618,1610490,2605.97,593,1974440,3330,-363950
2014-10-02,54 ( 0.93 %),491,1587290,3232.77,614,1758120,2863,-170830
2014-10-01,53.5 ( 2.88 %),732,2415090,3299.3,520,1377900,2650,1037190
2014-09-30,52 ( 0 %),753,1984110,2634.94,473,1713150,3622,270960
2014-09-29,52 ( -0.95 %),659,1519090,2305.14,433,1530730,3535,-11640
2014-09-26,52.5 ( -1.87 %),608,1377460,2265.56,525,1900950,3621,-523490
2014-09-25,53.5 ( 1.9 %),894,2254920,2522.28,587,1912560,3258,342360
2014-09-24,52.5 ( 0 %),904,2473770,2736.47,595,2054400,3453,419370
2014-09-23,52.5 ( -0.94 %),894,2528070,2827.82,594,2159810,3636,368260
2014-09-22,53 ( -1.85 %),907,2265810,2498.14,585,2609880,4461,-344070
2014-09-19,54 ( -1.82 %),1025,2451650,2391.85,626,2714710,4337,-263060
2014-09-18,55 ( -2.65 %),968,2654960,2742.73,835,3548600,4250,-893640
2014-09-17,56.5 ( 0.89 %),858,3399920,3962.61,1157,3893830,3365,-493910
2014-09-16,56 ( 0 %),0,0,0,0,0,0,0
2014-09-15,56 ( 0 %),814,2703060,3320.71,878,3367610,3836,-664550
2014-09-12,56 ( 0.9 %),928,2860210,3082.12,608,2352900,3870,507310
2014-09-11,55.5 ( -0.89 %),696,1718700,2469.4,547,2173460,3973,-454760
2014-09-10,56 ( 0.9 %),1224,4033910,3295.68,758,3299720,4353,734190
2014-09-09,55.5 ( -5.13 %),1762,5907230,3352.57,1479,7225960,4886,-1318730
2014-09-08,58.5 ( 0.86 %),907,3841650,4235.56,1063,3985230,3749,-143580
2014-09-05,58 ( 1.75 %),877,3758240,4285.34,940,3509380,3733,248860
2014-09-04,57 ( 0 %),835,2634250,3154.79,883,3592080,4068,-957830
2014-09-03,57 ( -0.87 %),979,2777880,2837.47,1044,3958980,3792,-1181100
2014-08-29,57.5 ( 0.88 %),1042,2928940,2810.88,992,3309290,3336,-380350
2014-08-28,57 ( 3.64 %),1296,5703520,4400.86,1467,4545850,3099,1157670
2014-08-27,55 ( 0 %),888,3749850,4222.8,1201,4112140,3424,-362290
2014-08-26,55 ( 4.76 %),1784,6945090,3892.99,1789,6482020,3623,463070
2014-08-25,52.5 ( 0.96 %),898,3240130,3608.16,858,3717800,4333,-477670
2014-08-22,52 ( 0.97 %),920,3444160,3743.65,767,3652630,4762,-208470
2014-08-21,51.5 ( -0.96 %),873,2874480,3292.65,759,3281230,4323,-406750
2014-08-20,52 ( -1.89 %),857,2278880,2659.14,635,3123220,4918,-844340
2014-08-19,53 ( 0.95 %),1197,4885830,4081.73,1641,5901290,3596,-1015460
2014-08-18,52.5 ( 1.94 %),791,3155970,3989.85,905,2774400,3066,381570
2014-08-15,51.5 ( -0.96 %),533,1842220,3456.32,702,2432280,3465,-590060
2014-08-14,52 ( 0.97 %),713,2367970,3321.14,922,2787960,3024,-419990
2014-08-13,51.5 ( 1.98 %),582,1780140,3058.66,636,1679280,2640,100860
2014-08-12,50.5 ( 0 %),535,1636980,3059.78,587,2086650,3555,-449670
2014-08-11,50.5 ( 0 %),503,1237140,2459.52,647,2231300,3449,-994160
2014-08-08,50.5 ( 0 %),550,1605040,2918.25,663,2095970,3161,-490930
2014-08-07,50.5 ( -0.98 %),671,1522950,2269.67,534,2040460,3821,-517510
2014-08-06,51 ( -0.97 %),789,1916600,2429.15,766,2783500,3634,-866900
2014-08-05,51.5 ( 3 %),837,2845560,3399.71,974,3337430,3427,-491870
2014-08-04,50 ( 0.4 %),497,1253970,2523.08,488,1526970,3129,-273000
2014-08-01,49.8 ( -1.39 %),536,1097590,2047.74,531,2166080,4079,-1068490
2014-07-31,50.5 ( 1.2 %),575,1565630,2722.83,471,1746290,3708,-180660
2014-07-30,49.9 ( 0.4 %),548,1490370,2719.65,598,1859180,3109,-368810
2014-07-29,49.7 ( -0.6 %),0,0,0,0,0,0,0
2014-07-28,50 ( -2.91 %),979,2340750,2390.96,867,3521890,4062,-1181140
2014-07-25,51.5 ( -1.9 %),668,2019270,3022.86,904,3387380,3747,-1368110
2014-07-24,52.5 ( 1.94 %),798,3267180,4094.21,798,2671440,3348,595740
2014-07-23,51.5 ( -0.96 %),594,2305380,3881.11,792,2958420,3735,-653040
2014-07-22,52 ( 1.96 %),846,2941590,3477.06,981,2892670,2949,48920
2014-07-21,51 ( -2.86 %),1004,2867570,2856.15,1258,3587880,2852,-720310
2014-07-18,52.5 ( 6.28 %),1737,7204570,4147.71,1590,5312030,3341,1892540
2014-07-17,49.4 ( -1 %),711,1356960,1908.52,637,2070750,3251,-713790
2014-07-16,49.9 ( -0.2 %),471,1460070,3099.94,991,3013250,3041,-1553180
2014-07-15,50 ( 1.21 %),498,1343980,2698.76,809,1939340,2397,-595360
2014-07-14,49.4 ( 1.44 %),635,1704890,2684.87,433,1352130,3123,352760
2014-07-11,48.7 ( -0.2 %),730,1553180,2127.64,440,1396570,3174,156610
2014-07-10,48.8 ( -1.81 %),943,1797250,1905.89,823,2396280,2912,-599030
2014-07-09,49.7 ( -0.4 %),517,1095390,2118.74,587,1540160,2624,-444770
2014-07-08,49.9 ( -0.2 %),607,1321540,2177.17,770,1806230,2346,-484690
2014-07-07,50 ( 1.01 %),805,2622890,3258.25,1050,3311820,3154,-688930
2014-07-04,49.5 ( 2.7 %),1196,3814600,3189.46,1086,2893540,2664,921060
2014-07-03,48.2 ( 2.55 %),763,2452190,3213.88,1000,2931790,2932,-479600
2014-07-02,47 ( 0.64 %),396,1107260,2796.11,510,1201050,2355,-93790
2014-07-01,46.7 ( 0.21 %),381,1035740,2718.48,533,1169390,2194,-133650
2014-06-30,46.6 ( -0.43 %),365,799260,2189.75,417,888890,2132,-89630
2014-06-27,46.8 ( 0.65 %),977,2455260,2513.06,1239,2623940,2118,-168680
2014-06-25,46.6 ( 0.87 %),294,841750,2863.1,537,1238350,2306,-396600
2014-06-24,46.2 ( 0.65 %),403,662760,1644.57,285,553160,1941,109600
2014-06-23,45.9 ( -0.65 %),355,429500,1209.86,208,481720,2316,-52220
2014-06-20,46.2 ( 0 %),390,682060,1748.87,345,636980,1846,45080
2014-06-19,46.2 ( -0.86 %),1266,2188840,1728.94,528,1623600,3075,565240
2014-06-18,46.6 ( -0.64 %),281,486940,1732.88,400,881180,2203,-394240
2014-06-17,46.9 ( 0.86 %),515,1546580,3003.07,481,1207790,2511,338790
2014-06-16,46.5 ( -1.06 %),657,1463740,2227.91,460,1503160,3268,-39420
2014-06-13,47 ( -0.21 %),343,1001470,2919.74,493,975110,1978,26360
2014-06-12,47.1 ( 1.29 %),824,1877550,2278.58,861,1999770,2323,-122220
2014-06-11,46.5 ( 3.56 %),882,2510940,2846.87,853,2106400,2469,404540
2014-06-10,44.9 ( 0 %),536,1124110,2097.22,559,1399850,2504,-275740
2014-06-09,44.9 ( -0.22 %),542,940670,1735.55,411,1143110,2781,-202440
2014-06-06,45 ( 1.81 %),430,908570,2112.95,242,600790,2483,307780
2014-06-05,44.2 ( -0.45 %),636,940720,1479.12,261,670740,2570,269980
2014-06-04,44.4 ( -1.77 %),644,1125290,1747.34,403,1298790,3223,-173500
2014-06-03,45.2 ( -0.44 %),452,815600,1804.42,264,744950,2822,70650
2014-06-02,45.4 ( -1.73 %),631,1105700,1752.3,369,1140430,3091,-34730
2014-05-30,0 ( 0 %),460,1277230,2776.59,515,1474050,2862,-196820
2014-05-29,46.1 ( 0.22 %),685,1696150,2476.13,767,2110250,2751,-414100
2014-05-28,46 ( 0.88 %),502,1257750,2505.48,569,1375530,2417,-117780
2014-05-27,45.6 ( 0.88 %),550,1534370,2789.76,554,1554750,2806,-20380
2014-05-26,45.2 ( -0.44 %),571,1206670,2113.26,415,1230270,2965,-23600
2014-05-23,45.4 ( -0.87 %),542,1212740,2237.53,503,1162220,2311,50520
2014-05-22,45.8 ( -0.87 %),907,2088500,2302.65,693,2367980,3417,-279480
2014-05-21,46.2 ( 4.05 %),1111,2805490,2525.19,863,2249970,2607,555520
2014-05-20,44.4 ( 0.91 %),771,1727740,2240.91,526,1528520,2906,199220
2014-05-19,44 ( 0 %),703,2199490,3128.72,638,1838880,2882,360610
2014-05-16,44 ( 6.02 %),868,2298570,2648.12,742,1854210,2499,444360
2014-05-15,41.5 ( -3.94 %),1180,2591340,2196.05,846,2389300,2824,202040
2014-05-14,43.2 ( 5.88 %),795,1836420,2309.96,699,1652250,2364,184170
2014-05-13,40.8 ( -5.34 %),1164,2754000,2365.98,940,3107910,3306,-353910
2014-05-12,43.1 ( -6.91 %),683,1333260,1952.06,759,3179450,4189,-1846190
2014-05-09,46.3 ( -2.53 %),1276,2441370,1913.3,713,2555540,3584,-114170
2014-05-08,47.5 ( -6.86 %),848,2068550,2439.33,960,4897830,5102,-2829280
2014-05-07,51 ( 0.39 %),736,1626120,2209.4,561,2340720,4172,-714600
2014-05-06,65 ( -1.52 %),1209,2653200,2194.54,613,2747450,4482,-94250
2014-05-05,66 ( -3.65 %),821,1698620,2068.96,613,2950910,4814,-1252290
2014-04-29,68.5 ( 0 %),643,1287960,2003.05,373,1275480,3420,12480
2014-04-28,68.5 ( 1.48 %),860,1871880,2176.6,557,1794030,3221,77850
2014-04-25,67.5 ( 3.05 %),908,3053750,3363.16,553,2298610,4157,755140
2014-04-24,65.5 ( 0 %),781,2415820,3093.24,418,2093050,5007,322770
2014-04-23,65.5 ( -2.24 %),631,1327430,2103.69,458,1970990,4303,-643560
2014-04-22,67 ( 3.08 %),837,2569710,3070.14,599,2316920,3868,252790
2014-04-21,65 ( -3.7 %),792,1803850,2277.59,605,2369020,3916,-565170
2014-04-18,67.5 ( -3.57 %),657,2136660,3252.15,631,2796110,4431,-659450
2014-04-17,70 ( 1.45 %),681,2220560,3260.73,474,1904300,4018,316260
2014-04-16,69 ( -2.13 %),847,3080100,3636.48,655,2845030,4344,235070
2014-04-15,70.5 ( -1.4 %),692,2649430,3828.66,783,3064110,3913,-414680
2014-04-14,71.5 ( 1.42 %),1037,3726190,3593.24,1025,3423840,3340,302350
2014-04-11,70.5 ( 0.71 %),909,2923500,3216.17,581,2127280,3661,796220
2014-04-10,70 ( -0.71 %),692,1940990,2804.9,614,2533990,4127,-593000
2014-04-08,70.5 ( 1.44 %),1109,4948190,4461.85,1134,4208330,3711,739860
2014-04-07,69.5 ( 2.21 %),709,2621490,3697.45,507,2020260,3985,601230
2014-04-04,68 ( -0.73 %),513,1530040,2982.53,535,2303340,4305,-773300
2014-04-03,68.5 ( 0.74 %),544,1264710,2324.83,489,1617250,3307,-352540
2014-04-02,68 ( -1.45 %),909,3001170,3301.62,764,2926000,3830,75170
2014-04-01,69 ( -1.43 %),632,1522160,2408.48,509,1761800,3461,-239640
2014-03-31,70 ( -0.71 %),567,1548240,2730.58,642,2028610,3160,-480370
2014-03-28,70.5 ( 3.68 %),760,3331150,4383.09,644,2074490,3221,1256660
2014-03-27,68 ( 0 %),760,2115630,2783.72,536,2502240,4668,-386610
2014-03-26,68 ( -2.16 %),877,2569100,2929.42,649,2988520,4605,-419420
2014-03-25,69.5 ( -2.11 %),711,1834390,2580.01,586,2110630,3602,-276240
2014-03-24,71 ( -0.7 %),662,1510210,2281.28,491,1829540,3726,-319330
2014-03-21,71.5 ( 0.7 %),579,2379810,4110.21,553,1853850,3352,525960
2014-03-20,71 ( -1.39 %),646,1960610,3035,747,2583980,3459,-623370
2014-03-19,72 ( 1.41 %),592,2650660,4477.47,582,2073190,3562,577470
2014-03-18,71 ( 5.19 %),1136,4762610,4192.44,980,3181350,3246,1581260
2014-03-17,67.5 ( 0 %),724,1802470,2489.6,516,1836500,3559,-34030
2014-03-14,67.5 ( -0.74 %),918,2632260,2867.39,622,2881810,4633,-249550
2014-03-13,68 ( 0.74 %),794,2058800,2592.95,579,2153480,3719,-94680
2014-03-12,67.5 ( 0.75 %),1360,3299410,2426.04,1019,4338100,4257,-1038690
2014-03-11,67 ( 5.51 %),1215,4131910,3400.75,883,3198570,3622,933340
2014-03-10,63.5 ( 0.79 %),395,1213260,3071.54,341,1140370,3344,72890
2014-03-07,63 ( 0.8 %),548,2250240,4106.28,468,1801220,3849,449020
2014-03-06,62.5 ( 0.81 %),452,815600,1804.42,264,744950,2822,70650
2014-03-05,62 ( 1.64 %),502,1302720,2595.06,302,1327760,4397,-25040
2014-03-04,61 ( -0.81 %),816,2308660,2829.24,405,1719320,4245,589340
2014-03-03,61.5 ( -3.91 %),810,2078240,2565.73,641,2493740,3890,-415500
2014-02-28,64 ( 1.59 %),784,2607010,3325.27,523,1798670,3439,808340
2014-02-27,63 ( -2.33 %),828,2111900,2550.6,552,1990480,3606,121420
2014-02-26,64.5 ( 4.88 %),1436,4391890,3058.42,644,3499760,5434,892130
2014-02-25,61.5 ( 3.36 %),933,3017910,3234.63,543,2415440,4448,602470
2014-02-24,59.5 ( 2.59 %),520,1671760,3214.92,354,1443410,4077,228350
2014-02-21,58 ( 1.75 %),511,1535920,3005.71,375,1893120,5048,-357200
2014-02-20,57 ( -3.39 %),589,1708910,2901.38,501,2165680,4323,-456770
2014-02-19,59 ( 3.51 %),553,2058380,3722.21,341,1409400,4133,648980
2014-02-18,57 ( 1.79 %),403,1204500,2988.83,252,892550,3542,311950
2014-02-17,56 ( -0.88 %),348,806850,2318.53,250,786330,3145,20520
2014-02-14,56.5 ( -0.88 %),369,903450,2448.37,298,1193210,4004,-289760
2014-02-13,57 ( 0 %),313,1013010,3236.45,298,1322240,4437,-309230
2014-02-12,57 ( 3.64 %),483,2123390,4396.25,376,1296440,3448,826950
2014-02-11,55 ( -0.9 %),522,1826260,3498.58,392,1778830,4538,47430
2014-02-10,55.5 ( 3.74 %),418,1446720,3461.05,347,1103080,3179,343640
2014-02-07,53.5 ( -1.83 %),316,1023220,3238.04,334,1211310,3627,-188090
2014-02-06,54.5 ( -1.8 %),311,922470,2966.14,252,969790,3848,-47320
2014-01-27,55.5 ( -0.89 %),309,1263190,4087.99,232,1072270,4622,190920
2014-01-24,56 ( 2.75 %),463,1895670,4094.32,346,1276450,3689,619220
2014-01-23,54.5 ( 2.83 %),279,1364220,4889.68,372,1168420,3141,195800
2014-01-22,53 ( 0 %),264,1291650,4892.61,448,1328390,2965,-36740
2014-01-21,53 ( 1.92 %),277,1375870,4967.04,423,1004400,2374,371470
2014-01-20,52 ( 0.97 %),416,1708040,4105.87,512,1538380,3005,169660
2014-01-17,51.5 ( 1.98 %),492,2349300,4775,504,1769450,3511,579850
2014-01-16,50.5 ( 1 %),395,1280210,3241.04,409,1666180,4074,-385970
2014-01-15,50 ( 1.63 %),594,2306230,3882.54,529,2123250,4014,182980
2014-01-14,49.2 ( 0.2 %),285,1338860,4697.75,362,1243890,3436,94970
2014-01-13,49.1 ( 0.82 %),244,1039930,4262.01,349,1257170,3602,-217240
2014-01-10,48.7 ( 0.62 %),320,1090060,3406.44,499,1708880,3425,-618820
2014-01-09,48.4 ( 1.26 %),227,820630,3615.11,283,570730,2017,249900
2014-01-08,47.8 ( 0.63 %),119,289200,2430.25,184,425940,2315,-136740
2014-01-07,47.5 ( -1.04 %),185,461170,2492.81,238,611250,2568,-150080
2014-01-06,48 ( 1.48 %),226,529430,2342.61,165,430450,2609,98980
2014-01-03,47.3 ( -0.21 %),171,345480,2020.35,113,346930,3070,-1450
2014-01-02,47.4 ( 0.64 %),152,342530,2253.49,265,625980,2362,-283450
2013-12-31,47.1 ( 0.86 %),356,1080000,3033.71,273,1158830,4245,-78830
2013-12-30,46.7 ( -0.85 %),193,579310,3001.61,199,754040,3789,-174730
2013-12-27,47.1 ( 0 %),118,276280,2341.36,146,475100,3254,-198820
2013-12-26,47.1 ( 0.64 %),184,667530,3627.88,208,844000,4058,-176470
2013-12-25,46.8 ( -0.21 %),170,415640,2444.94,125,520280,4162,-104640
2013-12-24,46.9 ( -0.64 %),162,306000,1888.89,120,489720,4081,-183720
2013-12-23,47.2 ( 0.43 %),159,277290,1743.96,148,406340,2746,-129050
2013-12-20,47 ( -0.63 %),150,236950,1579.67,154,397060,2578,-160110
2013-12-19,47.3 ( 0 %),159,390400,2455.35,187,578090,3091,-187690
2013-12-18,47.3 ( 0.21 %),127,335330,2640.39,120,289410,2412,45920
2013-12-17,47.2 ( 0 %),106,199900,1885.85,116,245130,2113,-45230
2013-12-16,47.2 ( 0 %),144,337170,2341.46,136,376160,2766,-38990
2013-12-13,47.2 ( 0.85 %),216,524790,2429.58,181,480300,2654,44490
2013-12-12,46.8 ( 0 %),266,535910,2014.7,168,600900,3577,-64990
2013-12-11,46.8 ( -0.85 %),281,695610,2475.48,164,650510,3967,45100
2013-12-10,47.2 ( -0.63 %),318,548640,1725.28,208,717640,3450,-169000
2013-12-09,47.5 ( -1.04 %),281,492900,1754.09,208,749730,3604,-256830
2013-12-06,48 ( -0.21 %),388,930680,2398.66,253,956200,3779,-25520
2013-12-05,48.1 ( -1.43 %),387,1054840,2725.68,287,1264450,4406,-209610
2013-12-04,48.8 ( 0 %),216,742800,3438.89,217,942820,4345,-200020
2013-12-03,48.8 ( 1.04 %),508,1966060,3870.2,353,1694960,4802,271100
2013-12-02,48.3 ( 0.42 %),204,606360,2972.35,155,447480,2887,158880
2013-11-29,48.1 ( -0.62 %),157,313720,1998.22,134,369810,2760,-56090
2013-11-28,48.4 ( -0.41 %),158,430720,2726.08,151,334410,2215,96310
2013-11-27,48.6 ( 0 %),143,322810,2257.41,179,463030,2587,-140220
2013-11-26,48.6 ( 0 %),244,577710,2367.66,154,453940,2948,123770
2013-11-25,48.6 ( 0.21 %),242,732500,3026.86,246,746440,3034,-13940
2013-11-22,48.5 ( 1.04 %),236,656170,2780.38,219,412230,1882,243940
2013-11-21,48 ( -0.21 %),308,826220,2682.53,268,763130,2848,63090
2013-11-20,48.1 ( -0.41 %),268,579170,2161.08,192,449540,2341,129630
2013-11-19,48.3 ( 0.42 %),215,668110,3107.49,209,516890,2473,151220
2013-11-18,48.1 ( 1.05 %),331,909000,2746.22,299,852330,2851,56670
2013-11-15,47.6 ( 2.81 %),406,1273610,3136.97,374,1073900,2871,199710
2013-11-14,46.3 ( 0.22 %),94,257630,2740.74,145,314210,2167,-56580
2013-11-13,46.2 ( -0.22 %),106,249980,2358.3,123,228080,1854,21900
2013-11-12,46.3 ( 0.43 %),170,445600,2621.18,243,540280,2223,-94680
2013-11-11,46.1 ( 0.22 %),134,320460,2391.49,142,282920,1992,37540
2013-11-08,46 ( 0.44 %),105,314550,2995.71,128,234650,1833,79900
2013-11-07,45.8 ( -0.65 %),148,349180,2359.32,152,348160,2291,1020
2013-11-06,46.1 ( 0.44 %),133,239240,1798.8,143,290710,2033,-51470
2013-11-05,45.9 ( -0.22 %),127,278320,2191.5,146,329020,2254,-50700
2013-11-04,46 ( 0 %),129,161770,1254.03,134,238590,1781,-76820
2013-11-01,46 ( 0.44 %),104,274600,2640.38,135,329950,2444,-55350
2013-10-31,45.8 ( -0.43 %),96,245370,2555.94,190,322510,1697,-77140
2013-10-30,46 ( 0.88 %),169,567830,3359.94,244,583590,2392,-15760
2013-10-29,45.6 ( 0.44 %),148,295380,1995.81,131,185380,1415,110000
2013-10-28,45.4 ( -0.44 %),171,267890,1566.61,134,252690,1886,15200
2013-10-25,45.6 ( -0.87 %),168,405400,2413.1,148,480030,3243,-74630
2013-10-24,46 ( -0.43 %),162,456960,2820.74,186,484170,2603,-27210
2013-10-23,46.2 ( 0.43 %),136,414390,3046.99,177,371160,2097,43230
2013-10-22,46 ( -0.43 %),168,437240,2602.62,166,426360,2568,10880
2013-10-21,46.2 ( 0 %),185,562440,3040.22,308,627970,2039,-65530
2013-10-18,46.2 ( 0.65 %),259,919500,3550.19,427,866330,2029,53170
2013-10-17,45.9 ( 0.44 %),201,720050,3582.34,323,807390,2500,-87340
2013-10-16,45.7 ( 0.44 %),187,661970,3539.95,255,625960,2455,36010
2013-10-15,45.5 ( 1.34 %),148,493370,3333.58,141,271040,1922,222330
2013-10-14,44.9 ( -0.22 %),171,308620,1804.8,130,273140,2101,35480
2013-10-11,45 ( -0.22 %),174,287190,1650.52,161,359670,2234,-72480
2013-10-10,45.1 ( -1.31 %),254,474270,1867.2,211,498490,2363,-24220
2013-10-09,45.7 ( -0.44 %),222,371380,1672.88,210,482680,2298,-111300
2013-10-08,45.9 ( -0.43 %),228,361900,1587.28,215,528110,2456,-166210
2013-10-07,46.1 ( 1.1 %),295,580220,1966.85,280,528730,1888,51490
2013-10-04,45.6 ( 1.79 %),347,813580,2344.61,360,746720,2074,66860
2013-10-03,44.8 ( -0.67 %),210,365070,1738.43,168,378940,2256,-13870
2013-10-02,45.1 ( 0.67 %),179,517770,2892.57,209,367460,1758,150310
2013-10-01,44.8 ( -0.67 %),323,525370,1626.53,304,557360,1833,-31990
2013-09-30,45.1 ( 0.22 %),245,432900,1766.94,249,483870,1943,-50970
2013-09-27,45 ( -0.44 %),168,415030,2470.42,188,391850,2084,23180
2013-09-26,45.2 ( 0.89 %),251,506590,2018.29,214,339970,1589,166620
2013-09-25,44.8 ( -0.88 %),294,602290,2048.61,325,634310,1952,-32020
2013-09-24,45.2 ( 1.8 %),265,663230,2502.75,387,678850,1754,-15620
2013-09-23,44.4 ( 2.07 %),289,632460,2188.44,313,515320,1646,117140
2013-09-20,43.5 ( 0.23 %),89,122870,1380.56,150,165240,1102,-42370
2013-09-19,43.4 ( 0.23 %),191,376810,1972.83,200,332500,1662,44310
2013-09-18,43.3 ( 0.93 %),276,470960,1706.38,276,453560,1643,17400
2013-09-17,42.9 ( 0.47 %),246,422550,1717.68,192,437330,2278,-14780
2013-09-16,42.7 ( -0.23 %),253,314590,1243.44,158,376810,2385,-62220
2013-09-13,42.8 ( -0.47 %),238,233350,980.46,182,328650,1806,-95300
2013-09-12,43 ( -0.69 %),197,279280,1417.66,180,410920,2283,-131640
2013-09-11,43.3 ( -0.46 %),320,421640,1317.62,274,702420,2564,-280780
2013-09-10,43.5 ( 0.69 %),186,194690,1046.72,144,208570,1448,-13880
2013-09-09,43.2 ( -2.48 %),310,374050,1206.61,202,365530,1810,8520
2013-09-06,44.3 ( 1.37 %),268,617560,2304.33,310,631780,2038,-14220
2013-09-05,43.7 ( 1.86 %),285,670510,2352.67,238,457710,1923,212800
2013-09-04,42.9 ( 0.23 %),298,484040,1624.3,195,416600,2136,67440
2013-09-03,42.8 ( -0.7 %),124,191550,1544.76,128,232380,1815,-40830
2013-08-30,43.1 ( 1.17 %),269,439140,1632.49,185,456060,2465,-16920
2013-08-29,42.6 ( -0.47 %),261,470960,1804.44,216,310510,1438,160450
2013-08-28,42.8 ( -3.6 %),437,749750,1715.68,276,720500,2611,29250
2013-08-27,44.4 ( -0.45 %),189,225800,1194.71,147,271750,1849,-45950
2013-08-26,44.6 ( -0.22 %),310,448750,1447.58,183,351880,1923,96870
2013-08-23,44.7 ( -1.54 %),419,662740,1581.72,269,707880,2632,-45140
2013-08-22,45.4 ( -2.16 %),390,729260,1869.9,270,597120,2212,132140
2013-08-21,46.4 ( -0.85 %),470,827150,1759.89,285,758160,2660,68990
2013-08-20,46.8 ( -0.64 %),423,897650,2122.1,349,737020,2112,160630
2013-08-19,47.1 ( 2.39 %),459,926560,2018.65,486,907900,1868,18660
2013-08-16,46 ( 0.44 %),256,481010,1878.95,275,468680,1704,12330
2013-08-15,45.8 ( 3.62 %),539,1315620,2440.85,505,1203910,2384,111710
2013-08-14,45.7 ( 0.44 %),225,399600,1776,213,337640,1585,61960
2013-08-13,45.5 ( 0.22 %),342,712380,2082.98,342,742480,2171,-30100
2013-08-12,45.5 ( -0.22 %),269,369600,1373.98,238,477160,2005,-107560
2013-08-09,45.6 ( 0.88 %),266,433280,1628.87,226,399920,1770,33360
2013-08-08,45.2 ( -2.38 %),410,701270,1710.41,386,828080,2145,-126810
2013-08-07,46.3 ( 2.43 %),728,1384500,1901.79,491,1162400,2367,222100
2013-08-06,45.2 ( 1.57 %),447,794300,1776.96,388,805900,2077,-11600
2013-08-05,44.5 ( 3.01 %),460,922560,2005.57,449,1042010,2321,-119450
2013-08-02,43.2 ( 0.7 %),140,213710,1526.5,139,200790,1445,12920
2013-08-01,42.9 ( -0.23 %),112,179100,1599.11,108,166820,1545,12280
2013-07-31,43 ( 0 %),108,279110,2584.35,125,260450,2084,18660
2013-07-30,43 ( 1.9 %),144,282490,1961.74,100,219180,2192,63310
2013-07-29,42.2 ( -1.63 %),158,255510,1617.15,121,310270,2564,-54760
2013-07-26,42.9 ( -1.15 %),141,120620,855.46,130,245260,1887,-124640
2013-07-25,43.4 ( 0.93 %),139,258720,1861.29,161,245160,1523,13560
2013-07-24,43 ( -1.38 %),260,557360,2143.69,159,439310,2763,118050
2013-07-23,43.6 ( -0.68 %),110,260600,2369.09,151,314160,2081,-53560
2013-07-22,43.9 ( 0 %),136,127680,938.82,142,228590,1610,-100910
2013-07-19,43.9 ( 1.39 %),139,226640,1630.5,170,283990,1671,-57350
2013-07-18,43.3 ( -0.92 %),108,145890,1350.83,139,203700,1465,-57810
2013-07-17,43.7 ( 0.23 %),158,371530,2351.46,249,371940,1494,-410
2013-07-16,43.6 ( 1.16 %),137,318550,2325.18,172,254270,1478,64280
2013-07-15,43.1 ( 0.23 %),88,225150,2558.52,155,188850,1218,36300
2013-07-12,43 ( 1.42 %),124,278070,2242.5,110,177190,1611,100880
2013-07-11,42.4 ( -0.24 %),94,214530,2282.23,116,242490,2090,-27960
2013-07-10,42.5 ( -0.23 %),93,225240,2421.94,100,182240,1822,43000
2013-07-09,42.6 ( -0.93 %),143,232640,1626.85,126,304990,2421,-72350
2013-07-08,43 ( -1.38 %),105,210570,2005.43,173,415900,2404,-205330
2013-07-05,43.6 ( 0.46 %),131,517970,3953.97,162,357760,2208,160210
2013-07-04,43.4 ( 1.88 %),412,1855570,4503.81,347,918490,2647,937080
2013-07-03,42.6 ( 0.47 %),162,514520,3176.05,156,357720,2293,156800
2013-07-02,42.4 ( 0.95 %),151,312900,2072.19,113,187820,1662,125080
2013-07-01,42 ( 0.48 %),127,371110,2922.13,109,152480,1399,218630
2013-06-28,41.8 ( 0.48 %),118,269560,2284.41,110,224790,2044,44770
2013-06-27,41.6 ( 0.24 %),187,398900,2133.16,87,280570,3225,118330
2013-06-26,41.5 ( 0.24 %),132,428030,3242.65,104,330180,3175,97850
2013-06-25,41.4 ( -2.59 %),235,959070,4081.15,249,927990,3727,31080
2013-06-24,42.5 ( -0.47 %),125,336160,2689.28,128,301840,2358,34320
2013-06-21,42.7 ( -0.23 %),170,480100,2824.12,115,358770,3120,121330
2013-06-20,42.8 ( -0.47 %),125,295800,2366.4,96,276190,2877,19610
2013-06-19,43 ( 0.23 %),193,362800,1879.79,106,222680,2101,140120
2013-06-18,42.9 ( -0.69 %),164,351550,2143.6,147,383190,2607,-31640
2013-06-17,43.2 ( -2.26 %),157,424800,2705.73,194,496340,2558,-71540
2013-06-14,44.2 ( -1.12 %),237,649200,2739.24,162,453450,2799,195750
2013-06-13,44.7 ( -0.67 %),241,645530,2678.55,227,638500,2813,7030
2013-06-12,45 ( -0.44 %),191,366440,1918.53,202,386080,1911,-19640
2013-06-11,45.2 ( -0.88 %),161,372370,2312.86,227,478170,2106,-105800
2013-06-10,45.6 ( 0.22 %),174,476600,2739.08,256,594270,2321,-117670
2013-06-07,45.5 ( -0.44 %),175,313650,1792.29,235,432310,1840,-118660
2013-06-06,45.7 ( 1.11 %),179,373130,2084.53,231,367400,1590,5730
2013-06-05,45.2 ( 1.12 %),186,383130,2059.84,274,375270,1370,7860
2013-06-04,44.7 ( 0.9 %),301,1178080,3913.89,466,1056400,2267,121680
2013-06-03,44.3 ( -0.45 %),261,558250,2138.89,308,652770,2119,-94520
2013-05-31,44.5 ( 1.37 %),333,853520,2563.12,459,1195150,2604,-341630
2013-05-30,43.9 ( -0.23 %),273,507870,1860.33,289,506770,1754,1100
2013-05-29,44 ( 2.09 %),411,962070,2340.8,496,899690,1814,62380
2013-05-28,43.1 ( 0.7 %),232,615110,2651.34,320,602100,1882,13010
2013-05-27,42.8 ( 1.9 %),240,609030,2537.62,381,742310,1948,-133280
2013-05-24,42 ( 0.72 %),257,647730,2520.35,396,549640,1388,98090
2013-05-23,41.7 ( 0 %),298,995250,3339.77,399,897110,2248,98140
2013-05-22,41.7 ( -0.71 %),215,694850,3231.86,467,958690,2053,-263840
2013-05-21,42 ( 6.87 %),544,3320860,6104.52,984,2441990,2482,878870
2013-05-20,39.3 ( 2.08 %),216,642970,2976.71,416,592250,1424,50720
2013-05-17,38.5 ( -0.77 %),141,324660,2302.55,207,362210,1750,-37550
2013-05-16,38.8 ( 0 %),135,374660,2775.26,253,526100,2079,-151440
2013-05-15,38.8 ( 1.04 %),135,364600,2700.74,258,365280,1416,-680
2013-05-14,38.4 ( 1.05 %),321,757630,2360.22,432,712150,1648,45480
2013-05-13,38 ( 0.26 %),177,279820,1580.9,172,164130,954,115690
2013-05-10,37.9 ( 0.26 %),155,192280,1240.52,134,155320,1159,36960
2013-05-09,37.8 ( 0 %),124,146200,1179.03,144,201230,1397,-55030
2013-05-08,37.8 ( 0.8 %),145,341650,2356.21,197,235460,1195,106190
2013-05-07,37.5 ( -2.09 %),162,160260,989.26,219,254310,1161,-94050
2013-05-06,38.3 ( 3.23 %),197,383950,1948.98,201,266570,1326,117380
2013-05-03,37.1 ( 0.27 %),187,202830,1084.65,120,193040,1609,9790
2013-05-02,37 ( -0.54 %),139,185140,1331.94,123,207750,1689,-22610
2013-04-26,37.2 ( 0 %),150,209290,1395.27,97,127550,1315,81740
2013-04-25,37.2 ( 0.27 %),153,273510,1787.65,128,131490,1027,142020
2013-04-24,37.1 ( -0.54 %),288,405360,1407.5,149,263620,1769,141740
2013-04-23,37.3 ( 1.08 %),147,166630,1133.54,157,151250,963,15380
2013-04-22,36.9 ( -0.27 %),165,264880,1605.33,148,253090,1710,11790
2013-04-18,37 ( -2.63 %),300,254150,847.17,140,265560,1897,-11410
2013-04-17,38 ( 1.33 %),232,331790,1430.13,203,267140,1316,64650
2013-04-16,37.5 ( -0.79 %),407,367780,903.64,162,205600,1269,162180
2013-04-15,37.8 ( -3.08 %),432,913690,2115.02,250,587460,2350,326230
2013-04-12,39 ( -0.51 %),254,636090,2504.29,318,580870,1827,55220
2013-04-11,39.2 ( -1.51 %),456,617180,1353.46,310,575670,1857,41510
2013-04-10,39.8 ( -2.69 %),406,547970,1349.68,506,758570,1499,-210600
2013-04-09,40.9 ( 3.02 %),753,1452270,1928.65,881,1496050,1698,-43780
2013-04-08,39.7 ( 3.39 %),473,1556620,3290.95,545,963920,1769,592700
2013-04-05,38.4 ( 0.79 %),299,324360,1084.82,201,301100,1498,23260
2013-04-04,38.1 ( -0.78 %),144,283990,1972.15,224,360080,1608,-76090
2013-04-03,38.4 ( -0.78 %),195,341110,1749.28,254,432460,1703,-91350
2013-04-02,38.7 ( 0.78 %),305,609360,1997.9,430,839060,1951,-229700
2013-04-01,38.4 ( 1.59 %),188,306770,1631.76,204,347880,1705,-41110
2013-03-29,37.8 ( 0 %),183,421230,2301.8,158,328980,2082,92250
2013-03-28,37.8 ( 0 %),234,336340,1437.35,202,289760,1434,46580
2013-03-27,37.8 ( -1.31 %),263,346570,1317.76,195,298050,1528,48520
2013-03-26,38.3 ( -0.52 %),168,218900,1302.98,215,329470,1532,-110570
2013-03-25,38.5 ( 1.32 %),264,341800,1294.7,258,339870,1317,1930
2013-03-22,38 ( -0.52 %),450,606780,1348.4,516,795430,1542,-188650
2013-03-21,38.2 ( 2.69 %),259,572450,2210.23,328,442510,1349,129940
2013-03-20,37.2 ( 0.54 %),113,192230,1701.15,174,160800,924,31430
2013-03-19,37 ( 0.27 %),126,115320,915.24,96,91370,952,23950
2013-03-18,36.9 ( -0.81 %),142,177090,1247.11,127,175240,1380,1850
2013-03-15,37.2 ( -0.27 %),98,110030,1122.76,90,85890,954,24140
2013-03-14,37.3 ( 0.54 %),71,74060,1043.1,103,112060,1088,-38000
2013-03-13,37.1 ( -0.8 %),136,164520,1209.71,139,147380,1060,17140
2013-03-12,37.4 ( 0 %),116,152760,1316.9,150,155690,1038,-2930
2013-03-11,37.4 ( 1.63 %),143,228610,1598.67,152,130770,860,97840
2013-03-08,36.8 ( 2.22 %),177,327080,1847.91,132,154870,1173,172210
2013-03-07,36 ( -0.55 %),200,223020,1115.1,81,181150,2236,41870
2013-03-06,36.2 ( 1.4 %),180,313520,1741.78,87,117250,1348,196270
2013-03-05,35.7 ( -1.38 %),211,377290,1788.1,139,407540,2932,-30250
2013-03-04,36.2 ( -2.16 %),273,502020,1838.9,121,346610,2865,155410
2013-03-01,37 ( 0 %),184,237400,1290.22,91,205230,2255,32170
2013-02-28,37 ( 1.09 %),262,494160,1886.11,124,327960,2645,166200
2013-02-27,36.6 ( -0.81 %),348,496110,1425.6,149,449590,3017,46520
2013-02-26,36.9 ( -3.91 %),292,416630,1426.82,216,539070,2496,-122440
2013-02-25,38.4 ( -0.26 %),174,257500,1479.89,166,384370,2315,-126870
2013-02-22,38.5 ( -0.26 %),342,613500,1793.86,282,659090,2337,-45590
2013-02-21,38.6 ( -2.28 %),274,378720,1382.19,230,531940,2313,-153220
2013-02-20,39.5 ( -0.5 %),301,369830,1228.67,161,328470,2040,41360
2013-02-19,39.7 ( -0.75 %),202,232870,1152.82,208,402560,1935,-169690
2013-02-18,40 ( 0.5 %),191,289130,1513.77,173,249900,1445,39230
2013-02-08,39.8 ( 0.51 %),142,208920,1471.27,142,280820,1978,-71900
2013-02-07,39.6 ( 0.51 %),161,335870,2086.15,132,265650,2012,70220
2013-02-06,39.4 ( 0.51 %),219,289990,1324.16,166,302870,1825,-12880
2013-02-05,39.2 ( -0.51 %),219,409710,1870.82,121,264660,2187,145050
2013-02-04,39.4 ( -0.25 %),239,408840,1710.63,205,356260,1738,52580
2013-02-01,39.5 ( -1.5 %),318,654990,2059.72,224,513190,2291,141800
2013-01-31,40.1 ( -1.72 %),279,586360,2101.65,288,683690,2374,-97330
2013-01-30,40.8 ( 3.29 %),593,1402330,2364.81,596,1120680,1880,281650
2013-01-29,39.5 ( -0.75 %),202,381070,1886.49,347,434470,1252,-53400
2013-01-28,39.8 ( 1.27 %),322,820100,2546.89,587,930270,1585,-110170
2013-01-25,39.3 ( 3.42 %),328,1274180,3884.7,674,1275900,1893,-1720
2013-01-24,38 ( 2.43 %),155,450170,2904.32,187,367180,1964,82990
2013-01-23,37.1 ( 0 %),222,615680,2773.33,200,306230,1531,309450
2013-01-22,37.1 ( -1.59 %),307,793700,2585.34,246,667960,2715,125740
2013-01-21,37.7 ( -0.53 %),224,418570,1868.62,225,301800,1341,116770
2013-01-18,37.9 ( -0.52 %),387,1096400,2833.07,294,598720,2036,497680
2013-01-17,38.1 ( -1.3 %),238,728810,3062.23,336,578770,1723,150040
2013-01-16,38.6 ( 1.05 %),341,850640,2494.55,341,669170,1962,181470
2013-01-15,38.2 ( 1.33 %),392,944140,2408.52,330,643570,1950,300570
2013-01-14,37.7 ( -3.08 %),531,971130,1828.87,350,892600,2550,78530
2013-01-11,38.9 ( -1.52 %),477,950730,1993.14,351,1085000,3091,-134270
2013-01-10,39.5 ( 1.28 %),439,1185370,2700.16,440,1136030,2582,49340
2013-01-09,39 ( 2.63 %),575,2699680,4695.1,466,1785020,3831,914660
2013-01-08,38 ( 4.97 %),414,1635760,3951.11,381,659720,1732,976040
2013-01-07,36.2 ( -0.55 %),231,340110,1472.34,178,354520,1992,-14410
2013-01-04,36.4 ( 1.39 %),282,558920,1981.99,188,416690,2216,142230
2013-01-03,35.9 ( -1.37 %),355,560200,1578.03,327,705520,2158,-145320
2013-01-02,36.4 ( 3.41 %),329,848670,2579.54,288,598450,2078,250220
2012-12-28,35.2 ( -0.85 %),225,294360,1308.27,230,410850,1786,-116490
2012-12-27,35.5 ( 3.5 %),321,629870,1962.21,396,541380,1367,88490
2012-12-26,34.3 ( 3.31 %),337,588960,1747.66,317,408910,1290,180050
2012-12-25,33.2 ( 0 %),245,366210,1494.73,230,466180,2027,-99970
2012-12-24,33.2 ( 1.84 %),196,339520,1732.24,248,340780,1374,-1260
2012-12-21,32.6 ( -0.61 %),314,362430,1154.24,170,378960,2229,-16530
2012-12-20,32.8 ( -1.5 %),148,124650,842.23,164,169530,1034,-44880
2012-12-19,33.3 ( 2.78 %),165,289640,1755.39,233,245950,1056,43690
2012-12-18,32.4 ( -1.52 %),258,167560,649.46,108,261310,2420,-93750
2012-12-17,32.9 ( -0.3 %),143,160680,1123.64,150,253670,1691,-92990
2012-12-14,33 ( -0.6 %),115,101210,880.09,113,179210,1586,-78000
2012-12-13,33.2 ( 0.61 %),199,238810,1200.05,199,347390,1746,-108580
2012-12-12,33 ( 1.54 %),201,313900,1561.69,177,322720,1823,-8820
2012-12-11,32.5 ( -0.61 %),131,92960,709.62,117,179140,1531,-86180
2012-12-10,32.7 ( 1.24 %),131,119410,911.53,117,135410,1157,-16000
2012-12-07,32.3 ( -0.62 %),156,121120,776.41,96,183430,1911,-62310
2012-12-06,32.5 ( -0.61 %),167,157550,943.41,119,197680,1661,-40130
2012-12-05,32.7 ( 2.83 %),198,243420,1229.39,165,160540,973,82880
2012-12-04,32.8 ( 0.92 %),242,182080,752.4,91,189010,2077,-6930
2012-12-03,32.5 ( -0.61 %),137,98600,719.71,57,149160,2617,-50560
2012-11-30,32.7 ( 0.31 %),154,104620,679.35,111,142930,1288,-38310
2012-11-29,32.6 ( -1.21 %),177,116640,658.98,130,209150,1609,-92510
2012-11-28,33 ( -1.2 %),131,130440,995.73,62,121550,1960,8890
2012-11-27,33.4 ( -0.89 %),126,79200,628.57,65,122600,1886,-43400
2012-11-26,33.7 ( -0.59 %),100,103160,1031.6,61,85900,1408,17260
2012-11-23,33.9 ( 0 %),84,78520,934.76,94,145610,1549,-67090
2012-11-22,33.9 ( 0 %),80,111980,1399.75,95,166000,1747,-54020
2012-11-21,33.9 ( -0.29 %),84,64470,767.5,90,129230,1436,-64760
2012-11-20,34 ( 0 %),108,84580,783.15,70,106620,1523,-22040
2012-11-19,34 ( -1.45 %),114,107720,944.91,97,180700,1863,-72980
2012-11-16,34.5 ( -0.58 %),112,78230,698.48,75,123320,1644,-45090
2012-11-15,34.7 ( -0.86 %),69,58210,843.62,77,161300,2095,-103090
2012-11-14,35 ( 0.29 %),81,102370,1263.83,94,68150,725,34220
2012-11-13,34.9 ( -0.29 %),75,56440,752.53,100,133340,1333,-76900
2012-11-12,35 ( 2.94 %),140,209460,1496.14,152,214620,1412,-5160
2012-11-09,34 ( 0 %),117,138950,1187.61,60,109460,1824,29490
2012-11-08,34 ( 0 %),80,144150,1801.88,117,180530,1543,-36380
2012-11-07,34 ( 1.49 %),124,200930,1620.4,92,164900,1792,36030
2012-11-06,33.5 ( -1.18 %),96,183170,1908.02,122,135820,1113,47350
2012-11-05,33.9 ( -0.59 %),152,307900,2025.66,126,164200,1303,143700
2012-11-02,34.1 ( -4.75 %),136,165850,1219.49,138,170370,1235,-4520
2012-11-01,35.8 ( 0 %),90,153630,1707,59,119090,2018,34540
2012-10-31,35.8 ( -0.28 %),89,155790,1750.45,94,168180,1789,-12390
2012-10-30,35.9 ( -1.1 %),140,160650,1147.5,103,163150,1584,-2500
2012-10-29,36.3 ( -0.27 %),111,120280,1083.6,74,112370,1519,7910
2012-10-26,36.4 ( -0.27 %),122,132100,1082.79,80,112930,1412,19170
2012-10-25,36.5 ( 0 %),83,170440,2053.49,86,143510,1669,26930
2012-10-24,36.5 ( 0 %),96,174320,1815.83,90,206140,2290,-31820
2012-10-23,36.5 ( 0 %),116,186260,1605.69,96,178500,1859,7760
2012-10-22,36.5 ( -0.27 %),112,168850,1507.59,116,174220,1502,-5370
2012-10-19,36.6 ( -0.27 %),137,124400,908.03,138,151750,1100,-27350
2012-10-18,36.7 ( -1.08 %),127,87630,690,132,209580,1588,-121950
2012-10-17,37.1 ( 0 %),86,75230,874.77,130,140380,1080,-65150
2012-10-16,37.1 ( 0.54 %),182,138790,762.58,116,164330,1417,-25540
2012-10-15,36.9 ( -0.54 %),129,334770,2595.12,139,193190,1390,141580
2012-10-12,37.1 ( -0.8 %),90,83660,929.56,172,164260,955,-80600
2012-10-11,37.4 ( -0.27 %),130,226660,1743.54,228,391970,1719,-165310
2012-10-10,37.5 ( 0.81 %),122,260740,2137.21,208,278110,1337,-17370
2012-10-09,37.2 ( 0.81 %),177,280970,1587.4,258,322850,1251,-41880
2012-10-08,36.9 ( 0.27 %),159,151360,951.95,140,162820,1163,-11460
2012-10-05,36.8 ( 0 %),104,101560,976.54,114,112540,987,-10980
2012-10-04,36.8 ( -0.27 %),100,176680,1766.8,173,245620,1420,-68940
2012-10-03,36.9 ( 0 %),149,180470,1211.21,118,164500,1394,15970
2012-10-02,36.9 ( 0 %),169,227200,1344.38,149,188860,1268,38340
2012-10-01,36.9 ( -2.64 %),233,177690,762.62,154,199250,1294,-21560
2012-09-28,37.9 ( -0.26 %),179,342150,1911.45,243,306240,1260,35910
2012-09-27,38 ( 2.7 %),522,698970,1339.02,433,473040,1092,225930
2012-09-26,37 ( 1.09 %),238,333810,1402.56,207,228260,1103,105550
2012-09-25,36.6 ( 0 %),182,271800,1493.41,192,329450,1716,-57650
2012-09-24,36.6 ( -0.54 %),174,261060,1500.34,160,237800,1486,23260
2012-09-21,36.8 ( 0.27 %),184,176060,956.85,135,186730,1383,-10670
2012-09-20,36.7 ( 0 %),228,252590,1107.85,202,267310,1323,-14720
2012-09-19,36.7 ( -2.91 %),605,722620,1194.41,220,584630,2657,137990
2012-09-18,37.8 ( -2.07 %),227,237120,1044.58,157,303340,1932,-66220
2012-09-17,38.6 ( -0.26 %),160,230860,1442.88,157,207560,1322,23300
2012-09-14,38.7 ( 0 %),221,283060,1280.81,211,385090,1825,-102030
2012-09-13,38.7 ( 0 %),174,260510,1497.18,150,317520,2117,-57010
2012-09-12,38.7 ( 0.52 %),172,157720,916.98,151,196020,1298,-38300
2012-09-11,38.5 ( 0.26 %),274,328740,1199.78,140,159930,1142,168810
2012-09-10,38.4 ( -2.29 %),285,356730,1251.68,189,215290,1139,141440
2012-09-07,39.3 ( -0.25 %),294,336980,1146.19,162,229120,1414,107860
2012-09-06,39.4 ( -2.72 %),373,389980,1045.52,197,314220,1595,75760
2012-09-05,40.5 ( -3.11 %),255,269790,1058,230,354370,1541,-84580
2012-09-04,41.8 ( 4.24 %),282,445360,1579.29,228,280150,1229,165210
2012-08-31,40.1 ( 4.97 %),554,1080790,1950.88,236,548600,2325,532190
2012-08-30,38.2 ( 0 %),480,914310,1904.81,134,718500,5362,195810
2012-08-29,38.2 ( 0.26 %),507,813060,1603.67,178,703660,3953,109400
2012-08-28,38.1 ( -2.56 %),378,745340,1971.8,212,541840,2556,203500
2012-08-27,39.1 ( -4.87 %),214,401010,1873.88,189,615070,3254,-214060
2012-08-24,42.1 ( 0.72 %),346,424760,1227.63,202,295610,1463,129150
2012-08-23,41.8 ( -5 %),231,368110,1593.55,265,530960,2004,-162850
2012-08-22,44 ( 0 %),249,326990,1313.21,173,270340,1563,56650
2012-08-21,44 ( -4.56 %),396,597940,1509.95,297,683100,2300,-85160
2012-08-20,46.1 ( 1.32 %),205,328900,1604.39,217,259240,1195,69660
2012-08-17,45.5 ( -0.66 %),378,523100,1383.86,198,329110,1662,193990
2012-08-16,45.8 ( -0.65 %),263,460200,1749.81,188,485970,2585,-25770
2012-08-15,46.1 ( -0.43 %),282,636850,2258.33,192,505360,2632,131490
2012-08-14,46.3 ( -0.43 %),306,707400,2311.76,213,384040,1803,323360
2012-08-13,46.5 ( 1.53 %),235,467580,1989.7,195,337980,1733,129600
2012-08-10,45.8 ( -2.35 %),388,613340,1580.77,195,675100,3462,-61760
2012-08-09,46.9 ( -0.42 %),335,456440,1362.51,134,472120,3523,-15680
2012-08-08,47.1 ( -0.21 %),124,143590,1157.98,90,133830,1487,9760
2012-08-07,47.2 ( 0 %),142,225870,1590.63,135,287470,2129,-61600
2012-08-06,47.2 ( -0.21 %),280,302180,1079.21,123,264470,2150,37710
2012-08-03,47.3 ( 0.21 %),153,273790,1789.48,162,274610,1695,-820
2012-08-02,47.2 ( 0 %),112,151690,1354.38,136,249740,1836,-98050
2012-08-01,47.2 ( -0.84 %),160,253150,1582.19,130,269010,2069,-15860
2012-07-31,47.6 ( -2.26 %),194,285470,1471.49,184,390950,2125,-105480
2012-07-30,48.7 ( 1.46 %),129,367170,2846.28,235,343150,1460,24020
2012-07-27,48 ( 0.42 %),113,296630,2625.04,232,269780,1163,26850
2012-07-26,47.8 ( 0.63 %),155,363590,2345.74,136,248860,1830,114730
2012-07-25,47.5 ( -3.46 %),185,595950,3221.35,256,718020,2805,-122070
2012-07-24,49.2 ( 4.46 %),226,593750,2627.21,374,445950,1192,147800
2012-07-23,47.1 ( 0 %),96,99720,1038.75,93,105940,1139,-6220
2012-07-20,47.1 ( -0.21 %),152,153600,1010.53,191,148060,775,5540
2012-07-19,47.2 ( 0.21 %),189,120320,636.61,142,101120,712,19200
2012-07-18,47.1 ( -0.42 %),104,93760,901.54,77,118500,1539,-24740
2012-07-17,47.3 ( 0 %),68,51000,750,65,61290,943,-10290
2012-07-16,47.3 ( -1.05 %),53,51480,971.32,65,71230,1096,-19750
2012-07-13,47.8 ( 1.49 %),122,65140,533.93,64,51690,808,13450
2012-07-12,47.1 ( 0 %),50,61540,1230.8,41,35060,855,26480
2012-07-10,47 ( -0.21 %),47,61580,1310.21,67,47670,711,13910
2012-07-09,47.1 ( -0.84 %),65,48760,750.15,85,27380,322,21380
2012-07-06,47.5 ( 0 %),46,49960,1086.09,51,44210,867,5750
2012-07-05,47.5 ( 0.64 %),51,84260,1652.16,73,56790,778,27470
2012-07-04,47.2 ( 0.43 %),66,98450,1491.67,75,42480,566,55970
2012-07-03,47 ( -0.21 %),58,39950,688.79,64,32680,511,7270
2012-07-02,47.1 ( 0 %),88,199430,2266.25,66,219890,3332,-20460
2012-06-29,47.1 ( 0 %),67,29890,446.12,41,60560,1477,-30670
2012-06-28,47.1 ( -3.09 %),82,67140,818.78,54,113000,2093,-45860
2012-06-27,48.6 ( 0 %),59,185190,3138.81,82,142450,1737,42740
2012-06-26,48.6 ( -0.82 %),51,64930,1273.14,66,67630,1025,-2700
2012-06-25,49 ( 0 %),49,82730,1688.37,104,80890,778,1840
2012-06-22,49 ( -0.41 %),78,113960,1461.03,62,101710,1640,12250
2012-06-21,0 ( 0 %),63,100690,1598.25,55,90480,1645,10210
2012-06-20,49.3 ( 0.41 %),77,151520,1967.79,109,165770,1521,-14250
2012-06-19,49.1 ( 0 %),75,180800,2410.67,92,146300,1590,34500
2012-06-18,49.1 ( 0.41 %),79,74550,943.67,96,123800,1290,-49250
2012-06-15,48.9 ( 0.2 %),62,198040,3194.19,66,195340,2960,2700
2012-06-14,48.8 ( -0.41 %),98,281510,2872.55,78,187680,2406,93830
2012-06-13,49 ( 0 %),75,137830,1837.73,85,157570,1854,-19740
2012-06-12,49 ( -0.2 %),94,218640,2325.96,71,178550,2515,40090
2012-06-11,49.1 ( 0.2 %),97,149900,1545.36,90,120460,1338,29440
2012-06-08,49 ( -0.61 %),115,123890,1077.3,122,206870,1696,-82980
2012-06-07,49.3 ( 0 %),79,76810,972.28,88,124970,1420,-48160
2012-06-06,49.3 ( 0.61 %),81,200440,2474.57,104,147460,1418,52980
2012-06-05,49 ( 0 %),77,225060,2922.86,99,217090,2193,7970
2012-06-04,49 ( -0.61 %),78,143380,1838.21,98,191170,1951,-47790
2012-06-01,49.3 ( -0.2 %),66,120260,1822.12,77,129110,1677,-8850
2012-05-31,49.4 ( -0.4 %),104,205760,1978.46,133,257650,1937,-51890
2012-05-30,49.6 ( 0.2 %),110,166330,1512.09,118,242210,2053,-75880
2012-05-29,49.5 ( -0.2 %),82,142770,1741.1,107,208750,1951,-65980
2012-05-28,49.6 ( 0 %),83,216700,2610.84,135,281410,2085,-64710
2012-05-25,49.6 ( 2.06 %),139,291570,2097.63,112,199640,1782,91930
2012-05-24,48.6 ( -0.41 %),95,196290,2066.21,128,262120,2048,-65830
2012-05-23,48.8 ( -2.01 %),138,188940,1369.13,143,272060,1903,-83120
2012-05-22,49.8 ( -1.39 %),117,162120,1385.64,128,306130,2392,-144010
2012-05-21,50.5 ( 4.12 %),186,482770,2595.54,104,200880,1932,281890
2012-05-18,48.5 ( -2.61 %),200,524420,2622.1,133,504090,3790,20330
2012-05-17,49.8 ( 1.01 %),166,347670,2094.4,105,211920,2018,135750
2012-05-16,49.3 ( -0.4 %),159,252720,1589.43,92,303900,3303,-51180
2012-05-15,49.5 ( -1 %),258,461910,1790.35,190,691460,3639,-229550
2012-05-14,64 ( -0.78 %),177,354170,2000.96,260,437700,1683,-83530
2012-05-11,64.5 ( -1.53 %),192,378180,1969.69,230,645990,2809,-267810
2012-05-10,65.5 ( -0.76 %),202,598870,2964.7,297,602770,2030,-3900
2012-05-09,66 ( -0.75 %),227,577210,2542.78,272,518020,1904,59190
2012-05-08,66.5 ( -0.75 %),186,492990,2650.48,336,784970,2336,-291980
2012-05-07,67 ( 1.52 %),211,461960,2189.38,275,572720,2083,-110760
2012-05-04,66 ( 1.54 %),249,691820,2778.39,379,876670,2313,-184850
2012-05-03,65 ( 4.84 %),390,1033430,2649.82,353,819830,2322,213600
2012-05-02,62 ( 4.2 %),442,1102330,2493.96,179,432810,2418,669520
2012-04-27,59.5 ( 0 %),156,299910,1922.5,139,239830,1725,60080
2012-04-26,59.5 ( -1.65 %),158,344550,2180.7,214,446480,2086,-101930
2012-04-25,60.5 ( 0.83 %),179,220510,1231.9,170,284410,1673,-63900
2012-04-24,60 ( 2.56 %),277,302870,1093.39,117,191830,1640,111040
2012-04-23,58.5 ( -0.85 %),187,271750,1453.21,120,234730,1956,37020
2012-04-20,59 ( -0.84 %),212,418460,1973.87,141,352110,2497,66350
2012-04-19,59.5 ( -4.03 %),150,378200,2521.33,205,503450,2456,-125250
2012-04-18,62 ( -0.8 %),182,434240,2385.93,217,471310,2172,-37070
2012-04-17,62.5 ( 0.81 %),120,297910,2482.58,169,366630,2169,-68720
2012-04-16,62 ( 1.64 %),235,393730,1675.45,203,406740,2004,-13010
2012-04-13,61 ( -3.17 %),195,325950,1671.54,217,386890,1783,-60940
2012-04-12,63 ( 0.8 %),158,398870,2524.49,240,475140,1980,-76270
2012-04-11,62.5 ( 4.17 %),234,844500,3608.97,331,606430,1832,238070
2012-04-10,60 ( 0 %),103,302850,2940.29,220,320150,1455,-17300
2012-04-09,60 ( 0.84 %),127,282420,2223.78,199,364860,1833,-82440
2012-04-06,59.5 ( 0 %),120,240350,2002.92,238,335160,1408,-94810
2012-04-05,59.5 ( 2.59 %),267,832070,3116.37,366,832250,2274,-180
2012-04-04,58 ( 0 %),112,356880,3186.43,227,453820,1999,-96940
2012-04-03,58 ( 0 %),77,208210,2704.03,141,209770,1488,-1560
2012-03-30,58 ( 0 %),136,350250,2575.37,207,361500,1746,-11250
2012-03-29,58 ( 0 %),123,398520,3240,241,376080,1560,22440
2012-03-28,58 ( 0.87 %),170,493890,2905.24,208,336560,1618,157330
2012-03-27,57.5 ( -0.86 %),135,322750,2390.74,270,323840,1199,-1090
2012-03-26,58 ( 0 %),123,291980,2373.82,208,300890,1447,-8910
2012-03-23,58 ( 0.87 %),152,274660,1806.97,212,261500,1233,13160
2012-03-22,57.5 ( -1.71 %),153,264030,1725.69,224,327670,1463,-63640
2012-03-21,58.5 ( 0 %),180,275660,1531.44,302,448130,1484,-172470
2012-03-20,58.5 ( -0.85 %),97,241970,2494.54,243,300030,1235,-58060
2012-03-19,59 ( 0 %),119,263950,2218.07,269,299650,1114,-35700
2012-03-16,59 ( 0 %),171,429790,2513.39,373,732390,1964,-302600
2012-03-15,59 ( 3.51 %),346,1010760,2921.27,390,720940,1849,289820
2012-03-14,57 ( 0 %),136,712860,5241.62,204,352000,1725,360860
2012-03-13,57 ( 0.88 %),108,278280,2576.67,149,282230,1894,-3950
2012-03-12,56.5 ( 0 %),144,428100,2972.92,180,311830,1732,116270
2012-03-09,56.5 ( 0 %),171,773540,4523.63,255,470340,1844,303200
2012-03-08,56.5 ( -1.74 %),174,553260,3179.66,256,633570,2475,-80310
2012-03-07,57.5 ( 2.68 %),219,713710,3258.95,216,334810,1550,378900
2012-03-06,56 ( -3.45 %),215,623100,2898.14,361,822240,2278,-199140
2012-03-05,58 ( 4.5 %),377,1032840,2739.63,209,427300,2044,605540
2012-03-02,55.5 ( 0.91 %),167,540310,3235.39,200,257250,1286,283060
2012-03-01,55 ( 0 %),74,253710,3428.51,175,225920,1291,27790
2012-02-29,55 ( 0.92 %),99,460700,4653.54,214,362520,1694,98180
2012-02-28,54.5 ( -0.91 %),125,402360,3218.88,256,342790,1339,59570
2012-02-27,55 ( 0.92 %),123,412560,3354.15,221,287720,1302,124840
2012-02-24,54.5 ( 0 %),99,323390,3266.57,299,448620,1500,-125230
2012-02-23,54.5 ( 0 %),129,401090,3109.22,241,343400,1425,57690
2012-02-22,54.5 ( 0.93 %),126,389130,3088.33,267,403280,1510,-14150
2012-02-21,54 ( 0 %),124,526720,4247.74,334,573010,1716,-46290
2012-02-20,54 ( 3.85 %),204,617630,3027.6,310,470810,1519,146820
2012-02-17,52 ( 0.97 %),101,236190,2338.51,172,262120,1524,-25930
2012-02-16,51.5 ( 0.98 %),97,411370,4240.93,195,249550,1280,161820
2012-02-15,51 ( 0 %),103,282160,2739.42,173,272190,1573,9970
2012-02-14,51 ( 0 %),107,270580,2528.79,125,284120,2273,-13540
2012-02-13,51 ( -0.97 %),112,270410,2414.38,211,342940,1625,-72530
2012-02-10,51.5 ( -0.96 %),99,352790,3563.54,235,407570,1734,-54780
2012-02-09,52 ( 0.97 %),137,317970,2320.95,247,322100,1304,-4130
2012-02-08,51.5 ( 1.98 %),177,355140,2006.44,195,268370,1376,86770
2012-02-07,50.5 ( 0 %),82,126820,1546.59,139,122220,879,4600
2012-02-06,50.5 ( 0 %),80,112010,1400.12,161,209860,1303,-97850
2012-02-03,50.5 ( -0.98 %),167,258690,1549.04,229,400910,1751,-142220
2012-02-02,51 ( 0.99 %),228,169400,742.98,186,222340,1195,-52940
2012-02-01,50.5 ( 1.61 %),115,153790,1337.3,160,197320,1233,-43530
2012-01-31,49.7 ( -0.6 %),91,68910,757.25,156,153910,987,-85000
2012-01-30,50 ( 0.6 %),83,101000,1216.87,96,100660,1049,340
2012-01-20,49.7 ( 0 %),85,157070,1847.88,134,159770,1192,-2700
2012-01-19,49.7 ( 0.4 %),78,151490,1942.18,123,273130,2221,-121640
2012-01-18,49.5 ( 0 %),77,135830,1764.03,108,204550,1894,-68720
2012-01-17,49.5 ( -2.94 %),107,237940,2223.74,167,238620,1429,-680
2012-01-16,51 ( 2 %),196,947010,4831.68,319,788520,2472,158490
2012-01-13,50 ( 1.83 %),127,573580,4516.38,232,222050,957,351530
2012-01-12,49.1 ( -0.81 %),70,188070,2686.71,139,95320,686,92750
2012-01-11,49.5 ( 0 %),58,395170,6813.28,179,333950,1866,61220
2012-01-10,49.5 ( 1.43 %),101,529430,5241.88,138,243370,1764,286060
2012-01-09,48.8 ( 0.41 %),112,208570,1862.23,102,92820,910,115750
2012-01-06,48.6 ( 0.83 %),83,139530,1681.08,73,111200,1523,28330
2012-01-05,48.2 ( -2.03 %),114,155590,1364.82,82,156430,1908,-840
2012-01-04,49.2 ( 0 %),63,126070,2001.11,115,172760,1502,-46690
2012-01-03,49.2 ( -1.01 %),87,204820,2354.25,122,156570,1283,48250
2011-12-30,49.7 ( 0.4 %),93,326470,3510.43,202,332660,1647,-6190
2011-12-29,49.5 ( 1.64 %),94,345360,3674.04,157,209500,1334,135860
2011-12-28,48.7 ( 0.21 %),81,257960,3184.69,92,145520,1582,112440
2011-12-27,48.6 ( -0.61 %),58,289550,4992.24,143,227330,1590,62220
2011-12-26,48.9 ( -0.2 %),53,257930,4866.6,119,182680,1535,75250
2011-12-23,49 ( -1.01 %),53,126860,2393.58,96,94920,989,31940
2011-12-22,49.5 ( 0 %),54,356130,6595,191,333280,1745,22850
2011-12-21,49.5 ( 0 %),59,236350,4005.93,135,177690,1316,58660
2011-12-20,49.5 ( 0 %),185,784260,4239.24,184,279630,1520,504630
2011-12-19,49.5 ( 1.02 %),91,248120,2726.59,163,211540,1298,36580
2011-12-16,49 ( 0.82 %),153,494310,3230.78,168,273420,1628,220890
2011-12-15,48.6 ( -0.82 %),70,258460,3692.29,142,282050,1986,-23590
2011-12-14,49 ( -0.81 %),80,310090,3876.12,169,333440,1973,-23350
2011-12-13,49.4 ( -0.2 %),78,393440,5044.1,229,368280,1608,25160
2011-12-12,49.5 ( 0 %),80,367250,4590.62,168,352560,2099,14690
2011-12-09,49.5 ( -0.6 %),53,141570,2671.13,255,284630,1116,-143060
2011-12-08,49.8 ( -0.4 %),45,89040,1978.67,176,218050,1239,-129010
2011-12-07,50 ( 0 %),112,391940,3499.46,252,414280,1644,-22340
2011-12-06,50 ( 0 %),106,465230,4388.96,318,562710,1770,-97480
2011-12-05,50 ( 1.42 %),194,745650,3843.56,203,534970,2635,210680
2011-12-02,49.3 ( 0.2 %),135,742270,5498.3,292,719230,2463,23040
2011-12-01,49.2 ( 0.2 %),96,421590,4391.56,150,289910,1933,131680
2011-11-30,49.1 ( 0.61 %),90,556650,6185,250,469790,1879,86860
2011-11-29,48.8 ( 0 %),100,445190,4451.9,191,342560,1794,102630
2011-11-28,48.8 ( -0.41 %),53,207520,3915.47,151,245810,1628,-38290
2011-11-25,49 ( -0.2 %),82,369700,4508.54,189,435480,2304,-65780
2011-11-24,49.1 ( 0 %),76,345980,4552.37,244,367480,1506,-21500
2011-11-23,49.1 ( 1.03 %),170,707020,4158.94,214,468230,2188,238790
2011-11-22,48.6 ( 0.83 %),140,453010,3235.79,244,306170,1255,146840
2011-11-21,48.2 ( 0 %),94,266200,2831.91,148,254940,1723,11260
2011-11-18,48.2 ( 0 %),100,271540,2715.4,146,184470,1263,87070
2011-11-17,48.2 ( 0.42 %),148,555670,3754.53,161,408010,2534,147660
2011-11-16,48 ( 1.05 %),115,363430,3160.26,139,248910,1791,114520
2011-11-15,47.5 ( -1.04 %),152,396910,2611.25,163,462850,2840,-65940
2011-11-14,48 ( -1.23 %),102,227300,2228.43,153,240770,1574,-13470
2011-11-11,48.6 ( -0.41 %),95,362760,3818.53,155,435850,2812,-73090
2011-11-10,48.8 ( 0 %),137,342380,2499.12,155,321220,2072,21160
2011-11-09,48.8 ( -0.41 %),124,245130,1976.85,184,320410,1741,-75280
2011-11-08,49 ( -1.61 %),145,248570,1714.28,175,360720,2061,-112150
2011-11-07,49.8 ( -0.2 %),98,348520,3556.33,326,623690,1913,-275170
2011-11-04,49.9 ( 1.22 %),163,650130,3988.53,403,638000,1583,12130
2011-11-03,49.3 ( -0.8 %),183,498990,2726.72,236,508010,2153,-9020
2011-11-02,49.7 ( 1.22 %),191,688030,3602.25,445,658170,1479,29860
2011-11-01,49.1 ( -0.81 %),87,301450,3464.94,252,380260,1509,-78810
2011-10-31,49.5 ( -1 %),153,539390,3525.42,453,824750,1821,-285360
2011-10-28,50 ( 3.09 %),187,631490,3376.95,395,400430,1014,231060
2011-10-27,48.5 ( 0 %),223,647440,2903.32,211,352940,1673,294500
2011-10-26,48.5 ( 1.68 %),153,428430,2800.2,302,495560,1641,-67130
2011-10-25,47.7 ( -1.24 %),203,478030,2354.83,206,471690,2290,6340
2011-10-24,48.3 ( -2.62 %),238,501320,2106.39,231,572920,2480,-71600
2011-10-21,49.6 ( 1.85 %),307,832950,2713.19,244,604920,2479,228030
2011-10-20,48.7 ( -0.2 %),165,368390,2232.67,155,411920,2658,-43530
2011-10-19,48.8 ( -0.41 %),174,516810,2970.17,224,452680,2021,64130
2011-10-18,49 ( -0.61 %),96,300500,3130.21,201,389130,1936,-88630
2011-10-17,49.3 ( -1.4 %),156,467810,2998.78,273,581100,2129,-113290
2011-10-14,50 ( 1.21 %),182,470920,2587.47,226,244450,1082,226470
2011-10-13,49.4 ( 1.02 %),147,590980,4020.27,188,240780,1281,350200
2011-10-12,48.9 ( -0.41 %),146,462960,3170.96,176,431990,2454,30970
2011-10-11,49.1 ( 0.2 %),259,584680,2257.45,175,283380,1619,301300
2011-10-10,49 ( -1.01 %),265,633680,2391.25,216,444490,2058,189190
2011-10-07,49.5 ( -1 %),250,630400,2521.6,295,801920,2718,-171520
2011-10-06,50 ( -0.99 %),321,948940,2956.2,414,1078290,2605,-129350
2011-10-05,50.5 ( -0.98 %),234,972940,4157.86,233,1100860,4725,-127920
2011-10-04,51 ( 0 %),148,550220,3717.7,198,392000,1980,158220
2011-10-03,51 ( -0.97 %),119,328420,2759.83,227,526260,2318,-197840
2011-09-30,51.5 ( 0 %),171,629000,3678.36,239,537830,2250,91170
2011-09-29,51.5 ( 0 %),167,420270,2516.59,242,441160,1823,-20890
2011-09-28,51.5 ( 0.98 %),189,382860,2025.71,217,369250,1702,13610
2011-09-27,51 ( 0.99 %),311,603460,1940.39,258,619110,2400,-15650
2011-09-26,51.5 ( -1.9 %),325,727380,2238.09,270,509010,1885,218370
2011-09-23,52.5 ( -1.87 %),289,540680,1870.87,275,424680,1544,116000
2011-09-22,53.5 ( 0 %),210,700010,3333.38,366,593800,1622,106210
2011-09-21,53.5 ( 0.94 %),214,781920,3653.83,537,1143990,2130,-362070
2011-09-20,53 ( -1.85 %),355,1274860,3591.15,507,1064170,2099,210690
2011-09-19,54 ( 4.85 %),322,1136600,3529.81,314,484970,1544,651630
2011-09-16,51.5 ( -2.83 %),648,2245690,3465.57,611,3699340,6055,-1453650
2011-09-15,53 ( 4.95 %),836,1796220,2148.59,227,1300440,5729,495780
2011-09-14,50.5 ( -3.81 %),766,1098040,1433.47,177,928370,5245,169670
2011-09-13,52.5 ( -1.87 %),767,1263970,1647.94,215,1389140,6461,-125170
2011-09-12,53.5 ( -2.73 %),333,614510,1845.38,168,591060,3518,23450
2011-09-09,55 ( -1.79 %),281,622710,2216.05,189,770490,4077,-147780
2011-09-08,56 ( 0.9 %),187,443630,2372.35,205,560790,2736,-117160
2011-09-07,55.5 ( -0.89 %),204,529450,2595.34,159,504630,3174,24820
2011-09-06,56 ( 0 %),102,500730,4909.12,160,412130,2576,88600
2011-09-05,56 ( 0 %),102,397300,3895.1,189,468420,2478,-71120
2011-09-01,56 ( 0.9 %),108,459750,4256.94,200,391710,1959,68040
2011-08-31,55.5 ( -0.89 %),133,689180,5181.8,262,664670,2537,24510
2011-08-30,56 ( 0.9 %),101,389820,3859.6,243,545810,2246,-155990
2011-08-29,55.5 ( 0.91 %),102,303540,2975.88,220,369340,1679,-65800
2011-08-26,55 ( 0.92 %),94,375600,3995.74,175,429730,2456,-54130
2011-08-25,54.5 ( 0 %),89,273780,3076.18,226,535850,2371,-262070
2011-08-24,54.5 ( 0 %),111,369490,3328.74,190,360620,1898,8870
2011-08-23,54.5 ( 0 %),106,303000,2858.49,215,376360,1751,-73360
2011-08-22,54.5 ( 0.93 %),126,422980,3356.98,208,362910,1745,60070
2011-08-19,54 ( -1.82 %),73,277800,3805.48,257,365010,1420,-87210
2011-08-18,55 ( 0.92 %),109,297820,2732.29,227,375410,1654,-77590
2011-08-17,54.5 ( 0.93 %),110,386400,3512.73,187,275280,1472,111120
2011-08-16,54 ( 0 %),123,377720,3070.89,183,307990,1683,69730
2011-08-15,54 ( 0 %),126,503070,3992.62,209,406620,1946,96450
2011-08-12,54 ( 0 %),153,452840,2959.74,295,375490,1273,77350
2011-08-11,54 ( 2.86 %),172,775610,4509.36,230,459230,1997,316380
2011-08-10,52.5 ( 1.94 %),232,883960,3810.17,222,743530,3349,140430
2011-08-09,51.5 ( -3.74 %),178,568740,3195.17,256,672010,2625,-103270
2011-08-08,53.5 ( -2.73 %),130,648770,4990.54,230,652170,2836,-3400
2011-08-05,55 ( -0.9 %),119,323190,2715.88,210,392620,1870,-69430
2011-08-04,55.5 ( 1.83 %),175,438450,2505.43,180,494720,2748,-56270
2011-08-03,54.5 ( 1.87 %),194,499960,2577.11,125,219880,1759,280080
2011-08-02,53.5 ( -3.6 %),162,352560,2176.3,270,471690,1747,-119130
2011-08-01,55.5 ( -3.48 %),274,705230,2573.83,383,948120,2476,-242890
2011-07-29,57.5 ( 0.88 %),254,1473340,5800.55,568,1641330,2890,-167990
2011-07-28,57 ( 3.64 %),251,970180,3865.26,393,786140,2000,184040
2011-07-27,55 ( 4.76 %),256,937700,3662.89,341,444250,1303,493450
2011-07-26,52.5 ( 1.94 %),157,560250,3568.47,393,537900,1369,22350
2011-07-25,51.5 ( 0.98 %),148,415690,2808.72,229,322630,1409,93060
2011-07-22,51 ( 0 %),165,472070,2861.03,255,379610,1489,92460
2011-07-21,51 ( -1.92 %),122,356690,2923.69,260,444800,1711,-88110
2011-07-20,52 ( 4.42 %),250,630200,2520.8,334,534950,1602,95250
2011-07-19,49.8 ( 0.81 %),137,405060,2956.64,145,226980,1565,178080
2011-07-18,49.4 ( 0.2 %),108,290820,2692.78,143,198260,1386,92560
2011-07-15,49.3 ( -1.2 %),87,188370,2165.17,189,255020,1349,-66650
2011-07-14,49.9 ( -0.2 %),114,271240,2379.3,253,354590,1402,-83350
2011-07-13,50 ( 1.42 %),171,447460,2616.73,245,492980,2012,-45520
2011-07-12,49.3 ( 1.44 %),173,540490,3124.22,294,423140,1439,117350
2011-07-11,48.6 ( 0.21 %),138,285450,2068.48,224,297260,1327,-11810
2011-07-08,48.5 ( 4.08 %),222,431730,1944.73,198,260040,1313,171690
2011-07-07,46.6 ( -0.21 %),84,127890,1522.5,93,135060,1452,-7170
2011-07-06,46.7 ( 1.74 %),105,193920,1846.86,132,168160,1274,25760
2011-07-05,45.9 ( -0.22 %),263,318330,1210.38,168,461550,2747,-143220
2011-07-04,46 ( -1.29 %),211,463840,2198.29,131,608820,4647,-144980
2011-07-01,46.6 ( -2.92 %),173,207070,1196.94,182,361180,1985,-154110
2011-06-30,48 ( -0.21 %),172,162190,942.97,145,263580,1818,-101390
2011-06-29,48.1 ( -1.84 %),202,226240,1120,104,285480,2745,-59240
2011-06-28,49 ( 0.82 %),142,188190,1325.28,105,121580,1158,66610
2011-06-27,48.6 ( -1.82 %),157,167120,1064.46,163,384640,2360,-217520
2011-06-24,49.5 ( -0.4 %),97,214910,2215.57,160,522220,3264,-307310
2011-06-23,49.7 ( -1.58 %),100,204950,2049.5,157,402050,2561,-197100
2011-06-22,50.5 ( 1 %),99,241790,2442.32,179,385330,2153,-143540
2011-06-21,50 ( 1.01 %),130,252580,1942.92,124,298710,2409,-46130
2011-06-20,49.5 ( -1 %),103,182800,1774.76,198,410170,2072,-227370
2011-06-17,50 ( -0.99 %),216,635670,2942.92,304,797340,2623,-161670
2011-06-16,50.5 ( 1 %),154,182190,1183.05,152,140090,922,42100
2011-06-15,50 ( 0 %),218,510860,2343.39,212,532700,2513,-21840
2011-06-14,50 ( -0.99 %),211,370210,1754.55,194,407250,2099,-37040
2011-06-13,50.5 ( 0 %),145,225400,1554.48,151,232600,1540,-7200
2011-06-10,50.5 ( -0.98 %),159,256160,1611.07,171,285460,1669,-29300
2011-06-09,51 ( 0 %),118,127100,1077.12,153,130700,854,-3600
2011-06-08,51 ( -1.92 %),158,386690,2447.41,355,704550,1985,-317860
2011-06-07,52 ( 4 %),275,600810,2184.76,247,423020,1713,177790
2011-06-06,50 ( -0.99 %),133,513290,3859.32,289,445400,1541,67890
2011-06-03,50.5 ( 1.41 %),193,501750,2599.74,464,608310,1311,-106560
2011-06-02,49.8 ( 4.84 %),208,585910,2816.88,238,369410,1552,216500
2011-06-01,47.5 ( 4.86 %),376,778040,2069.26,189,437580,2315,340460
2011-05-31,45.3 ( 0 %),118,238270,2019.24,122,186270,1527,52000
2011-05-30,45.3 ( -0.66 %),143,313520,2192.45,221,347100,1571,-33580
2011-05-27,45.6 ( 0.22 %),353,539110,1527.22,199,605480,3043,-66370
2011-05-26,45.5 ( 4.84 %),242,582690,2407.81,168,306260,1823,276430
2011-05-25,43.4 ( -4.82 %),110,312250,2838.64,219,564150,2576,-251900
2011-05-24,45.6 ( -5 %),134,298100,2224.63,235,616900,2625,-318800
2011-05-23,48 ( -4.95 %),178,217850,1223.88,194,481780,2483,-263930
2011-05-20,50.5 ( -1.94 %),196,361850,1846.17,185,437560,2365,-75710
2011-05-19,51.5 ( 0.98 %),141,302730,2147.02,159,227550,1431,75180
2011-05-18,51 ( -0.97 %),175,265900,1519.43,127,205410,1617,60490
2011-05-17,51.5 ( 0 %),142,269170,1895.56,150,181190,1208,87980
2011-05-16,51.5 ( -1.9 %),111,268590,2419.73,211,333180,1579,-64590
2011-05-13,52.5 ( 0 %),128,420790,3287.42,241,342150,1420,78640
2011-05-12,52.5 ( 0 %),125,287850,2302.8,179,224610,1255,63240
2011-05-11,52.5 ( -0.94 %),141,536480,3804.82,202,496240,2457,40240
2011-05-10,53 ( 0 %),131,322260,2460,304,349550,1150,-27290
2011-05-09,53 ( 1.92 %),117,402780,3442.56,261,369870,1417,32910
2011-05-06,52 ( 0.97 %),153,302930,1979.93,360,446760,1241,-143830
2011-05-05,51.5 ( 0.98 %),91,226750,2491.76,189,201150,1064,25600
2011-05-04,51.5 ( 0.98 %),132,280730,2126.74,189,261370,1383,19360
2011-04-29,51 ( 0.99 %),151,398310,2637.81,243,332800,1370,65510
2011-04-28,50.5 ( -0.98 %),174,205300,1179.89,180,229410,1274,-24110
2011-04-27,51 ( 0 %),299,385060,1287.83,190,528110,2780,-143050
2011-04-26,51 ( -1.92 %),111,240580,2167.39,299,373350,1249,-132770
2011-04-25,52 ( 4.21 %),180,224520,1247.33,147,190640,1297,33880
2011-04-22,49.9 ( -1.19 %),210,216830,1032.52,191,248620,1302,-31790
2011-04-21,50.5 ( 0 %),269,294080,1093.23,120,197360,1645,96720
2011-04-20,50.5 ( -0.98 %),358,458680,1281.23,160,515180,3220,-56500
2011-04-19,51 ( -0.97 %),289,292410,1011.8,126,221640,1759,70770
2011-04-18,51.5 ( -2.83 %),186,204190,1097.8,141,236720,1679,-32530
2011-04-15,53 ( 0 %),298,477720,1603.09,155,393050,2536,84670
2011-04-14,53 ( -3.64 %),227,273010,1202.69,191,336340,1761,-63330
2011-04-13,55 ( -4.35 %),188,293140,1559.26,368,457430,1243,-164290
2011-04-08,57.5 ( 0 %),182,425970,2340.49,485,639040,1318,-213070
2011-04-07,57.5 ( 0.88 %),537,1743990,3247.65,1238,2279740,1841,-535750
2011-04-06,57 ( 4.59 %),313,2110530,6742.91,184,324410,1763,1786120
2011-04-05,54.5 ( 4.81 %),274,1736500,6337.59,140,122720,877,1613780
2011-04-04,52 ( 4.21 %),262,1304840,4980.31,141,131820,935,1173020
2011-04-01,49.9 ( -2.16 %),295,168810,572.24,196,265280,1353,-96470
2011-03-31,51 ( 0 %),164,114610,698.84,166,188310,1134,-73700
2011-03-30,51 ( -0.97 %),235,328920,1399.66,190,287220,1512,41700
2011-03-29,51.5 ( -0.96 %),184,127100,690.76,191,151720,794,-24620
2011-03-28,52 ( -0.95 %),240,190550,793.96,194,187630,967,2920
2011-03-25,52.5 ( -0.94 %),215,201100,935.35,171,207930,1216,-6830
2011-03-24,53 ( -0.93 %),141,112170,795.53,210,218920,1042,-106750
2011-03-23,53.5 ( 0.94 %),109,248430,2279.17,231,207310,897,41120
2011-03-22,53 ( 0 %),174,346400,1990.8,248,355250,1432,-8850
2011-03-21,53 ( 0 %),172,368700,2143.6,280,499550,1784,-130850
2011-03-18,53 ( 1.92 %),337,703860,2088.61,178,501840,2819,202020
2011-03-17,52 ( -0.95 %),256,278130,1086.45,150,217950,1453,60180
2011-03-16,52.5 ( 0 %),241,420580,1745.15,206,399930,1941,20650
2011-03-15,52.5 ( -0.94 %),229,393770,1719.52,178,370420,2081,23350
2011-03-14,53 ( -1.85 %),199,396590,1992.91,212,350500,1653,46090
2011-03-11,54 ( -0.92 %),290,450910,1554.86,275,558630,2031,-107720
2011-03-10,54.5 ( 0.93 %),295,576350,1953.73,217,583020,2687,-6670
2011-03-09,54 ( -1.82 %),231,484280,2096.45,228,375430,1647,108850
2011-03-08,55 ( 1.85 %),172,459350,2670.64,225,370450,1646,88900
2011-03-07,54 ( 0 %),123,286030,2325.45,237,360200,1520,-74170
2011-03-04,54 ( 0 %),163,381590,2341.04,339,618990,1826,-237400
2011-03-03,54 ( 0 %),236,471190,1996.57,317,511170,1613,-39980
2011-03-02,54 ( -0.92 %),288,846310,2938.58,416,801650,1927,44660
2011-03-01,54.5 ( 0.93 %),209,536340,2566.22,197,430690,2186,105650
2011-02-28,54 ( -2.7 %),290,686740,2368.07,435,937890,2156,-251150
2011-02-25,55.5 ( 4.72 %),440,925290,2102.93,346,633580,1831,291710
2011-02-24,53 ( -0.93 %),464,977590,2106.88,347,898820,2590,78770
2011-02-23,53.5 ( -0.93 %),497,840840,1691.83,269,678760,2523,162080
2011-02-22,54 ( -2.7 %),439,1253050,2854.33,265,830610,3134,422440
2011-02-21,55.5 ( -4.31 %),351,436460,1243.48,306,559420,1828,-122960
2011-02-18,58 ( -4.92 %),747,852210,1140.84,299,1289130,4311,-436920
2011-02-17,61 ( 0 %),321,463880,1445.11,225,416790,1852,47090
2011-02-16,61 ( -0.81 %),336,559350,1664.73,176,380590,2162,178760
2011-02-15,61.5 ( 0 %),362,488490,1349.42,183,487090,2662,1400
2011-02-14,61.5 ( -0.81 %),455,590260,1297.27,233,805120,3455,-214860
2011-02-11,62 ( -0.8 %),537,930550,1732.87,211,934550,4429,-4000
2011-02-10,62.5 ( -0.79 %),392,679820,1734.23,208,648320,3117,31500
2011-02-09,63 ( -0.79 %),228,340720,1494.39,315,589340,1871,-248620
2011-02-08,63.5 ( 0.79 %),277,760560,2745.7,249,705390,2833,55170
2011-01-28,63 ( -3.08 %),239,506460,2119.08,462,1105130,2392,-598670
2011-01-27,65 ( 4.84 %),333,996280,2991.83,245,514440,2100,481840
2011-01-26,62 ( -0.8 %),430,647140,1504.98,147,480540,3269,166600
2011-01-25,62.5 ( -0.79 %),225,639090,2840.4,276,682830,2474,-43740
2011-01-24,63 ( -1.56 %),202,469750,2325.5,282,537070,1905,-67320
2011-01-21,64 ( 0.79 %),252,466960,1853.02,381,641120,1683,-174160
2011-01-20,63.5 ( -1.55 %),211,355640,1685.5,209,364820,1746,-9180
2011-01-19,64.5 ( -0.77 %),169,373500,2210.06,369,586210,1589,-212710
2011-01-18,65 ( 0 %),211,621320,2944.64,548,762340,1391,-141020
2011-01-17,65 ( 2.36 %),402,834460,2075.77,430,850560,1978,-16100
2011-01-14,63.5 ( 4.96 %),384,1433230,3732.37,165,186470,1130,1246760
2011-01-13,60.5 ( -0.82 %),324,450360,1390,140,363760,2598,86600
2011-01-12,61 ( -2.4 %),302,591220,1957.68,192,632030,3292,-40810
2011-01-11,62.5 ( 0 %),173,430520,2488.55,221,374020,1692,56500
2011-01-10,62.5 ( 0.81 %),295,780240,2644.88,260,512770,1972,267470
2011-01-07,62 ( -0.8 %),267,725060,2715.58,226,689820,3052,35240
2011-01-06,62.5 ( 0 %),233,427670,1835.49,166,324010,1952,103660
2011-01-05,62.5 ( -1.57 %),323,496700,1537.77,232,745920,3215,-249220
2011-01-04,63.5 ( -1.55 %),237,371240,1566.41,189,482220,2551,-110980
2010-12-31,64.5 ( 1.57 %),196,519340,2649.69,220,453730,2062,65610
2010-12-30,63.5 ( -1.55 %),281,761530,2710.07,192,783780,4082,-22250
2010-12-29,64.5 ( -0.77 %),234,486880,2080.68,206,645970,3136,-159090
2010-12-28,65 ( 0.78 %),232,578260,2492.5,175,476330,2722,101930
2010-12-27,64.5 ( 0 %),221,502010,2271.54,189,404520,2140,97490
2010-12-24,64.5 ( -0.77 %),249,484200,1944.58,200,386880,1934,97320
2010-12-23,65 ( 0.78 %),309,688870,2229.35,194,523810,2700,165060
2010-12-22,64.5 ( -0.77 %),353,631060,1787.71,209,437870,2095,193190
2010-12-21,65 ( -1.52 %),455,789730,1735.67,205,797740,3891,-8010
2010-12-20,66 ( 0 %),414,621970,1502.34,177,614810,3474,7160
2010-12-17,66 ( 0.76 %),434,675340,1556.08,167,616010,3689,59330
2010-12-16,65.5 ( -2.96 %),486,738830,1520.23,220,828680,3767,-89850
2010-12-15,67.5 ( -2.17 %),346,621140,1795.2,271,745520,2751,-124380
2010-12-14,69 ( -0.72 %),205,526930,2570.39,352,686770,1951,-159840
2010-12-13,69.5 ( 1.46 %),384,630030,1640.7,323,682130,2112,-52100
2010-12-10,68.5 ( 0.74 %),311,628150,2019.77,273,592760,2171,35390
2010-12-09,68 ( 1.49 %),262,331860,1266.64,136,276220,2031,55640
2010-12-08,67 ( -0.74 %),302,273290,904.93,153,279620,1828,-6330
2010-12-07,67.5 ( -1.46 %),334,510730,1529.13,173,541940,3133,-31210
2010-12-06,68.5 ( -0.72 %),673,874540,1299.47,187,772430,4131,102110
2010-12-03,69 ( 0 %),404,355620,880.25,205,499490,2437,-143870
2010-12-02,69 ( 0.73 %),290,301880,1040.97,161,342410,2127,-40530
2010-12-01,68.5 ( -2.14 %),440,864720,1965.27,244,1045660,4285,-180940
2010-11-30,70 ( -0.71 %),212,386640,1823.77,264,674780,2556,-288140
2010-11-29,70.5 ( 2.92 %),137,277650,2026.64,146,337320,2310,-59670
2010-11-26,68.5 ( -2.14 %),177,177440,1002.49,193,288370,1494,-110930
2010-11-25,70 ( -1.41 %),173,160810,929.54,196,226060,1153,-65250
2010-11-24,71 ( 1.43 %),115,192150,1670.87,179,203180,1135,-11030
2010-11-23,70 ( 1.45 %),142,331760,2336.34,152,274040,1803,57720
2010-11-22,69 ( 1.47 %),180,301720,1676.22,111,222840,2008,78880
2010-11-19,68 ( -1.45 %),235,320430,1363.53,141,446940,3170,-126510
2010-11-18,69 ( 0.73 %),204,299680,1469.02,80,264660,3308,35020
2010-11-17,68.5 ( -1.44 %),239,429880,1798.66,110,603290,5484,-173410
2010-11-16,69.5 ( -0.71 %),190,444590,2339.95,153,417830,2731,26760
2010-11-15,70 ( -2.78 %),201,352520,1753.83,106,308310,2909,44210
2010-11-12,72 ( -0.69 %),332,486920,1466.63,169,370080,2190,116840
2010-11-11,72.5 ( -2.03 %),172,222300,1292.44,137,288910,2109,-66610
2010-11-10,74 ( 1.37 %),172,432540,2514.77,206,395850,1922,36690
2010-11-09,73 ( 0.69 %),225,520240,2312.18,204,510180,2501,10060
2010-11-08,72.5 ( -4.61 %),169,322880,1910.53,269,728520,2708,-405640
2010-11-05,76 ( 3.4 %),216,782130,3620.97,335,767540,2291,14590
2010-11-04,73.5 ( 0.68 %),125,164710,1317.68,133,147610,1110,17100
2010-11-03,73 ( 0 %),149,245910,1650.4,151,209730,1389,36180
2010-11-02,73 ( -2.01 %),134,239030,1783.81,177,265680,1501,-26650
2010-11-01,74.5 ( -2.61 %),277,425610,1536.5,283,531330,1877,-105720
2010-10-29,76.5 ( 4.08 %),351,1462960,4167.98,672,1217040,1811,245920
2010-10-28,73.5 ( 1.38 %),187,832980,4454.44,390,799690,2050,33290
2010-10-27,72.5 ( 1.4 %),225,839240,3729.96,438,945960,2160,-106720
2010-10-26,71.5 ( 2.88 %),224,704570,3145.4,178,533130,2995,171440
2010-10-25,69.5 ( 0 %),175,584020,3337.26,166,493190,2971,90830
2010-10-22,69.5 ( 0 %),158,287530,1819.81,105,259950,2476,27580
2010-10-21,69.5 ( -1.42 %),191,297210,1556.07,110,378370,3440,-81160
2010-10-20,70.5 ( -1.4 %),135,287020,2126.07,197,509770,2588,-222750
2010-10-19,71.5 ( 0 %),119,359080,3017.48,182,515520,2833,-156440
2010-10-18,71.5 ( 0 %),99,266880,2695.76,147,387690,2637,-120810
2010-10-15,71.5 ( -2.05 %),196,525750,2682.4,210,748570,3565,-222820
2010-10-14,73 ( 0.69 %),125,426200,3409.6,221,421140,1906,5060
2010-10-13,72.5 ( 1.4 %),167,493330,2954.07,152,376470,2477,116860
2010-10-12,71.5 ( -0.69 %),104,177650,1708.17,110,222760,2025,-45110
2010-10-11,72 ( -1.37 %),157,262160,1669.81,128,296740,2318,-34580
2010-10-08,73 ( -0.68 %),110,285280,2593.45,258,467690,1813,-182410
2010-10-07,73.5 ( 1.38 %),241,825170,3423.94,414,646910,1563,178260
2010-10-06,72.5 ( 0.69 %),127,340110,2678.03,208,387770,1864,-47660
2010-10-05,72 ( 1.41 %),175,522260,2984.34,192,403770,2103,118490
2010-10-04,71 ( 0 %),102,341230,3345.39,214,387860,1812,-46630
2010-10-01,71 ( 0 %),153,378670,2474.97,207,361070,1744,17600
2010-09-30,71 ( 0.71 %),118,416350,3528.39,215,523930,2437,-107580
2010-09-29,70.5 ( -0.7 %),161,283620,1761.61,158,420940,2664,-137320
2010-09-28,71 ( 1.43 %),128,380180,2970.16,134,296430,2212,83750
2010-09-27,70 ( -0.71 %),181,230470,1273.31,130,270520,2081,-40050
2010-09-24,70.5 ( -1.4 %),277,343380,1239.64,139,397560,2860,-54180
2010-09-23,71.5 ( 0 %),225,466740,2074.4,154,431350,2801,35390
2010-09-22,71.5 ( -0.69 %),268,402550,1502.05,144,346350,2405,56200
2010-09-21,72 ( -1.37 %),195,330670,1695.74,187,387700,2073,-57030
2010-09-20,73 ( -0.68 %),116,165180,1423.97,164,238420,1454,-73240
2010-09-17,73.5 ( 2.08 %),149,336900,2261.07,193,328910,1704,7990
2010-09-16,72 ( -1.37 %),130,237190,1824.54,175,253420,1448,-16230
2010-09-15,73 ( 0 %),99,170260,1719.8,209,284640,1362,-114380
2010-09-14,73 ( 0 %),96,156030,1625.31,129,122220,947,33810
2010-09-13,73 ( 0.69 %),89,229720,2581.12,154,222160,1443,7560
2010-09-10,72.5 ( -1.36 %),120,309260,2577.17,210,299610,1427,9650
2010-09-09,73.5 ( 1.38 %),118,390170,3306.53,173,283000,1636,107170
2010-09-08,72.5 ( -0.68 %),155,367020,2367.87,157,366740,2336,280
2010-09-07,73 ( -1.35 %),213,475540,2232.58,205,592340,2889,-116800
2010-09-06,74 ( -0.67 %),196,751120,3832.24,373,792480,2125,-41360
2010-09-01,74.5 ( -0.67 %),325,563250,1733.08,228,629320,2760,-66070
2010-08-31,75 ( 4.17 %),191,996680,5218.22,316,764820,2420,231860
2010-08-30,72 ( 2.86 %),159,364280,2291.07,149,450680,3025,-86400
2010-08-27,70 ( 0 %),134,335210,2501.57,116,228750,1972,106460
2010-08-26,70 ( 0.72 %),237,636950,2687.55,142,356940,2514,280010
2010-08-25,69.5 ( -0.71 %),172,553590,3218.55,174,508880,2925,44710
2010-08-24,70 ( -4.11 %),194,362360,1867.84,129,395180,3063,-32820
2010-08-23,73 ( -2.67 %),90,161580,1795.33,170,273770,1610,-112190
2010-08-20,75 ( 4.17 %),123,320410,2604.96,127,228480,1799,91930
2010-08-19,72 ( -0.69 %),138,334310,2422.54,120,240610,2005,93700
2010-08-18,72.5 ( -3.33 %),93,180020,1935.7,126,235660,1870,-55640
2010-08-17,75 ( 2.04 %),106,210970,1990.28,163,342820,2103,-131850
2010-08-16,73.5 ( 3.52 %),178,425900,2392.7,80,177810,2223,248090
2010-08-13,71 ( 0 %),195,388420,1991.9,118,277090,2348,111330
2010-08-12,71 ( -4.05 %),123,338480,2751.87,137,346130,2526,-7650
2010-08-11,74 ( 1.37 %),86,232470,2703.14,86,144030,1675,88440
2010-08-10,74 ( -1.33 %),152,600360,3949.74,204,493560,2419,106800
2010-08-09,75 ( -2.6 %),165,491720,2980.12,157,376020,2395,115700
2010-08-06,77 ( -2.53 %),273,476570,1745.68,249,611300,2455,-134730
2010-08-05,79 ( 4.64 %),111,492930,4440.81,275,552520,2009,-59590
2010-08-04,75.5 ( -3.21 %),175,452260,2584.34,218,581720,2668,-129460
2010-08-03,78 ( 1.96 %),170,725300,4266.47,365,749280,2053,-23980
2010-08-02,76.5 ( -0.65 %),138,439660,3185.94,229,493460,2155,-53800
2010-07-30,77 ( 3.36 %),360,1256110,3489.19,438,1378080,3146,-121970
2010-07-29,74.5 ( 4.93 %),146,891540,6106.44,323,510690,1581,380850
2010-07-28,71 ( -2.07 %),149,312080,2094.5,177,338950,1915,-26870
2010-07-27,72.5 ( 4.32 %),259,1316740,5083.94,492,984380,2001,332360
2010-07-26,69.5 ( -1.42 %),107,247850,2316.36,170,285170,1677,-37320
2010-07-23,70.5 ( 0.71 %),106,371650,3506.13,284,403920,1422,-32270
2010-07-22,70 ( 0.72 %),123,665520,5410.73,441,635000,1440,30520
2010-07-21,69.5 ( -0.71 %),93,299540,3220.86,229,374610,1636,-75070
2010-07-20,70 ( 0 %),109,302200,2772.48,280,345700,1235,-43500
2010-07-19,70 ( 0.72 %),100,250940,2509.4,250,278660,1115,-27720
2010-07-16,69.5 ( 0 %),70,149220,2131.71,261,220630,845,-71410
2010-07-15,69.5 ( 1.46 %),100,301140,3011.4,258,332340,1288,-31200
2010-07-14,68.5 ( -1.44 %),87,149110,1713.91,203,320830,1580,-171720
2010-07-13,69.5 ( 1.46 %),162,710310,4384.63,399,696420,1745,13890
2010-07-12,68.5 ( -0.72 %),137,270740,1976.2,210,210400,1002,60340
2010-07-09,69 ( -0.72 %),85,123840,1456.94,139,218520,1572,-94680
2010-07-08,69.5 ( 2.96 %),126,371180,2945.87,238,312150,1312,59030
2010-07-07,67.5 ( -0.74 %),63,152400,2419.05,150,297270,1982,-144870
2010-07-06,68 ( -0.73 %),143,338620,2367.97,158,498090,3152,-159470
2010-07-05,68.5 ( 0.74 %),86,273070,3175.23,168,338440,2015,-65370
2010-07-02,68 ( -2.86 %),175,240420,1373.83,174,288960,1661,-48540
2010-07-01,70 ( 1.45 %),191,512290,2682.15,155,356850,2302,155440
2010-06-30,69 ( -0.72 %),119,312810,2628.66,174,208740,1200,104070
2010-06-29,69.5 ( 2.21 %),163,752000,4613.5,278,668660,2405,83340
2010-06-28,68 ( -0.73 %),126,205470,1630.71,82,144090,1757,61380
2010-06-25,68.5 ( -1.44 %),130,264620,2035.54,134,242920,1813,21700
2010-06-24,69.5 ( 2.96 %),181,550110,3039.28,268,397820,1484,152290
2010-06-23,67.5 ( -3.57 %),93,126370,1358.82,201,263610,1311,-137240
2010-06-22,70 ( 1.45 %),105,380050,3619.52,282,373540,1325,6510
2010-06-21,69 ( 2.22 %),99,280370,2832.02,236,358750,1520,-78380
2010-06-18,67.5 ( -1.46 %),146,333930,2287.19,272,438400,1612,-104470
2010-06-17,68.5 ( 1.48 %),112,462320,4127.86,302,441700,1463,20620
2010-06-16,67.5 ( 1.5 %),112,284360,2538.93,190,241950,1273,42410
2010-06-15,66.5 ( -2.92 %),132,275130,2084.32,218,399820,1834,-124690
2010-06-14,68.5 ( 2.24 %),138,352520,2554.49,281,351250,1250,1270
2010-06-11,67 ( 0.75 %),78,247040,3167.18,260,379010,1458,-131970
2010-06-10,66.5 ( 0.76 %),116,427950,3689.22,251,327630,1305,100320
2010-06-09,66 ( 1.54 %),90,457200,5080,182,289920,1593,167280
2010-06-08,65 ( 0.78 %),155,691780,4463.1,140,321810,2299,369970
2010-06-07,64.5 ( -3.73 %),120,382780,3189.83,207,473850,2289,-91070
2010-06-04,67 ( 0.75 %),104,388420,3734.81,327,382690,1170,5730
2010-06-03,66.5 ( 0.76 %),145,614360,4236.97,255,568810,2231,45550
2010-06-02,66 ( 0 %),134,537730,4012.91,234,624790,2670,-87060
2010-06-01,66 ( 1.54 %),130,443550,3411.92,199,429570,2159,13980
2010-05-31,65 ( -1.52 %),115,356570,3100.61,246,448010,1821,-91440
2010-05-28,66 ( 0.76 %),204,669610,3282.4,329,963200,2928,-293590
2010-05-27,65.5 ( 1.55 %),156,941380,6034.49,245,935910,3820,5470
2010-05-26,64.5 ( 0 %),159,370230,2328.49,252,626890,2488,-256660
2010-05-25,64.5 ( 4.88 %),167,459840,2753.53,202,270140,1337,189700
2010-05-24,61.5 ( 4.24 %),143,287010,2007.06,102,155120,1521,131890
2010-05-21,59 ( -4.07 %),215,491700,2286.98,185,438780,2372,52920
2010-05-20,61.5 ( 3.36 %),170,399740,2351.41,96,133090,1386,266650
2010-05-19,59.5 ( -2.46 %),229,529150,2310.7,160,424140,2651,105010
2010-05-18,61 ( 0 %),187,408270,2183.26,115,347260,3020,61010
2010-05-17,61 ( -3.94 %),211,217640,1031.47,113,377120,3337,-159480
2010-05-14,63.5 ( 0 %),155,105730,682.13,101,173820,1721,-68090
2010-05-13,63.5 ( 1.6 %),217,212970,981.43,90,159290,1770,53680
2010-05-12,62.5 ( -2.34 %),234,152670,652.44,150,186140,1241,-33470
2010-05-11,64 ( 0 %),328,213320,650.37,139,354230,2548,-140910
2010-05-10,85.5 ( -1.16 %),317,468200,1476.97,173,507610,2934,-39410
2010-05-07,86.5 ( -1.14 %),286,344860,1205.8,173,387650,2241,-42790
2010-05-06,87.5 ( -1.69 %),258,449120,1740.78,171,445720,2607,3400
2010-05-05,89 ( 0.56 %),182,413640,2272.75,236,451530,1913,-37890
2010-05-04,88.5 ( 0.57 %),149,150180,1007.92,265,308670,1165,-158490
2010-04-29,88 ( -0.56 %),194,591800,3050.52,267,611740,2291,-19940
2010-04-28,88.5 ( 0 %),82,212170,2587.44,225,343610,1527,-131440
2010-04-27,88.5 ( 0 %),70,381550,5450.71,363,586640,1616,-205090
2010-04-26,88.5 ( 0.57 %),112,317160,2831.79,354,487320,1377,-170160
2010-04-22,88 ( 2.33 %),163,411990,2527.55,261,491960,1885,-79970
2010-04-21,86 ( 0 %),96,240300,2503.12,170,309150,1819,-68850
2010-04-20,86 ( 0 %),122,254530,2086.31,159,325960,2050,-71430
2010-04-19,86 ( -1.15 %),77,342590,4449.22,184,476630,2590,-134040
2010-04-16,87 ( -0.57 %),84,242010,2881.07,224,349610,1561,-107600
2010-04-15,87.5 ( 0 %),93,399030,4290.65,279,556330,1994,-157300
2010-04-14,87.5 ( 0.57 %),88,316440,3595.91,221,271320,1228,45120
2010-04-13,87 ( 0 %),97,513420,5292.99,304,501900,1651,11520
2010-04-12,87 ( 1.16 %),87,388520,4465.75,236,331070,1403,57450
2010-04-09,86 ( 0 %),97,228780,2358.56,209,256230,1226,-27450
2010-04-08,86 ( -0.58 %),105,253020,2409.71,240,333800,1391,-80780
2010-04-07,86.5 ( 0.58 %),98,297700,3037.76,274,341840,1248,-44140
2010-04-06,86 ( 0 %),87,361020,4149.66,411,668350,1626,-307330
2010-04-05,86 ( 0 %),92,230160,2501.74,348,477100,1371,-246940
2010-04-02,86 ( 1.18 %),106,513460,4843.96,538,697200,1296,-183740
2010-04-01,85 ( 1.8 %),111,468930,4224.59,295,466280,1581,2650
2010-03-31,83.5 ( 0 %),123,253290,2059.27,218,354330,1625,-101040
2010-03-30,83.5 ( -1.18 %),291,475360,1633.54,180,414870,2305,60490
2010-03-29,84.5 ( 1.81 %),172,211330,1228.66,215,340420,1583,-129090
2010-03-26,83 ( -0.6 %),276,399770,1448.44,139,274030,1971,125740
2010-03-25,83.5 ( -1.76 %),196,331410,1690.87,268,487370,1819,-155960
2010-03-24,85 ( 2.41 %),200,548560,2742.8,249,355830,1429,192730
2010-03-23,83 ( -1.19 %),247,317860,1286.88,211,374000,1773,-56140
2010-03-22,84 ( -2.33 %),232,311080,1340.86,194,322690,1663,-11610
2010-03-19,86 ( -0.58 %),166,301610,1816.93,321,634680,1977,-333070
2010-03-18,86.5 ( 2.37 %),186,317010,1704.35,212,276040,1302,40970
2010-03-17,84.5 ( 0.6 %),308,671940,2181.62,253,522480,2065,149460
2010-03-16,84 ( -4.55 %),417,776470,1862.04,357,1156630,3240,-380160
2010-03-15,88 ( -1.12 %),239,430070,1799.46,321,605440,1886,-175370
2010-03-12,89 ( 0 %),272,522930,1922.54,437,612360,1401,-89430
2010-03-11,89 ( 1.14 %),301,489700,1626.91,659,858490,1303,-368790
2010-03-10,88 ( 4.76 %),629,2409140,3830.11,856,1470300,1718,938840
2010-03-09,84 ( 1.82 %),188,903590,4806.33,405,625640,1545,277950
2010-03-08,82.5 ( 0.61 %),161,542050,3366.77,259,534740,2065,7310
2010-03-05,82 ( -0.61 %),97,367010,3783.61,333,556190,1670,-189180
2010-03-04,82.5 ( 1.85 %),132,545640,4133.64,336,498860,1485,46780
2010-03-03,81 ( 1.25 %),119,427090,3588.99,197,379290,1925,47800
2010-03-02,80 ( 0 %),141,451470,3201.91,142,333630,2350,117840
2010-03-01,80 ( 2.56 %),139,300000,2158.27,116,204920,1767,95080
2010-02-26,78 ( -3.11 %),579,1136870,1963.51,127,934250,7356,202620
2010-02-25,80.5 ( 0 %),255,337600,1323.92,119,486570,4089,-148970
2010-02-24,80.5 ( 0 %),216,437670,2026.25,87,252090,2898,185580
2010-02-23,80.5 ( -3.59 %),183,201130,1099.07,122,204250,1674,-3120
2010-02-22,83.5 ( -0.6 %),108,216370,2003.43,197,336900,1710,-120530
2010-02-12,84 ( 0.6 %),116,432390,3727.5,295,549650,1863,-117260
2010-02-11,83.5 ( 1.83 %),109,277640,2547.16,193,270870,1403,6770
2010-02-10,82 ( 3.14 %),78,157540,2019.74,135,165950,1229,-8410
2010-02-09,79.5 ( -4.22 %),205,327640,1598.24,181,367860,2032,-40220
2010-02-08,83 ( 2.47 %),153,410280,2681.57,209,319170,1527,91110
2010-02-05,81 ( -4.14 %),115,325830,2833.3,344,529730,1540,-203900
2010-02-04,84.5 ( 0 %),131,579570,4424.2,554,675250,1219,-95680
2010-02-03,84.5 ( 4.32 %),224,1143500,5104.91,789,1067430,1353,76070
2010-02-02,81 ( 3.85 %),126,642690,5100.71,565,634940,1124,7750
2010-02-01,78 ( 1.3 %),101,314100,3109.9,194,272880,1407,41220
2010-01-29,77 ( -1.28 %),142,154240,1086.2,121,200590,1658,-46350
2010-01-28,78 ( 0 %),91,105020,1154.07,131,129970,992,-24950
2010-01-27,78 ( -3.7 %),163,184470,1131.72,213,300630,1411,-116160
2010-01-26,81 ( 3.18 %),165,245180,1485.94,255,203880,800,41300
2010-01-25,78.5 ( 0.64 %),88,167000,1897.73,119,95810,805,71190
2010-01-22,78 ( 0 %),121,244500,2020.66,208,290250,1395,-45750
2010-01-21,78 ( -1.27 %),151,456230,3021.39,244,420560,1724,35670
2010-01-20,79 ( 1.94 %),182,663020,3642.97,399,533490,1337,129530
2010-01-19,77.5 ( 1.97 %),137,323130,2358.61,199,289520,1455,33610
2010-01-18,76 ( -1.94 %),115,201140,1749.04,188,213640,1136,-12500
2010-01-15,77.5 ( -1.9 %),125,201900,1615.2,240,237050,988,-35150
2010-01-14,79 ( 0.64 %),134,208740,1557.76,194,271200,1398,-62460
2010-01-13,78.5 ( 3.29 %),200,278140,1390.7,160,206980,1294,71160
2010-01-12,76 ( -1.94 %),223,390420,1750.76,187,350260,1873,40160
2010-01-11,77.5 ( -0.64 %),247,229300,928.34,137,258930,1890,-29630
2010-01-08,78 ( -3.11 %),208,230340,1107.4,270,478550,1772,-248210
2010-01-07,80.5 ( -0.62 %),198,217510,1098.54,255,342480,1343,-124970
2010-01-06,81 ( -1.82 %),221,230380,1042.44,375,419150,1118,-188770
2010-01-05,82.5 ( 0 %),187,263590,1409.57,387,608790,1573,-345200
2010-01-04,82.5 ( 4.43 %),243,365660,1504.77,200,300880,1504,64780
2009-12-31,79 ( 1.28 %),235,449320,1912,205,404200,1972,45120
2009-12-30,78 ( 1.3 %),182,191710,1053.35,145,183700,1267,8010
2009-12-29,77 ( -2.53 %),232,275610,1187.97,205,465710,2272,-190100
2009-12-28,79 ( -2.47 %),191,328480,1719.79,489,905430,1852,-576950
2009-12-25,81 ( 2.53 %),115,250580,2178.96,268,316820,1182,-66240
2009-12-24,79 ( 2.6 %),198,605510,3058.13,410,497340,1213,108170
2009-12-23,77 ( 4.76 %),185,711140,3844,254,338470,1333,372670
2009-12-22,73.5 ( 5 %),147,617980,4203.95,108,177150,1640,440830
2009-12-21,70 ( 4.48 %),283,852610,3012.76,23,60410,2627,792200
2009-12-18,67 ( -4.29 %),369,1236580,3351.17,136,562920,4139,673660
2009-12-17,70 ( -2.78 %),183,455880,2491.15,122,296510,2430,159370
2009-12-16,72 ( -3.36 %),98,334890,3417.24,281,451420,1606,-116530
2009-12-15,74.5 ( 0.68 %),113,279480,2473.27,212,216400,1021,63080
2009-12-14,74 ( 4.96 %),149,332960,2234.63,120,195580,1630,137380
2009-12-11,72 ( -1.37 %),207,389330,1880.82,214,360230,1683,29100
2009-12-10,73 ( -0.68 %),174,568850,3269.25,199,592310,2976,-23460
2009-12-09,73.5 ( -3.92 %),221,365400,1653.39,168,417390,2484,-51990
2009-12-08,76.5 ( -1.29 %),118,188960,1601.36,172,213110,1239,-24150
2009-12-07,77.5 ( 1.97 %),161,413690,2569.5,127,211340,1664,202350
2009-12-04,76 ( 0 %),191,329180,1723.46,164,459930,2804,-130750
2009-12-03,76 ( -2.56 %),246,680810,2767.52,255,703020,2757,-22210
2009-12-02,78 ( -1.89 %),156,279830,1793.78,284,474170,1670,-194340
2009-12-01,79.5 ( 0 %),164,281540,1716.71,236,404280,1713,-122740
2009-11-30,79.5 ( 4.61 %),133,449070,3376.47,253,350110,1384,98960
2009-11-27,76 ( 4.83 %),335,649110,1937.64,184,443040,2408,206070
2009-11-26,72.5 ( -4.61 %),164,362310,2209.21,246,716850,2914,-354540
2009-11-25,76 ( -5 %),300,520980,1736.6,242,726580,3002,-205600
2009-11-24,80 ( -2.44 %),304,408650,1344.24,185,583160,3152,-174510
2009-11-23,82 ( -2.38 %),292,357430,1224.08,219,483660,2208,-126230
2009-11-20,84 ( 0 %),190,190570,1003,195,263380,1351,-72810
2009-11-19,84 ( 1.2 %),210,292600,1393.33,219,215320,983,77280
2009-11-18,83 ( 0.61 %),211,341900,1620.38,222,429270,1934,-87370
2009-11-17,82.5 ( 0.61 %),191,332620,1741.47,218,414550,1902,-81930
2009-11-16,82 ( -2.38 %),306,513440,1677.91,255,873400,3425,-359960
2009-11-13,84 ( 0 %),184,249660,1356.85,240,511960,2133,-262300
2009-11-12,84 ( 2.44 %),203,524360,2583.05,268,580150,2165,-55790
2009-11-11,82 ( 2.5 %),223,403560,1809.69,197,481920,2446,-78360
2009-11-10,80 ( -1.84 %),278,482460,1735.47,270,598490,2217,-116030
2009-11-09,81.5 ( -0.61 %),176,442630,2514.94,302,451360,1495,-8730
2009-11-06,82 ( -2.96 %),220,261930,1190.59,255,524070,2055,-262140
2009-11-05,84.5 ( 3.05 %),202,317000,1569.31,177,234040,1322,82960
2009-11-04,82 ( 1.23 %),306,702450,2295.59,263,523410,1990,179040
2009-11-03,81 ( -1.22 %),278,440760,1585.47,303,286670,946,154090
2009-11-02,82 ( -4.65 %),307,623890,2032.21,319,884570,2773,-260680
2009-10-30,86 ( 1.18 %),341,548070,1607.24,238,479680,2015,68390
2009-10-29,85 ( -2.86 %),395,542430,1373.24,320,521370,1629,21060
2009-10-28,87.5 ( -0.57 %),280,219800,785,261,400660,1535,-180860
2009-10-27,88 ( -1.12 %),343,705780,2057.67,338,675230,1998,30550
2009-10-26,89 ( -0.56 %),279,761480,2729.32,346,703510,2033,57970
2009-10-23,89.5 ( -1.1 %),218,546710,2507.84,639,873740,1367,-327030
2009-10-22,90.5 ( 1.69 %),417,766160,1837.31,406,580380,1430,185780
2009-10-21,89 ( -1.66 %),400,463600,1159,439,645360,1470,-181760
2009-10-20,90.5 ( 1.69 %),420,595120,1416.95,482,754560,1565,-159440
2009-10-19,89 ( -2.73 %),408,508060,1245.25,342,737080,2155,-229020
2009-10-16,91.5 ( -1.61 %),303,760200,2508.91,750,1198880,1599,-438680
2009-10-15,93 ( 4.49 %),391,1817910,4649.39,830,1150460,1386,667450
2009-10-14,89 ( 1.71 %),310,824990,2661.26,523,679530,1299,145460
2009-10-13,87.5 ( 0 %),231,661680,2864.42,597,761920,1276,-100240
2009-10-12,87.5 ( 1.16 %),311,900670,2896.05,690,1056340,1531,-155670
2009-10-09,86.5 ( 0 %),313,1053590,3366.1,466,883310,1896,170280
2009-10-08,86.5 ( 0 %),207,477200,2305.31,542,631760,1166,-154560
2009-10-07,86.5 ( 4.22 %),292,747950,2561.47,336,542380,1614,205570
2009-10-06,83 ( 0.61 %),340,700470,2060.21,269,550310,2046,150160
2009-10-05,82.5 ( 0 %),592,1414030,2388.56,252,947630,3760,466400
2009-10-02,82.5 ( -2.94 %),636,1073770,1688.32,411,939650,2286,134120
2009-10-01,85 ( -1.73 %),416,920300,2212.26,300,958270,3194,-37970
2009-09-30,86.5 ( 0 %),505,1277590,2529.88,400,1423910,3560,-146320
2009-09-29,86.5 ( -0.57 %),522,1178830,2258.3,380,1715770,4515,-536940
2009-09-28,87 ( 0 %),530,1161270,2191.08,349,1368480,3921,-207210
2009-09-25,87 ( 0 %),562,893090,1589.13,294,1224640,4165,-331550
2009-09-24,87 ( -1.14 %),409,681810,1667.02,358,1041120,2908,-359310
2009-09-23,88 ( -1.12 %),519,1072920,2067.28,478,1473770,3083,-400850
2009-09-22,89 ( -1.11 %),441,920980,2088.39,509,1078860,2120,-157880
2009-09-21,90 ( 0 %),314,454470,1447.36,546,1044940,1914,-590470
2009-09-18,90 ( 0 %),460,1042900,2267.17,524,1425560,2721,-382660
2009-09-17,90 ( 3.45 %),487,1432720,2941.93,560,1644220,2936,-211500
2009-09-16,87 ( -3.33 %),473,1368750,2893.76,528,1721280,3260,-352530
2009-09-15,90 ( 2.27 %),507,1128700,2226.23,763,1529600,2005,-400900
2009-09-14,88 ( 4.76 %),583,1948340,3341.92,614,1051640,1713,896700
2009-09-11,84 ( -0.59 %),287,675210,2352.65,362,747310,2064,-72100
2009-09-10,84.5 ( 0.6 %),322,693320,2153.17,301,527100,1751,166220
2009-09-09,84 ( 1.2 %),276,596660,2161.81,254,667400,2628,-70740
2009-09-08,83 ( 1.22 %),416,751530,1806.56,227,462990,2040,288540
2009-09-07,82 ( -2.38 %),473,1164150,2461.21,514,810690,1577,353460
2009-09-04,84 ( -1.75 %),379,858860,2266.12,368,957410,2602,-98550
2009-09-03,85.5 ( -2.29 %),453,863360,1905.87,405,882090,2178,-18730
2009-09-01,87.5 ( -1.69 %),478,729300,1525.73,375,554350,1478,174950
2009-08-31,89 ( 2.3 %),339,534720,1577.35,347,711850,2051,-177130
2009-08-28,87 ( 1.16 %),320,771680,2411.5,304,532750,1752,238930
2009-08-27,86 ( 0 %),614,1657500,2699.51,296,1257080,4247,400420
2009-08-26,86 ( -1.15 %),350,651860,1862.46,370,826260,2233,-174400
2009-08-25,87 ( 0.58 %),342,816650,2387.87,656,1320430,2013,-503780
2009-08-24,86.5 ( 4.85 %),471,1428390,3032.68,487,912490,1874,515900
2009-08-21,82.5 ( 2.48 %),236,887480,3760.51,701,897250,1280,-9770
2009-08-20,80.5 ( 0.62 %),187,475500,2542.78,403,471650,1170,3850
2009-08-19,80 ( 1.27 %),281,665490,2368.29,283,527340,1863,138150
2009-08-18,79 ( -0.63 %),278,713090,2565.07,292,448950,1538,264140
2009-08-17,79.5 ( -0.62 %),185,478550,2586.76,394,616310,1564,-137760
2009-08-14,80 ( -0.62 %),321,792930,2470.19,427,513020,1201,279910
2009-08-13,80.5 ( 0.62 %),239,542210,2268.66,504,676310,1342,-134100
2009-08-12,80 ( 0.63 %),189,581790,3078.25,522,614750,1178,-32960
2009-08-11,79.5 ( 0 %),196,475880,2427.96,512,565890,1105,-90010
2009-08-10,79.5 ( 1.92 %),195,599050,3072.05,482,686720,1425,-87670
2009-08-07,78 ( 0 %),155,350010,2258.13,424,415140,979,-65130
2009-08-06,78 ( 0.65 %),199,517100,2598.49,556,666050,1198,-148950
2009-08-05,77.5 ( 0 %),196,398540,2033.37,493,509850,1034,-111310
2009-08-04,77.5 ( 1.31 %),173,451800,2611.56,749,1103300,1473,-651500
2009-08-03,76.5 ( 0 %),150,290360,1935.73,481,715760,1488,-425400
2009-07-31,76.5 ( 2 %),166,647380,3899.88,519,910780,1755,-263400
2009-07-30,75 ( 0 %),205,464660,2266.63,331,389480,1177,75180
2009-07-29,75 ( 0 %),173,262410,1516.82,422,374740,888,-112330
2009-07-28,75 ( -2.6 %),216,499440,2312.22,786,941230,1197,-441790
2009-07-27,77 ( 0.65 %),297,590340,1987.68,946,1404130,1484,-813790
2009-07-24,76.5 ( 4.79 %),197,761000,3862.94,493,421560,855,339440
2009-07-23,73 ( 1.39 %),135,636910,4717.85,417,368350,883,268560
2009-07-22,72 ( 0 %),157,667680,4252.74,515,696930,1353,-29250
2009-07-21,72 ( 2.13 %),248,869880,3507.58,416,812400,1953,57480
2009-07-20,70.5 ( -2.08 %),172,530200,3082.56,357,658530,1845,-128330
2009-07-17,72 ( 0 %),168,493320,2936.43,608,688820,1133,-195500
2009-07-16,72 ( 0.7 %),163,429940,2637.67,722,874480,1211,-444540
2009-07-15,71.5 ( 2.14 %),170,560510,3297.12,355,381830,1076,178680
2009-07-14,70 ( -1.41 %),261,561200,2150.19,312,513650,1646,47550
2009-07-13,71 ( 0 %),233,787290,3378.93,363,591830,1630,195460
2009-07-10,71 ( 0 %),347,853430,2459.45,328,631470,1925,221960
2009-07-09,71 ( -1.39 %),268,550410,2053.77,352,557210,1583,-6800
2009-07-08,72 ( -0.69 %),277,698140,2520.36,391,448930,1148,249210
2009-07-07,72.5 ( -1.36 %),255,815360,3197.49,865,1062990,1229,-247630
2009-07-06,73.5 ( 4.26 %),283,878080,3102.76,523,581600,1112,296480
2009-07-03,70.5 ( 1.44 %),434,1285210,2961.31,417,570460,1368,714750
2009-07-02,69.5 ( 3.73 %),554,1163710,2100.56,269,387560,1441,776150
2009-07-01,67 ( -4.29 %),709,1453350,2049.86,397,867720,2186,585630
2009-06-30,70 ( -4.11 %),492,1168630,2375.26,578,1675120,2898,-506490
2009-06-29,73 ( -0.68 %),298,746210,2504.06,731,1319310,1805,-573100
2009-06-26,73.5 ( 2.08 %),375,1095740,2921.97,886,1377640,1555,-281900
2009-06-25,72 ( 0.7 %),474,1586530,3347.11,932,1491050,1600,95480
2009-06-24,71.5 ( 4.38 %),588,1702050,2894.64,138,234300,1698,1467750
2009-06-23,68.5 ( -4.2 %),510,1542700,3024.9,822,1409240,1714,133460
2009-06-22,71.5 ( -4.67 %),468,739800,1580.77,832,1382750,1662,-642950
2009-06-19,75 ( 4.9 %),929,2616530,2816.5,1264,1588240,1257,1028290
2009-06-18,71.5 ( 4.38 %),563,1617170,2872.42,117,157690,1348,1459480
2009-06-17,68.5 ( 4.58 %),1263,2594470,2054.21,458,991670,2165,1602800
2009-06-16,65.5 ( -3.68 %),939,2133270,2271.85,695,1537060,2212,596210
2009-06-15,68 ( -3.55 %),900,1236600,1374,592,1248320,2109,-11720
2009-06-12,70.5 ( -4.08 %),1250,1379150,1103.32,726,2180390,3003,-801240
2009-06-11,73.5 ( 0 %),1266,2085370,1647.21,546,1653350,3028,432020
2009-06-10,73.5 ( -4.55 %),564,1256220,2227.34,1047,2393280,2286,-1137060
2009-06-09,77 ( -0.65 %),864,1327650,1536.63,1057,1489970,1410,-162320
2009-06-08,77.5 ( 4.73 %),370,1012910,2737.59,181,319760,1767,693150
2009-06-05,74 ( 4.96 %),456,1669700,3661.62,640,780690,1220,889010
2009-06-04,70.5 ( 0.71 %),739,1265820,1712.88,952,1420580,1492,-154760
2009-06-03,70 ( 0 %),482,908830,1885.54,1231,1657380,1346,-748550
2009-06-02,70 ( 2.19 %),606,1337440,2207,987,1556240,1577,-218800
2009-06-01,68.5 ( 3.79 %),551,1370700,2487.66,880,1315460,1495,55240
2009-05-29,66 ( 0 %),681,1051710,1544.36,605,1175680,1943,-123970
2009-05-28,66 ( -1.49 %),500,1173090,2346.18,705,1094050,1552,79040
2009-05-27,67 ( 0 %),662,1289660,1948.13,1225,1995820,1629,-706160
2009-05-26,67 ( 0.75 %),685,1145050,1671.61,1112,1989680,1789,-844630
2009-05-25,66.5 ( 4.72 %),802,1567060,1953.94,302,860630,2850,706430
2009-05-22,63.5 ( -3.05 %),854,1446650,1693.97,633,1146310,1811,300340
2009-05-21,65.5 ( -2.24 %),965,1517600,1572.64,879,1387110,1578,130490
2009-05-20,67 ( 0 %),929,1866330,2008.97,1114,2434030,2185,-567700
2009-05-19,67 ( 0.75 %),827,1359690,1644.12,939,2825390,3009,-1465700
2009-05-18,66.5 ( 0 %),588,1023190,1740.12,704,1382180,1963,-358990
2009-05-15,66.5 ( 4.72 %),980,1588290,1620.7,465,1147910,2469,440380
2009-05-14,63.5 ( -2.31 %),1154,2219150,1923.01,764,2316090,3032,-96940
2009-05-13,65 ( -4.41 %),1167,1943210,1665.13,1026,2810510,2739,-867300
2009-05-12,68 ( 3.03 %),919,1611190,1753.2,817,1169330,1431,441860
2009-05-11,66 ( 3.12 %),642,2030980,3163.52,1066,2131940,2000,-100960
2009-05-08,64 ( 0.79 %),836,2405530,2877.43,1266,2470730,1952,-65200
2009-05-07,63.5 ( 4.96 %),614,2691390,4383.37,667,1032650,1548,1658740
2009-05-06,60.5 ( 0 %),762,3375600,4429.92,2970,4274840,1439,-899240
2009-05-05,60.5 ( 4.31 %),642,3577040,5571.71,352,227170,645,3349870
2009-05-04,58 ( 4.5 %),406,1849290,4554.9,186,223130,1200,1626160
2009-04-29,55.5 ( 0.91 %),441,1166820,2645.85,635,1077320,1697,89500
2009-04-28,55 ( 0 %),423,1328740,3141.23,683,995100,1457,333640
2009-04-27,55 ( 1.85 %),398,1369100,3439.95,936,1330910,1422,38190
2009-04-24,54 ( 0.93 %),736,1586780,2155.95,749,1264360,1688,322420
2009-04-23,53.5 ( -0.93 %),483,1505350,3116.67,995,1723480,1732,-218130
2009-04-22,54 ( 4.85 %),943,2738060,2903.56,391,1004140,2568,1733920
2009-04-21,51.5 ( -2.83 %),1055,2340190,2218.19,1240,2931290,2364,-591100
2009-04-20,53 ( -4.5 %),225,402140,1787.29,871,1854280,2129,-1452140
2009-04-17,55.5 ( -4.31 %),865,1159400,1340.35,917,1977060,2156,-817660
2009-04-16,58 ( 0.87 %),1117,2006770,1796.57,954,2165020,2269,-158250
2009-04-15,57.5 ( -3.36 %),1304,2269910,1740.73,1385,2829330,2043,-559420
2009-04-14,59.5 ( 4.39 %),1217,2988270,2455.44,1138,2272010,1996,716260
2009-04-13,57 ( 4.59 %),540,1518060,2811.22,116,104360,900,1413700
2009-04-10,54.5 ( 4.81 %),635,2110630,3323.83,191,249850,1308,1860780
2009-04-09,52 ( 0 %),1267,2121080,1674.1,877,1981750,2260,139330
2009-04-08,52 ( -3.7 %),1311,2338230,1783.55,1383,2685390,1942,-347160
2009-04-07,54 ( 4.85 %),1011,2929370,2897.5,1261,1892480,1501,1036890
2009-04-03,51.5 ( 4.25 %),526,1834980,3488.56,546,901030,1650,933950
2009-04-02,49.4 ( 4.88 %),662,1805170,2726.84,564,1150970,2041,654200
2009-04-01,47.1 ( 4.9 %),724,1145560,1582.27,260,375130,1443,770430
2009-03-31,44.9 ( -1.75 %),1477,1931010,1307.39,255,974620,3822,956390
2009-03-30,45.7 ( -4.79 %),1193,1338390,1121.87,350,1440080,4115,-101690
2009-03-27,48 ( -3.81 %),829,998860,1204.9,894,2135500,2389,-1136640
2009-03-26,49.9 ( 3.1 %),538,1073780,1995.87,810,1594240,1968,-520460
2009-03-25,48.4 ( 4.76 %),461,1344760,2917.05,985,1415790,1437,-71030
2009-03-24,46.2 ( 5 %),336,876150,2607.59,155,294160,1898,581990
2009-03-23,44 ( -3.3 %),417,486230,1166.02,308,557050,1809,-70820
2009-03-20,45.5 ( 0 %),488,582610,1193.87,328,530500,1617,52110
2009-03-19,45.5 ( -4.81 %),494,796500,1612.35,774,1456790,1882,-660290
2009-03-18,47.8 ( 4.82 %),697,1169890,1678.46,462,1085080,2349,84810
2009-03-17,45.6 ( 3.64 %),420,683990,1628.55,423,744200,1759,-60210
2009-03-16,44 ( 1.38 %),261,411400,1576.25,176,372260,2115,39140
2009-03-13,43.4 ( 0 %),328,356110,1085.7,270,548300,2031,-192190
2009-03-12,43.4 ( -3.56 %),313,418890,1338.31,388,565560,1458,-146670
2009-03-11,45 ( 1.35 %),400,739700,1849.25,417,835740,2004,-96040
2009-03-10,44.4 ( 0.68 %),368,746690,2029.05,470,961120,2045,-214430
2009-03-09,44.1 ( 2.08 %),221,508010,2298.69,443,650380,1468,-142370
2009-03-06,43.2 ( 0.47 %),332,615550,1854.07,380,412500,1086,203050
2009-03-05,43 ( 2.63 %),311,453260,1457.43,411,718540,1748,-265280
2009-03-04,41.9 ( 0.96 %),267,389350,1458.24,242,307350,1270,82000
2009-03-03,41.5 ( -4.82 %),271,312180,1151.96,330,517300,1568,-205120
2009-03-02,43.6 ( 1.63 %),315,453580,1439.94,492,626830,1274,-173250
2009-02-27,42.9 ( 4.63 %),322,682460,2119.44,449,452780,1008,229680
2009-02-26,41 ( 3.8 %),414,868590,2098.04,482,741920,1539,126670
2009-02-25,39.5 ( 4.77 %),435,709980,1632.14,212,333520,1573,376460
2009-02-24,37.7 ( -4.8 %),269,278610,1035.72,340,513890,1511,-235280
2009-02-23,39.6 ( -4.81 %),321,297430,926.57,338,490310,1451,-192880
2009-02-20,41.6 ( -0.95 %),368,310590,843.99,213,223240,1048,87350
2009-02-19,42 ( 0 %),388,526210,1356.21,333,477130,1433,49080
2009-02-18,42 ( -2.55 %),468,825690,1764.29,365,560380,1535,265310
2009-02-17,43.1 ( -4.86 %),551,435080,789.62,296,606520,2049,-171440
2009-02-16,45.3 ( -2.79 %),449,525100,1169.49,205,607300,2962,-82200
2009-02-13,46.6 ( -0.85 %),500,478160,956.32,142,231860,1633,246300
2009-02-12,47 ( -0.21 %),416,444870,1069.4,174,442510,2543,2360
2009-02-11,47.1 ( -1.87 %),468,603670,1289.89,192,531130,2766,72540
2009-02-10,48 ( -2.64 %),215,248960,1157.95,300,363960,1213,-115000
2009-02-09,49.3 ( 3.79 %),207,230270,1112.42,311,319820,1028,-89550
2009-02-06,47.5 ( 2.15 %),306,310790,1015.65,207,310650,1501,140
2009-02-05,46.5 ( -2.11 %),335,319910,954.96,244,291380,1194,28530
2009-02-04,47.5 ( 1.93 %),433,454130,1048.8,223,286600,1285,167530
2009-02-03,46.6 ( -3.92 %),439,416970,949.82,293,613290,2093,-196320
2009-02-02,48.5 ( -3.96 %),387,407840,1053.85,210,592290,2820,-184450
2009-01-23,50.5 ( 0 %),143,287340,2009.37,250,296110,1184,-8770
2009-01-22,50.5 ( 1.61 %),307,535180,1743.26,182,247670,1361,287510
2009-01-21,49.7 ( -0.4 %),206,291570,1415.39,136,279040,2052,12530
2009-01-20,49.9 ( -1.19 %),261,439200,1682.76,235,510610,2173,-71410
2009-01-19,50.5 ( 0 %),236,491750,2083.69,289,331400,1147,160350
2009-01-16,50.5 ( 1 %),282,511630,1814.29,499,587720,1178,-76090
2009-01-15,50 ( -1.96 %),349,627940,1799.26,350,507820,1451,120120
2009-01-14,51 ( 2.2 %),473,736050,1556.13,385,578830,1503,157220
2009-01-13,49.9 ( -1.19 %),526,563210,1070.74,256,471010,1840,92200
2009-01-12,50.5 ( 0 %),460,467180,1015.61,191,391830,2051,75350
2009-01-09,50.5 ( -1.94 %),487,623310,1279.9,258,577820,2240,45490
2009-01-08,51.5 ( -2.83 %),452,818990,1811.92,570,815100,1430,3890
2009-01-07,53 ( 2.91 %),436,1128480,2588.26,956,1145330,1198,-16850
2009-01-06,51.5 ( 3 %),257,493790,1921.36,504,565520,1122,-71730
2009-01-05,50 ( 0 %),308,314120,1019.87,368,415860,1130,-101740
2009-01-02,50 ( 0 %),209,193630,926.46,209,166170,795,27460
2008-12-31,50 ( -0.99 %),523,701380,1341.07,736,1056110,1435,-354730
2008-12-30,50.5 ( 3.91 %),499,861880,1727.21,422,654230,1550,207650
2008-12-29,48.6 ( -0.1 %),444,511930,1153,354,346120,978,165810
2008-12-26,48.7 ( -0.2 %),414,580620,1402.46,200,331690,1658,248930
2008-12-25,49 ( 0.41 %),335,471530,1407.55,163,286790,1759,184740
2008-12-24,49 ( -1.21 %),489,597330,1221.53,168,230930,1375,366400
2008-12-23,49.6 ( -3.69 %),461,505730,1097.03,362,539920,1491,-34190
2008-12-22,51.5 ( -1.81 %),352,468840,1331.93,465,737640,1586,-268800
2008-12-19,52.5 ( 0.1 %),318,740720,2329.31,557,790030,1418,-49310
2008-12-18,52.5 ( 0.1 %),307,536210,1746.61,626,638370,1020,-102160
2008-12-17,52.5 ( 3.96 %),500,932990,1865.98,503,844160,1678,88830
2008-12-16,50.5 ( -4.72 %),251,563840,2246.37,1006,1090340,1084,-526500
2008-12-15,53 ( 4.95 %),488,673480,1380.08,479,566150,1182,107330
2008-12-12,50.5 ( 4.88 %),450,839420,1865.38,363,438610,1208,400810
2008-12-11,48.2 ( 1.9 %),355,581210,1637.21,298,277040,930,304170
2008-12-10,47.3 ( -2.77 %),311,355230,1142.22,418,475140,1137,-119910
2008-12-09,48.7 ( 4.73 %),467,736820,1577.77,482,669500,1389,67320
2008-12-08,46.5 ( -4.62 %),421,560700,1331.83,421,471430,1120,89270
2008-12-05,48.9 ( -3.17 %),612,781540,1277.03,323,487760,1510,293780
2008-12-04,50.5 ( 0 %),529,713350,1348.49,305,578040,1895,135310
2008-12-03,50.5 ( 1 %),659,733780,1113.47,321,501770,1563,232010
2008-12-02,50 ( -4.67 %),528,777400,1472.35,411,682410,1660,94990
2008-12-01,52.5 ( 3.96 %),596,945710,1586.76,466,722980,1551,222730
2008-11-28,50.5 ( 4.55 %),749,1222050,1631.58,134,349130,2605,872920
2008-11-27,48.5 ( -4.9 %),737,855850,1161.26,394,1158150,2939,-302300
2008-11-26,51 ( -4.67 %),450,683690,1519.31,482,995470,2065,-311780
2008-11-25,53.5 ( 2 %),560,576360,1029.21,399,643190,1612,-66830
2008-11-24,52.5 ( 3.96 %),614,940550,1531.84,354,539010,1523,401540
2008-11-21,50.5 ( -3.72 %),1029,1138100,1106.03,424,774600,1827,363500
2008-11-20,52.5 ( -4.55 %),637,536490,842.21,416,1014300,2438,-477810
2008-11-19,55 ( -2.65 %),863,648800,751.8,369,603460,1635,45340
2008-11-18,56.5 ( -2.59 %),676,579140,856.72,264,326760,1238,252380
2008-11-17,58 ( -3.33 %),415,446050,1074.82,402,562600,1400,-116550
2008-11-14,60 ( 4.35 %),848,1024170,1207.75,371,645220,1739,378950
2008-11-13,57.5 ( -0.86 %),1274,1175590,922.76,602,1315500,2185,-139910
2008-11-12,58 ( -4.92 %),273,246800,904.03,596,1085670,1822,-838870
2008-11-11,61 ( -4.69 %),658,550800,837.08,694,1535250,2212,-984450
2008-11-10,64 ( 4.92 %),808,910920,1127.38,149,435720,2924,475200
2008-11-07,61 ( 4.72 %),1301,1602270,1231.57,483,1115400,2309,486870
2008-11-06,89 ( 4.09 %),817,1721170,2106.7,1032,1733480,1680,-12310
2008-11-05,85.5 ( 4.91 %),479,1143800,2387.89,128,160580,1255,983220
2008-11-04,81.5 ( 4.49 %),726,907740,1250.33,392,600150,1531,307590
2008-11-03,78 ( 4.7 %),875,1148170,1312.19,467,837550,1793,310620
2008-10-31,74.5 ( 4.93 %),793,1500150,1891.74,97,214790,2214,1285360
2008-10-30,71 ( 4.41 %),508,705550,1388.88,260,329520,1267,376030
2008-10-29,68 ( 4.62 %),819,1679140,2050.23,246,438790,1784,1240350
2008-10-28,65 ( -2.26 %),445,650700,1462.25,375,636310,1697,14390
2008-10-27,66.5 ( -4.32 %),207,390520,1886.57,357,625410,1752,-234890
2008-10-24,69.5 ( -4.79 %),415,458250,1104.22,324,566560,1749,-108310
2008-10-23,73 ( -4.58 %),280,439550,1569.82,388,756640,1950,-317090
2008-10-22,76.5 ( -1.92 %),357,408330,1143.78,268,353110,1318,55220
2008-10-21,78 ( 4.7 %),371,757920,2042.91,299,441110,1475,316810
2008-10-20,74.5 ( -4.49 %),318,263870,829.78,234,386160,1650,-122290
2008-10-17,78 ( 2.63 %),594,603160,1015.42,266,506590,1904,96570
2008-10-16,76 ( 1.33 %),812,832580,1025.34,410,643370,1569,189210
2008-10-15,75 ( 4.9 %),1326,1784000,1345.4,287,685690,2389,1098310
2008-10-14,71.5 ( 4.38 %),1457,3085240,2117.53,13,42650,3281,3042590
2008-10-13,68.5 ( -4.86 %),475,607040,1277.98,423,652520,1543,-45480
2008-10-10,72 ( -4.64 %),247,221730,897.69,305,827880,2714,-606150
2008-10-09,75.5 ( -4.43 %),690,900250,1304.71,623,1216260,1952,-316010
2008-10-08,79 ( -4.82 %),210,181880,866.1,425,941700,2216,-759820
2008-10-07,83 ( -4.6 %),99,138250,1396.46,496,1212770,2445,-1074520
2008-10-06,87 ( -4.92 %),308,409660,1330.06,351,670860,1911,-261200
2008-10-03,91.5 ( -3.68 %),449,423210,942.56,257,473960,1844,-50750
2008-10-02,95 ( 2.15 %),590,667940,1132.1,299,496680,1661,171260
2008-10-01,93 ( 1.64 %),526,741430,1409.56,429,691830,1613,49600
2008-09-30,91.5 ( -4.44 %),48,15530,323.54,725,1543760,2129,-1528230
2008-09-29,96 ( -3.52 %),293,414630,1415.12,451,580780,1288,-166150
2008-09-26,99.5 ( 4.74 %),355,751050,2115.63,385,677380,1759,73670
2008-09-25,95 ( 4.97 %),395,1007340,2550.23,358,757330,2115,250010
2008-09-24,90.5 ( -3.72 %),270,359750,1332.41,378,645020,1706,-285270
2008-09-23,94 ( 3.87 %),838,1681040,2006.01,735,1686860,2295,-5820
2008-09-22,90.5 ( 4.62 %),894,1650110,1845.76,43,326690,7597,1323420
2008-09-19,86.5 ( 4.85 %),1001,1909970,1908.06,327,757640,2317,1152330
2008-09-18,82.5 ( -4.62 %),67,144600,2158.21,623,1348090,2164,-1203490
2008-09-17,86.5 ( -4.95 %),78,71390,915.26,519,990310,1908,-918920
2008-09-16,91 ( -4.71 %),277,341750,1233.75,420,813240,1936,-471490
2008-09-15,95.5 ( -4.5 %),782,1040790,1330.93,668,1315640,1970,-274850
2008-09-12,100 ( -4.76 %),100,99390,993.9,754,1445390,1917,-1346000
2008-09-11,105 ( -4.55 %),73,125420,1718.08,707,911390,1289,-785970
2008-09-10,110 ( -4.35 %),179,245500,1371.51,558,745500,1336,-500000
2008-09-09,115 ( -4.96 %),431,581510,1349.21,774,1413150,1826,-831640
2008-09-08,121 ( -4.72 %),67,91770,1369.7,752,1148530,1527,-1056760
2008-09-05,127 ( -4.51 %),623,605910,972.57,649,1784130,2749,-1178220
2008-09-04,133 ( 4.72 %),579,1231990,2127.79,345,812380,2355,419610
2008-09-03,127 ( 4.96 %),277,859540,3103.03,164,363820,2218,495720
2008-08-29,121 ( 0 %),625,1131040,1809.66,1006,1311550,1304,-180510
2008-08-28,121 ( 4.31 %),905,2677390,2958.44,1032,2101230,2036,576160
2008-08-27,116 ( 4.5 %),450,2063070,4584.6,52,51750,995,2011320
2008-08-26,111 ( 4.72 %),647,3051380,4716.2,33,11570,351,3039810
2008-08-25,106 ( 4.95 %),566,2501910,4420.34,43,49110,1142,2452800
2008-08-22,101 ( 4.66 %),594,2337520,3935.22,70,87220,1246,2250300
2008-08-21,96.5 ( 4.89 %),406,1343880,3310.05,111,231990,2090,1111890
2008-08-20,92 ( 4.55 %),546,2442390,4473.24,310,871030,2810,1571360
2008-08-19,88 ( 4.76 %),544,2073440,3811.47,129,142630,1106,1930810
2008-08-18,84 ( 5 %),579,2213790,3823.47,56,382720,6834,1831070
2008-08-15,80 ( 2.56 %),640,2091710,3268.3,28,16710,597,2075000
2008-08-14,78 ( 2.63 %),530,1935330,3651.57,53,36200,683,1899130
2008-08-13,76 ( 2.7 %),465,1946840,4186.75,156,221080,1417,1725760
2008-08-12,74 ( 2.78 %),478,1873200,3918.83,83,121650,1466,1751550
2008-08-11,72 ( 2.86 %),364,1679730,4614.64,49,51350,1048,1628380
2008-08-08,70 ( 2.94 %),416,1274110,3062.76,581,696730,1199,577380
2008-08-07,68 ( 2.26 %),289,557840,1930.24,218,362700,1664,195140
2008-08-06,66.5 ( 2.31 %),544,1145210,2105.17,175,280690,1604,864520
2008-08-05,65 ( -2.99 %),61,216280,3545.57,364,665490,1828,-449210
2008-08-04,67 ( -2.9 %),335,473630,1413.82,678,796760,1175,-323130
2008-08-01,69 ( 2.99 %),391,687540,1758.41,249,272140,1093,415400
2008-07-31,67 ( 2.29 %),510,1044980,2048.98,409,667250,1631,377730
2008-07-30,65.5 ( 2.34 %),588,1168790,1987.74,327,658470,2014,510320
2008-07-29,64 ( 2.4 %),497,1051240,2115.17,31,72740,2346,978500
2008-07-28,62.5 ( 2.46 %),337,803650,2384.72,52,46620,897,757030
2008-07-25,62 ( 0.81 %),434,595350,1371.77,353,432820,1226,162530
2008-07-24,61.5 ( -2.38 %),822,1475060,1794.48,870,1261900,1450,213160
2008-07-23,63 ( -2.33 %),42,118350,2817.86,863,1601870,1856,-1483520
2008-07-22,64.5 ( -2.27 %),31,165620,5342.58,1100,1974820,1795,-1809200
2008-07-21,66 ( -2.94 %),366,714950,1953.42,860,1399030,1627,-684080
2008-07-18,68 ( 2.26 %),594,1231050,2072.47,402,651860,1622,579190
2008-07-17,66.5 ( 2.31 %),749,1938280,2587.82,52,93730,1802,1844550
2008-07-16,65 ( 2.36 %),910,1946380,2138.88,408,815770,1999,1130610
2008-07-15,63.5 ( 2.42 %),769,2695020,3504.58,32,61500,1922,2633520
2008-07-14,62 ( 2.48 %),723,2236890,3093.9,44,102180,2322,2134710
2008-07-11,60.5 ( 2.54 %),608,1719740,2828.52,80,165300,2066,1554440
2008-07-10,59 ( 2.61 %),443,1372060,3097.2,86,174910,2034,1197150
2008-07-09,57.5 ( 2.68 %),419,727810,1737.02,205,324580,1583,403230
2008-07-08,56 ( 2.75 %),375,614730,1639.28,541,494840,915,119890
2008-07-07,54.5 ( -2.68 %),413,838240,2029.64,774,867720,1121,-29480
2008-07-04,56 ( 2.75 %),547,1039990,1901.26,106,114780,1083,925210
2008-07-03,54.5 ( 2.83 %),387,739420,1910.65,69,41650,604,697770
2008-07-02,53 ( 2.91 %),604,820940,1359.17,282,491750,1744,329190
2008-07-01,51.5 ( 3 %),316,490460,1552.09,155,154190,995,336270
2008-06-30,50 ( 0 %),351,332130,946.24,288,340430,1182,-8300
2008-06-27,50 ( 1.01 %),271,242330,894.21,245,216010,882,26320
2008-06-26,49.5 ( -1.98 %),269,225070,836.69,368,358530,974,-133460
2008-06-25,50.5 ( 2.02 %),370,379770,1026.41,180,284130,1578,95640
2008-06-24,49.5 ( 2.91 %),448,536540,1197.63,247,274340,1111,262200
2008-06-23,48.1 ( -2.83 %),298,436950,1466.28,346,688580,1990,-251630
2008-06-20,49.5 ( -2.94 %),54,96710,1790.93,415,774520,1866,-677810
2008-06-19,51 ( -2.86 %),57,85410,1498.42,354,541830,1531,-456420
2008-06-18,52.5 ( -1.87 %),407,645410,1585.77,558,1102630,1976,-457220
2008-06-17,53.5 ( 1.9 %),542,471670,870.24,53,227950,4301,243720
2008-06-16,52.5 ( 1.94 %),755,891950,1181.39,241,763760,3169,128190
2008-06-13,51.5 ( -1.9 %),265,409120,1543.85,354,1238400,3498,-829280
2008-06-12,52.5 ( -1.87 %),137,196520,1434.45,314,1084470,3454,-887950
2008-06-11,53.5 ( -1.83 %),56,12340,220.36,332,1227950,3699,-1215610
2008-06-10,54.5 ( -1.8 %),7,5040,720,352,1060930,3014,-1055890
2008-06-09,55.5 ( -1.77 %),16,22830,1426.88,305,963160,3158,-940330
2008-06-06,56.5 ( -1.74 %),19,6460,340,375,1137810,3034,-1131350
2008-06-05,57.5 ( -1.71 %),13,2430,186.92,412,1308090,3175,-1305660
2008-06-04,58.5 ( -1.68 %),15,3870,258,404,1150570,2848,-1146700
2008-06-03,59.5 ( -1.65 %),13,10280,790.77,455,1296350,2849,-1286070
2008-06-02,60.5 ( -1.63 %),12,7300,608.33,417,1385490,3323,-1378190
2008-05-30,61.5 ( -1.6 %),28,20370,727.5,394,1375060,3490,-1354690
2008-05-29,62.5 ( 0 %),0,0,0,0,0,0,0
2008-05-28,62.5 ( 0 %),0,0,0,0,0,0,0
2008-05-27,62.5 ( 0 %),0,0,0,0,0,0,0
2008-05-26,62.5 ( -1.57 %),19,8560,450.53,443,1630060,3680,-1621500
2008-05-23,63.5 ( -1.55 %),26,42540,1636.15,534,1498040,2805,-1455500
2008-05-22,64.5 ( -1.53 %),13,3320,255.38,518,1693350,3269,-1690030
2008-05-21,65.5 ( -1.5 %),18,91850,5102.78,482,1479300,3069,-1387450
2008-05-20,66.5 ( -1.48 %),19,13570,714.21,392,1153550,2943,-1139980
2008-05-19,67.5 ( -1.46 %),25,73740,2949.6,332,920370,2772,-846630
2008-05-16,68.5 ( -1.44 %),64,65920,1030,358,945470,2641,-879550
2008-05-15,69.5 ( -1.42 %),18,7980,443.33,392,1447850,3693,-1439870
2008-05-14,70.5 ( -1.4 %),16,8580,536.25,431,1653840,3837,-1645260
2008-05-13,71.5 ( -1.38 %),14,8790,627.86,523,1809060,3459,-1800270
2008-05-12,72.5 ( -1.36 %),13,45450,3496.15,528,1806600,3422,-1761150
2008-05-09,73.5 ( -2 %),36,31710,880.83,584,1495500,2561,-1463790
2008-05-08,75 ( -1.96 %),24,108670,4527.92,673,1500280,2229,-1391610
2008-05-07,76.5 ( -1.92 %),29,82390,2841.03,623,1452050,2331,-1369660
2008-05-06,78 ( -1.89 %),33,69790,2114.85,491,906250,1846,-836460
2008-05-05,79.5 ( -1.85 %),58,123490,2129.14,281,490760,1746,-367270
2008-04-29,81 ( -1.82 %),242,383770,1585.83,406,477520,1176,-93750
2008-04-28,82.5 ( -1.79 %),223,459940,2062.51,395,611870,1549,-151930
2008-04-25,84 ( -1.75 %),69,43420,629.28,369,784090,2125,-740670
2008-04-24,85.5 ( -1.72 %),51,53300,1045.1,413,959970,2324,-906670
2008-04-23,87 ( -1.69 %),27,8870,328.52,406,829530,2043,-820660
2008-04-22,88.5 ( -1.67 %),61,53530,877.54,228,454820,1995,-401290
2008-04-21,90 ( -1.64 %),126,272120,2159.68,244,433350,1776,-161230
2008-04-18,92.5 ( -1.6 %),189,281760,1490.79,358,518410,1448,-236650
2008-04-17,94 ( 1.08 %),365,659290,1806.27,460,864190,1879,-204900
2008-04-16,93 ( -1.59 %),52,89940,1729.62,416,625650,1504,-535710
2008-04-11,94.5 ( -1.56 %),85,75550,888.82,401,724280,1806,-648730
2008-04-10,96 ( -1.54 %),71,100200,1411.27,379,370480,978,-270280
2008-04-09,97.5 ( -1.02 %),233,491770,2110.6,513,623560,1216,-131790
2008-04-08,98.5 ( -1.01 %),642,731390,1139.24,692,1004510,1452,-273120
2008-04-07,99.5 ( 1.53 %),547,785570,1436.14,15,44420,2961,741150
2008-04-04,98 ( 0.51 %),499,566620,1135.51,17,19260,1133,547360
2008-04-03,97.5 ( 0.52 %),435,664150,1526.78,6,7660,1277,656490
2008-04-02,97 ( 0.52 %),519,885500,1706.17,10,1820,182,883680
2008-04-01,96.5 ( 0.52 %),455,701070,1540.81,40,80650,2016,620420
2008-03-31,96 ( 0.52 %),396,661300,1669.95,49,281820,5751,379480
2008-03-28,95.5 ( 0.53 %),580,539180,929.62,67,370310,5527,168870
2008-03-27,95 ( 0.53 %),570,852040,1494.81,123,564730,4591,287310
2008-03-26,94.5 ( -4.55 %),484,491820,1016.16,422,1085150,2571,-593330
2008-03-25,99 ( -4.81 %),83,97260,1171.81,716,1501610,2097,-1404350
2008-03-24,104 ( -4.59 %),88,61590,699.89,516,1388880,2692,-1327290
2008-03-21,109 ( -4.39 %),261,225440,863.75,421,596020,1416,-370580
2008-03-20,114 ( -4.2 %),458,388550,848.36,388,531920,1371,-143370
2008-03-19,119 ( -4.8 %),625,445440,712.7,401,860080,2145,-414640
2008-03-18,125 ( -4.58 %),122,53240,436.39,462,828230,1793,-774990
2008-03-17,131 ( -4.38 %),222,118740,534.86,323,415340,1286,-296600
2008-03-14,137 ( 0 %),299,300960,1006.56,309,467490,1513,-166530
2008-03-13,137 ( 0 %),298,149920,503.09,328,333630,1017,-183710
2008-03-12,137 ( 2.24 %),475,625300,1316.42,361,491270,1361,134030
2008-03-11,134 ( -4.29 %),639,663850,1038.89,782,733030,937,-69180
2008-03-10,140 ( 4.48 %),1009,1510820,1497.34,464,749800,1616,761020
2008-03-07,134 ( 4.69 %),1200,2017370,1681.14,39,66860,1714,1950510
2008-03-06,128 ( 4.92 %),846,1432240,1692.96,99,150750,1523,1281490
2008-03-05,122 ( -4.69 %),138,260000,1884.06,776,1405440,1811,-1145440
2008-03-04,128 ( -4.48 %),102,134790,1321.47,773,879040,1137,-744250
2008-03-03,134 ( -4.96 %),163,190060,1166.01,486,563800,1160,-373740
2008-02-29,141 ( -4.73 %),388,250080,644.54,329,431840,1313,-181760
2008-02-28,148 ( -1.99 %),309,175260,567.18,280,249920,893,-74660
2008-02-27,151 ( -0.66 %),374,353120,944.17,295,310360,1052,42760
2008-02-26,152 ( -4.4 %),459,309160,673.55,408,533400,1307,-224240
2008-02-25,159 ( 4.61 %),741,772480,1042.48,203,320820,1580,451660
2008-02-22,152 ( -4.4 %),319,287230,900.41,422,697190,1652,-409960
2008-02-21,159 ( -4.79 %),219,187680,856.99,374,440400,1178,-252720
2008-02-20,167 ( -4.57 %),626,376820,601.95,248,444040,1790,-67220
2008-02-19,175 ( -0.57 %),633,362110,572.05,159,292940,1842,69170
2008-02-18,176 ( -4.35 %),516,464570,900.33,197,315180,1600,149390
2008-02-15,184 ( -0.54 %),264,163040,617.58,170,163200,960,-160
2008-02-14,185 ( 0.54 %),435,343850,790.46,162,232480,1435,111370
2008-02-13,184 ( -4.66 %),343,293660,856.15,231,292860,1268,800
2008-02-12,193 ( -2.53 %),182,132500,728.02,230,186790,812,-54290
2008-02-01,198 ( 0.51 %),401,280810,700.27,319,348260,1092,-67450
2008-01-31,197 ( -1.5 %),443,303850,685.89,479,404080,844,-100230
2008-01-30,200 ( 4.71 %),714,627450,878.78,362,372780,1030,254670
2008-01-29,191 ( 4.95 %),450,451130,1002.51,362,220100,608,231030
2008-01-28,182 ( 2.25 %),346,401070,1159.16,313,289200,924,111870
2008-01-25,178 ( 4.71 %),498,562140,1128.8,587,323340,551,238800
2008-01-24,170 ( -2.3 %),842,875540,1039.83,633,618490,977,257050
2008-01-23,174 ( -4.92 %),210,92540,440.67,585,695740,1189,-603200
2008-01-22,183 ( -4.69 %),358,202800,566.48,485,662180,1365,-459380
2008-01-21,192 ( -4.95 %),759,502640,662.24,411,940370,2288,-437730
2008-01-18,202 ( 1.51 %),407,419720,1031.25,275,179570,653,240150
2008-01-17,199 ( 0.51 %),452,449710,994.93,558,515100,923,-65390
2008-02-21,159 ( -4.79 %),219,187680,856.99,374,440400,1178,-252720
2008-02-20,167 ( -4.57 %),626,376820,601.95,248,444040,1790,-67220
2008-02-19,175 ( -0.57 %),633,362110,572.05,159,292940,1842,69170
2008-02-18,176 ( -4.35 %),516,464570,900.33,197,315180,1600,149390
2008-02-15,184 ( -0.54 %),264,163040,617.58,170,163200,960,-160
2008-02-14,185 ( 0.54 %),435,343850,790.46,162,232480,1435,111370
2008-02-13,184 ( -4.66 %),343,293660,856.15,231,292860,1268,800
2008-02-12,193 ( -2.53 %),182,132500,728.02,230,186790,812,-54290
2008-02-01,198 ( 0.51 %),401,280810,700.27,319,348260,1092,-67450
2008-01-31,197 ( -1.5 %),443,303850,685.89,479,404080,844,-100230
2008-01-30,200 ( 4.71 %),714,627450,878.78,362,372780,1030,254670
2008-01-29,191 ( 4.95 %),450,451130,1002.51,362,220100,608,231030
2008-01-28,182 ( 2.25 %),346,401070,1159.16,313,289200,924,111870
2008-01-25,178 ( 4.71 %),498,562140,1128.8,587,323340,551,238800
2008-01-24,170 ( -2.3 %),842,875540,1039.83,633,618490,977,257050
2008-01-23,174 ( -4.92 %),210,92540,440.67,585,695740,1189,-603200
2008-01-22,183 ( -4.69 %),358,202800,566.48,485,662180,1365,-459380
2008-01-21,192 ( -4.95 %),759,502640,662.24,411,940370,2288,-437730
2008-01-18,202 ( 1.51 %),407,419720,1031.25,275,179570,653,240150
2008-01-17,199 ( 0.51 %),452,449710,994.93,558,515100,923,-65390
2007-12-17,221 ( -0.45 %),349,348130,997.51,186,320550,1723,27580
2007-12-14,222 ( -0.89 %),587,408920,696.63,140,332400,2374,76520
2007-12-13,224 ( -1.32 %),450,400580,890.18,209,440130,2106,-39550
2007-12-12,227 ( 0.44 %),704,739060,1049.8,169,412020,2438,327040
2007-12-11,226 ( -0.88 %),510,437180,857.22,168,417180,2483,20000
2007-12-10,228 ( -1.72 %),462,406300,879.44,221,516870,2339,-110570
2007-12-07,232 ( 0.87 %),739,496710,672.14,194,358850,1850,137860
2007-12-06,230 ( -0.86 %),826,526550,637.47,179,449950,2514,76600
2007-12-05,232 ( -1.69 %),482,337550,700.31,225,479280,2130,-141730
2007-12-04,236 ( -1.26 %),718,458730,638.9,201,506290,2519,-47560
2007-12-03,239 ( 0.42 %),367,295460,805.07,165,266340,1614,29120
2007-11-30,238 ( -0.42 %),394,205070,520.48,126,253720,2014,-48650
2007-11-29,239 ( -0.83 %),453,166910,368.45,261,429840,1647,-262930
2007-11-28,241 ( -0.82 %),544,270440,497.13,195,239890,1230,30550
2007-11-27,243 ( -1.62 %),820,396490,483.52,278,374340,1347,22150
2007-11-26,247 ( 0 %),231,237610,1028.61,289,281740,975,-44130
2007-11-23,247 ( 0.41 %),157,181280,1154.65,413,261530,633,-80250
2007-11-22,246 ( 2.5 %),182,235260,1292.64,479,296430,619,-61170
2007-11-21,240 ( -2.44 %),182,235260,1292.64,479,296430,619,-61170
2007-11-20,246 ( -1.2 %),260,343470,1321.04,327,473520,1448,-130050
2007-11-19,249 ( 0 %),188,220650,1173.67,341,289560,849,-68910
2007-11-16,249 ( 1.22 %),339,360260,1062.71,323,219320,679,140940
2007-11-15,246 ( -1.99 %),291,198760,683.02,421,329210,782,-130450
2007-11-14,251 ( 4.58 %),433,446000,1030.02,318,311360,979,134640
2007-11-13,240 ( -4.38 %),322,272520,846.34,503,426010,847,-153490
2007-11-12,251 ( 0 %),150,305100,2034,418,319660,765,-14560
2007-11-09,251 ( 1.62 %),283,514350,1817.49,470,368100,783,146250
2007-11-08,247 ( 1.23 %),570,252930,443.74,298,236600,794,16330
2007-11-07,244 ( -1.21 %),857,539230,629.21,198,400590,2023,138640
2007-11-06,247 ( -3.89 %),660,498550,755.38,324,489220,1510,9330
2007-11-05,257 ( -2.65 %),450,513000,1140,317,413110,1303,99890
2007-11-02,264 ( -2.22 %),549,412460,751.29,336,353010,1051,59450
2007-11-01,270 ( -0.74 %),297,286220,963.7,390,382720,981,-96500
2007-10-31,272 ( 0.74 %),230,290870,1264.65,522,357690,685,-66820
2007-10-30,270 ( -0.37 %),310,338140,1090.77,308,347230,1127,-9090
2007-10-29,271 ( -1.45 %),296,367970,1243.14,351,300670,857,67300
2007-10-26,275 ( -0.72 %),217,255640,1178.06,668,441670,661,-186030
2007-10-25,277 ( -1.07 %),315,366680,1164.06,942,719070,763,-352390
2007-10-24,280 ( 3.32 %),460,535290,1163.67,416,364470,876,170820
2007-10-23,271 ( -0.37 %),540,623540,1154.7,467,668240,1431,-44700
2007-10-22,272 ( -1.09 %),637,503780,790.86,398,505200,1269,-1420
2007-10-19,275 ( -1.08 %),745,524870,704.52,262,292950,1118,231920
2007-10-18,278 ( -1.42 %),290,313790,1082.03,629,438980,698,-125190
2007-10-17,282 ( 1.44 %),588,554340,942.76,395,286200,725,268140
2007-10-16,278 ( -0.71 %),505,465050,920.89,507,379940,749,85110
2007-10-15,280 ( -1.06 %),350,267390,763.97,523,331940,635,-64550
2007-10-12,283 ( 0.71 %),398,277820,698.04,465,260600,560,17220
2007-10-11,281 ( -2.09 %),616,449700,730.03,714,545960,765,-96260
2007-10-10,287 ( 0 %),313,276000,881.79,904,570770,631,-294770
2007-10-09,287 ( 4.74 %),709,607180,856.39,425,287410,676,319770
2007-10-08,274 ( -1.79 %),850,608280,715.62,699,580050,830,28230
2007-10-05,281 ( -4.75 %),707,496300,701.98,1038,995580,959,-499280
2007-10-04,295 ( -1.99 %),421,522630,1241.4,1008,818970,812,-296340
2007-10-03,301 ( 1.69 %),726,822340,1132.7,1247,1178130,945,-355790
2007-10-02,296 ( 3.5 %),898,1213520,1351.36,1128,1227330,1088,-13810
2007-10-01,286 ( 4.76 %),852,998580,1172.04,380,494730,1302,503850
2007-09-28,273 ( 5 %),638,919510,1441.24,789,555090,704,364420
2007-09-27,260 ( 4 %),528,739410,1400.4,1118,645970,578,93440
2007-09-26,250 ( 0 %),787,575460,731.21,1146,891230,778,-315770
2007-09-25,250 ( 4.6 %),801,862010,1076.17,726,520620,717,341390
2007-09-24,239 ( 4.82 %),661,715310,1082.16,583,319290,548,396020
2007-09-21,228 ( 1.33 %),436,426080,977.25,803,559900,697,-133820
2007-09-20,225 ( 0.9 %),615,539030,876.47,377,268820,713,270210
2007-09-19,223 ( 0.45 %),427,335370,785.41,333,279210,838,56160
2007-09-18,222 ( -0.89 %),330,307600,932.12,341,285370,837,22230
2007-09-17,224 ( -0.44 %),322,439470,1364.81,374,276500,739,162970
2007-09-14,225 ( 0.9 %),281,370150,1317.26,369,265120,718,105030
2007-09-13,223 ( 0 %),224,279440,1247.5,314,288260,918,-8820
2007-09-12,223 ( 0 %),298,301650,1012.25,323,273640,847,28010
2007-09-11,223 ( 0 %),283,259310,916.29,414,272400,658,-13090
2007-09-10,223 ( -0.89 %),510,368440,722.43,333,237510,713,130930
2007-09-07,225 ( 0 %),370,297110,803,374,278540,745,18570
2007-09-06,225 ( 0 %),400,334950,837.38,321,229880,716,105070
2007-09-05,225 ( -1.75 %),584,641060,1097.71,473,563170,1191,77890
2007-09-04,229 ( 1.78 %),354,477330,1348.39,391,244110,624,233220
2007-08-31,225 ( 0 %),489,435370,890.33,328,372370,1135,63000
2007-08-30,225 ( -0.44 %),440,440920,1002.09,249,311320,1250,129600
2007-08-29,226 ( 0 %),301,338230,1123.69,315,175800,558,162430
2007-08-28,226 ( 0 %),347,281530,811.33,422,327440,776,-45910
2007-08-27,226 ( -1.74 %),346,376620,1088.5,636,442800,696,-66180
2007-08-24,230 ( 2.22 %),451,587500,1302.66,686,501550,731,85950
2007-08-23,225 ( -1.75 %),334,332560,995.69,795,601770,757,-269210
2007-08-22,229 ( 0.88 %),287,372530,1298.01,879,553980,630,-181450
2007-08-21,227 ( 0.89 %),367,265050,722.21,551,365590,664,-100540
2007-08-20,225 ( 2.27 %),799,501390,627.52,249,213860,859,287530
2007-08-17,220 ( -1.35 %),1754,786290,448.28,293,528630,1804,257660
2007-08-16,223 ( -3.04 %),813,465020,571.98,445,699000,1571,-233980
2007-08-15,230 ( -2.13 %),566,270740,478.34,360,258230,717,12510
2007-08-14,235 ( 1.73 %),1082,531140,490.89,300,315210,1051,215930
2007-08-13,231 ( -3.75 %),776,487070,627.67,502,425890,848,61180
2007-08-10,240 ( -4 %),988,591570,598.76,1162,876530,754,-284960
2007-08-09,250 ( 4.6 %),1356,852860,628.95,619,561000,906,291860
2007-08-08,239 ( 4.82 %),875,817230,933.98,965,636710,660,180520
2007-08-07,228 ( 4.59 %),747,683780,915.37,394,274100,696,409680
2007-08-06,218 ( 0.46 %),664,573150,863.18,442,410300,928,162850
2007-08-03,217 ( -4.82 %),885,611900,691.41,720,700840,973,-88940
2007-08-02,228 ( -5 %),729,378140,518.71,401,519130,1295,-140990
2007-08-01,240 ( -2.04 %),862,596790,692.33,333,566760,1702,30030
2007-07-31,245 ( -3.16 %),477,400840,840.34,403,467880,1161,-67040
2007-07-30,253 ( 1.2 %),476,401900,844.33,301,322860,1073,79040
2007-07-27,250 ( 0 %),875,518040,592.05,349,420450,1205,97590
2007-07-26,250 ( -1.96 %),964,506280,525.19,432,418480,969,87800
2007-07-25,255 ( -4.49 %),912,498480,546.58,514,513760,1000,-15280
2007-07-24,267 ( -1.48 %),738,400370,542.51,321,417500,1301,-17130
2007-07-23,272 ( -3.89 %),418,267970,641.08,521,477970,917,-210000
2007-07-20,283 ( -0.7 %),778,388680,499.59,315,514480,1633,-125800
2007-07-19,285 ( -1.04 %),413,218970,530.19,287,189470,660,29500
2007-07-18,288 ( -0.69 %),979,640450,654.19,316,586500,1856,53950
2007-07-17,290 ( 0 %),1053,608690,578.05,175,489390,2797,119300
2007-07-16,290 ( -3.01 %),1286,513610,399.39,301,676630,2248,-163020
2007-07-13,299 ( -2.29 %),2071,1093810,528.16,239,1077290,4507,16520
2007-07-12,306 ( -0.65 %),200,188240,941.2,311,166380,535,21860
2007-07-11,308 ( 0 %),229,182290,796.03,389,182720,470,-430
2007-07-10,308 ( 0 %),322,229580,712.98,249,241100,968,-11520
2007-07-09,308 ( 0 %),320,358130,1119.16,267,203620,763,154510
2007-07-06,308 ( -0.65 %),295,236990,803.36,335,187160,559,49830
2007-07-05,310 ( -0.64 %),255,457670,1794.78,924,550050,595,-92380
2007-07-04,312 ( 2.97 %),330,327310,991.85,540,261110,484,66200
2007-07-03,303 ( 0.33 %),505,391540,775.33,351,233800,666,157740
2007-07-02,302 ( -1.63 %),563,429580,763.02,361,366620,1016,62960
