Ngày,Thay đổi,Số lệnh mua,Kl mua,KLTB 1 lệnh mua,Số lệnh bán,Kl bán,KLTB 1 lệnh bán,Kl ròng
2025-05-09,0 ( 0 %),0,0,0,0,0,0,0
2025-05-07,25.4 ( -0.2 %),0,0,0,0,0,0,0
2025-05-06,25.45 ( -0.97 %),0,0,0,0,0,0,0
2025-05-05,25.7 ( 0.78 %),0,0,0,0,0,0,0
2025-04-29,25.5 ( -0.58 %),7749,25441900,3283.25,6966,31980700,4591,-6538800
2025-04-28,25.65 ( -0.19 %),8750,22741600,2599.04,6748,27958400,4143,-5216800
2025-04-25,25.7 ( 0.39 %),9714,42228800,4347.21,9320,52014500,5581,-9785700
2025-04-24,25.6 ( 0.2 %),10536,30964400,2938.91,10741,40504600,3771,-9540200
2025-04-23,25.55 ( 2 %),8580,37773100,4402.46,14029,48966000,3490,-11192900
2025-04-22,25.05 ( 0.4 %),28153,93265900,3312.82,12844,71646900,5578,21619000
2025-04-21,24.95 ( -1.96 %),13907,29300600,2106.9,6656,35193700,5288,-5893100
2025-04-18,25.45 ( -0.2 %),12435,33510500,2694.85,11775,42572600,3616,-9062100
2025-04-17,25.5 ( 0 %),19861,47623000,2397.81,11130,47536100,4271,86900
2025-04-16,25.5 ( -1.35 %),17607,48677900,2764.69,11989,48203800,4021,474100
2025-04-15,25.85 ( 1.97 %),20158,85315800,4232.35,23950,85692700,3578,-376900
2025-04-14,25.35 ( 4.32 %),26321,85488700,3247.93,20847,92988000,4460,-7499300
2025-04-11,24.3 ( 6.81 %),38237,152534100,3989.18,15331,95616400,6237,56917700
2025-04-10,22.75 ( 6.81 %),48054,242550300,5047.45,809,3062400,3785,239487900
2025-04-09,21.3 ( -6.99 %),34326,90143400,2626.1,17126,144361500,8429,-54218100
2025-04-08,22.9 ( -6.91 %),18749,38374800,2046.77,11634,104286700,8964,-65911900
2025-04-04,24.6 ( -2.96 %),41816,122456800,2928.47,16112,120728700,7493,1728100
2025-04-03,25.35 ( -6.97 %),42428,108229200,2550.89,16911,180071800,10648,-71842600
2025-04-02,27.25 ( 0.93 %),9947,37236000,3743.44,8520,39992900,4694,-2756900
2025-04-01,27 ( 0.93 %),12490,31844900,2549.63,5235,33265000,6354,-1420100
2025-03-31,26.75 ( -1.47 %),17808,43137400,2422.36,6001,46316200,7718,-3178800
2025-03-28,27.15 ( -1.27 %),12512,39769800,3178.53,6835,38943900,5698,825900
2025-03-27,27.5 ( -0.18 %),7021,21524200,3065.69,7436,36837400,4954,-15313200
2025-03-26,27.55 ( 1.29 %),16571,97495900,5883.53,13824,81439200,5891,16056700
2025-03-25,27.2 ( 0.18 %),11261,42232200,3750.31,6073,43242300,7120,-1010100
2025-03-24,27.15 ( 0 %),12837,31645300,2465.16,5135,34120400,6645,-2475100
2025-03-21,27.15 ( 0 %),11407,40743900,3571.83,5138,38002100,7396,2741800
2025-03-20,27.15 ( -0.37 %),15876,49045200,3089.27,5889,45935500,7800,3109700
2025-03-19,27.25 ( -1.27 %),21136,65219800,3085.72,9028,68159000,7550,-2939200
2025-03-18,27.6 ( -0.9 %),10129,29924700,2954.36,9433,51701500,5481,-21776800
2025-03-17,27.85 ( 1.09 %),8524,36951300,4334.97,10782,53951800,5004,-17000500
2025-03-14,27.55 ( -0.54 %),11276,30868300,2737.52,6575,43848200,6669,-12979900
2025-03-12,27.8 ( -1.24 %),12969,37964500,2927.33,9683,54141600,5591,-16177100
2025-03-11,28.15 ( 0.72 %),13101,67811400,5176.05,9766,46082900,4719,21728500
2025-03-10,27.95 ( -0.36 %),9357,43709100,4671.27,11099,52054500,4690,-8345400
2025-03-07,0 ( 0 %),12628,67041300,5308.94,10254,59180100,5771,7861200
2025-03-06,27.95 ( 1.45 %),11270,79351100,7040.91,8540,63638200,7452,15712900
2025-03-05,27.55 ( -1.08 %),14473,53749700,3713.79,8649,56914100,6580,-3164400
2025-03-04,27.85 ( -0.71 %),14810,52521600,3546.36,9819,55950800,5698,-3429200
2025-03-03,28.05 ( 0.18 %),8076,39879800,4938.06,10224,44075600,4311,-4195800
2025-02-28,28 ( -1.58 %),9302,38949900,4187.26,12786,57377500,4488,-18427600
2025-02-27,28.45 ( 2.52 %),13646,95457900,6995.3,24676,87981500,3565,7476400
2025-02-26,27.75 ( 0.91 %),8853,65384100,7385.53,16198,66725500,4119,-1341400
2025-02-25,27.5 ( -0.72 %),15409,62112100,4030.9,14671,61796400,4212,315700
2025-02-24,27.7 ( 4.73 %),19319,129826900,6720.17,37349,149638100,4006,-19811200
2025-02-21,26.45 ( -0.38 %),6355,19953100,3139.75,6870,28203900,4105,-8250800
2025-02-20,26.55 ( 0.19 %),5647,21098000,3736.14,8018,29506200,3680,-8408200
2025-02-19,26.5 ( -0.19 %),6702,28991100,4325.74,7740,33849100,4373,-4858000
2025-02-18,26.55 ( 1.53 %),6306,41807000,6629.72,12644,48053900,3801,-6246900
2025-02-17,26.15 ( 0.19 %),7307,21035300,2878.79,6953,25320000,3642,-4284700
2025-02-14,26.1 ( 0.77 %),7281,36142600,4963.96,9367,36603900,3908,-461300
2025-02-13,25.9 ( 0.19 %),7746,20476000,2643.43,6064,22466100,3705,-1990100
2025-02-12,25.85 ( -0.96 %),8911,22777300,2556.09,6629,28243500,4261,-5466200
2025-02-11,26.1 ( 2.76 %),21054,59451800,2823.78,9566,42924600,4487,16527200
2025-02-10,25.4 ( -4.69 %),37083,86582000,2334.82,9821,90913100,9257,-4331100
2025-02-07,26.65 ( -0.56 %),6133,20150700,3285.62,4614,25250500,5473,-5099800
2025-02-06,26.8 ( 0 %),5443,25678900,4717.78,6083,31832600,5233,-6153700
2025-02-05,26.8 ( -0.19 %),5494,36510500,6645.52,6138,28463200,4637,8047300
2025-02-04,26.85 ( 1.7 %),6894,41101800,5961.97,8585,35067500,4085,6034300
2025-02-03,0 ( 0 %),8040,29535900,3673.62,4979,27701300,5564,1834600
2025-01-24,26.55 ( -0.38 %),4467,19463000,4357.06,5861,24195900,4128,-4732900
2025-01-23,26.65 ( 1.91 %),6094,31676700,5198.01,6739,31338200,4650,338500
2025-01-22,26.15 ( -0.57 %),4893,19796800,4045.94,4999,20456300,4092,-659500
2025-01-21,26.3 ( -0.57 %),5144,23100900,4490.84,4965,25383700,5113,-2282800
2025-01-20,26.45 ( -0.19 %),3996,19585400,4901.25,6964,28427600,4082,-8842200
2025-01-17,26.5 ( 0.76 %),5727,32290100,5638.22,6498,27531000,4237,4759100
2025-01-16,26.3 ( 0.38 %),5719,20135000,3520.72,5220,25136500,4815,-5001500
2025-01-15,26.2 ( 1.35 %),6438,28240300,4386.5,5493,20163600,3671,8076700
2025-01-14,25.85 ( -0.19 %),5418,19918000,3676.26,3731,14748500,3953,5169500
2025-01-13,25.9 ( 1.37 %),10316,29151800,2825.88,5931,22536600,3800,6615200
2025-01-10,25.55 ( -1.73 %),10621,21291400,2004.65,4236,28336600,6689,-7045200
2025-01-09,26 ( -0.95 %),8483,16151300,1903.96,3449,21702300,6292,-5551000
2025-01-08,26.25 ( 0.77 %),9237,30816200,3336.17,4016,23744200,5912,7072000
2025-01-07,26.05 ( 0 %),9093,31345000,3447.16,4748,29397100,6191,1947900
2025-01-06,26.05 ( -2.07 %),9143,21933000,2398.88,4859,26901500,5536,-4968500
2025-01-03,26.6 ( -1.48 %),6993,21443400,3066.41,4961,26080900,5257,-4637500
2025-01-02,27 ( 1.31 %),7973,43857000,5500.69,7056,29876000,4234,13981000
2024-12-31,26.65 ( -0.37 %),7834,19375300,2473.23,3856,22627500,5868,-3252200
2024-12-30,26.75 ( -0.37 %),8138,21942300,2696.28,3744,27209700,7268,-5267400
2024-12-27,26.85 ( -0.56 %),6332,19074900,3012.46,5884,26118400,4439,-7043500
2024-12-26,27 ( -0.55 %),6586,21310900,3235.79,6528,28628200,4385,-7317300
2024-12-25,27.15 ( 1.69 %),7027,28007700,3985.73,7606,34443900,4529,-6436200
2024-12-24,26.7 ( -1.11 %),9815,24656800,2512.15,4504,26024800,5778,-1368000
2024-12-23,27 ( 1.12 %),6957,24635400,3541.1,4527,26079000,5761,-1443600
2024-12-20,26.7 ( -0.56 %),9762,29385000,3010.14,4033,34008600,8433,-4623600
2024-12-19,26.85 ( -1.83 %),15705,54844100,3492.14,6201,60676100,9785,-5832000
2024-12-18,27.35 ( 1.3 %),7665,25320300,3303.37,4194,28257500,6738,-2937200
2024-12-17,27 ( 0 %),8202,27313900,3330.15,4343,20913900,4816,6400000
2024-12-16,27 ( -0.74 %),12442,35628100,2863.53,5840,32080900,5493,3547200
2024-12-13,27.2 ( -1.09 %),11346,36726200,3236.93,6638,33464000,5041,3262200
2024-12-12,27.5 ( -0.9 %),8878,35761200,4028.07,8416,49283200,5856,-13522000
2024-12-11,27.75 ( -0.54 %),8690,31607900,3637.27,12465,49036000,3934,-17428100
2024-12-10,27.9 ( 0.9 %),10492,60401400,5756.9,17579,70015400,3983,-9614000
2024-12-09,27.65 ( 0.18 %),8107,42911300,5293.12,11107,39185900,3528,3725400
2024-12-06,27.6 ( -0.9 %),9840,37509600,3811.95,13677,56391500,4123,-18881900
2024-12-05,27.85 ( 4.31 %),13049,84417500,6469.27,20232,73180500,3617,11237000
2024-12-04,26.7 ( -1.11 %),6548,23361600,3567.75,6167,28157400,4566,-4795800
2024-12-03,27 ( 0.37 %),7727,29549900,3824.24,6771,30116200,4448,-566300
2024-12-02,26.9 ( 0.56 %),7033,35422100,5036.56,11866,52032500,4385,-16610400
2024-11-29,26.75 ( 1.33 %),6674,34179800,5121.34,8049,30413200,3779,3766600
2024-11-28,26.4 ( 0.38 %),5476,33916900,6193.74,9587,34042800,3551,-125900
2024-11-27,26.3 ( -0.19 %),5805,17427700,3002.19,4756,20738100,4360,-3310400
2024-11-26,26.35 ( 0.19 %),6952,29793300,4285.57,7338,30846200,4204,-1052900
2024-11-25,26.3 ( 0.77 %),6941,25774200,3713.33,6859,28535300,4160,-2761100
2024-11-22,26.1 ( 0.97 %),8082,45087600,5578.77,9818,38175400,3888,6912200
2024-11-21,25.85 ( 0.98 %),8319,33663500,4046.58,4824,31527200,6535,2136300
2024-11-20,25.6 ( 0.59 %),17765,56809600,3197.84,9449,49294800,5217,7514800
2024-11-19,25.45 ( -1.36 %),12479,30797100,2467.91,4399,32835700,7464,-2038600
2024-11-18,25.8 ( -0.39 %),17618,48455200,2750.32,6651,49177600,7394,-722400
2024-11-14,26.3 ( -2.77 %),18934,40205400,2123.45,6792,56147000,8267,-15941600
2024-11-13,27.05 ( -1.64 %),12077,39775200,3293.47,8246,49302400,5979,-9527200
2024-11-12,27.5 ( -0.72 %),9401,37609100,4000.54,13946,56919900,4081,-19310800
2024-11-11,27.7 ( 2.59 %),12131,91080700,7508.09,16048,65020900,4052,26059800
2024-11-08,27 ( 0.19 %),8026,56881900,7087.2,13870,56069900,4043,812000
2024-11-07,26.95 ( 0 %),5067,35842300,7073.67,10694,40667100,3803,-4824800
2024-11-06,0 ( 0 %),7776,55012100,7074.6,10827,38084700,3518,16927400
2024-11-05,26.5 ( 0.76 %),5977,22637000,3787.35,4250,14760700,3473,7876300
2024-11-04,26.3 ( -0.94 %),10520,31035800,2950.17,4319,28464300,6590,2571500
2024-11-01,26.55 ( -1.3 %),9858,27532200,2792.88,5606,27650800,4932,-118600
2024-10-31,26.9 ( -0.37 %),6531,23311900,3569.42,6792,28281600,4164,-4969700
2024-10-30,27 ( -0.18 %),4940,34067300,6896.21,6713,27129800,4041,6937500
2024-10-29,27.05 ( 1.12 %),6211,42593100,6857.69,8045,29514500,3669,13078600
2024-10-28,26.75 ( 1.13 %),6195,30002900,4843.08,6952,27749700,3992,2253200
2024-10-25,26.45 ( 0 %),5353,21557500,4027.18,5399,22211800,4114,-654300
2024-10-24,26.45 ( 0 %),9413,35867800,3810.45,6580,27747000,4217,8120800
2024-10-23,26.45 ( -0.75 %),10041,31898600,3176.83,4931,23636800,4794,8261800
2024-10-22,26.65 ( -0.37 %),10533,31381600,2979.36,6385,30726800,4812,654800
2024-10-21,26.75 ( -0.74 %),9068,23210400,2559.59,6349,26045100,4102,-2834700
2024-10-18,26.95 ( -1.1 %),15604,27835700,1783.88,6106,37094600,6075,-9258900
2024-10-17,27.25 ( 0.55 %),10957,36139900,3298.34,7769,38640800,4974,-2500900
2024-10-16,27.1 ( -0.18 %),10370,24716900,2383.5,7400,28253400,3818,-3536500
2024-10-15,27.15 ( 0.37 %),9129,43303100,4743.47,12161,44244600,3638,-941500
2024-10-14,27.05 ( -0.92 %),9241,29378600,3179.16,8655,34501500,3986,-5122900
2024-10-11,27.3 ( 0.18 %),8489,35829600,4220.71,9438,35940200,3808,-110600
2024-10-10,27.25 ( -0.91 %),10604,44580900,4204.16,15530,58643900,3776,-14063000
2024-10-09,27.5 ( 2.04 %),14160,82903900,5854.8,21474,82483300,3841,420600
2024-10-08,26.95 ( 2.08 %),12192,68112300,5586.64,17508,68130400,3891,-18100
2024-10-07,26.4 ( 0.76 %),5619,26327800,4685.5,7588,32536900,4288,-6209100
2024-10-04,26.2 ( 0 %),8158,36035300,4417.17,7411,38033600,5132,-1998300
2024-10-03,26.2 ( -0.38 %),11066,50323500,4547.58,10824,53470400,4940,-3146900
2024-10-02,26.3 ( -1.68 %),12953,37642500,2906.08,8704,42435000,4875,-4792500
2024-10-01,26.75 ( 1.52 %),13775,65717900,4770.81,20123,76401100,3797,-10683200
2024-09-30,26.35 ( 1.15 %),10752,78788800,7327.83,17216,72274800,4198,6514000
2024-09-27,26.05 ( 0 %),12859,55818000,4340.77,12368,58812500,4755,-2994500
2024-09-26,26.05 ( -0.57 %),9608,39240300,4084.13,13363,53060500,3971,-13820200
2024-09-25,26.2 ( 1.35 %),12576,65076300,5174.64,19882,81273000,4088,-16196700
2024-09-24,25.85 ( 0.58 %),6742,23467700,3480.82,7948,30319300,3815,-6851600
2024-09-23,25.7 ( 0.19 %),7915,30750800,3885.13,11038,47556600,4308,-16805800
2024-09-20,25.65 ( 1.58 %),14627,79698800,5448.75,23924,91471700,3823,-11772900
2024-09-19,25.25 ( 0.6 %),7242,26323000,3634.77,10470,41017500,3918,-14694500
2024-09-18,25.1 ( -0.59 %),9690,22724700,2345.17,8007,33140600,4139,-10415900
2024-09-17,25.25 ( 1.61 %),11249,23988200,2132.47,5711,24865600,4354,-877400
2024-09-16,24.85 ( -0.6 %),13103,25049200,1911.71,7312,32183500,4401,-7134300
2024-09-13,25 ( -0.4 %),11004,19989500,1816.57,4595,26993300,5874,-7003800
2024-09-12,25.1 ( -0.99 %),7563,15460000,2044.16,5978,27259400,4560,-11799400
2024-09-11,25.35 ( 0.8 %),10790,33458100,3100.84,7917,31763000,4012,1695100
2024-09-10,25.15 ( -1.76 %),12197,28257600,2316.77,9108,38127300,4186,-9869700
2024-09-09,25.6 ( 0.79 %),15808,55327700,3499.98,18187,72626300,3993,-17298600
2024-09-06,25.4 ( 1.4 %),17953,38718100,2156.64,8899,39122200,4396,-404100
2024-09-05,25.05 ( -0.79 %),16279,34727600,2133.28,7338,35482800,4835,-755200
2024-09-04,25.25 ( -0.98 %),21575,40233400,1864.82,7754,31395400,4049,8838000
2024-08-30,25.5 ( -0.39 %),11601,31149000,2685.03,11303,29762500,2633,1386500
2024-08-29,25.6 ( -0.39 %),9677,27510600,2842.89,8850,35800200,4045,-8289600
2024-08-28,25.7 ( -0.19 %),12881,32225100,2501.75,8830,35081200,3973,-2856100
2024-08-27,25.75 ( -0.96 %),10775,27390600,2542.05,7022,30084500,4284,-2693900
2024-08-26,26 ( -0.19 %),10058,37187000,3697.26,13219,47936100,3626,-10749100
2024-08-23,26.05 ( 1.17 %),22205,50273300,2264.05,12493,36351200,2910,13922100
2024-08-22,25.75 ( -1.53 %),19985,41530900,2078.1,11024,47548800,4313,-6017900
2024-08-21,26.15 ( 1.36 %),14291,42056800,2942.89,13002,45210400,3477,-3153600
2024-08-20,25.8 ( -0.19 %),12134,36611400,3017.26,11365,42845700,3770,-6234300
2024-08-19,25.85 ( 0.98 %),13017,45440900,3490.89,14176,45102900,3182,338000
2024-08-16,25.6 ( 1.59 %),23411,68074900,2907.82,14119,53175200,3766,14899700
2024-08-15,25.2 ( -0.98 %),13363,29257600,2189.45,7974,26534800,3328,2722800
2024-08-14,25.45 ( 0.2 %),11562,31357600,2712.13,6570,24209300,3685,7148300
2024-08-13,25.4 ( -1.74 %),24193,49855500,2060.74,7626,41962000,5502,7893500
2024-08-12,25.85 ( -0.77 %),11982,23610500,1970.5,5560,21364900,3843,2245600
2024-08-08,25.6 ( -1.73 %),16540,36551700,2209.9,6731,32544800,4835,4006900
2024-08-07,26.05 ( -0.95 %),13014,26027300,1999.95,6103,24603800,4031,1423500
2024-08-06,26.3 ( 1.35 %),11541,35916800,3112.1,9551,30840300,3229,5076500
2024-08-05,25.95 ( -4.77 %),20018,60777500,3036.14,10574,66505400,6290,-5727900
2024-08-02,27.25 ( 2.06 %),12335,39736000,3221.4,8635,28713700,3325,11022300
2024-08-01,26.7 ( -1.84 %),18926,47591400,2514.6,10871,52376200,4818,-4784800
2024-07-31,27.2 ( -2.51 %),18895,41323100,2186.99,8730,43764800,5013,-2441700
2024-07-30,27.9 ( 0 %),5885,24653900,4189.28,8717,32739600,3756,-8085700
2024-07-29,27.9 ( 1.64 %),7396,26974900,3647.23,8702,29974600,3445,-2999700
2024-07-26,27.45 ( 0.37 %),7633,23436100,3070.37,4760,18881600,3967,4554500
2024-07-25,27.35 ( -1.26 %),12508,29463300,2355.56,4609,27910100,6056,1553200
2024-07-24,27.7 ( -0.36 %),17198,37133000,2159.15,7387,37333500,5054,-200500
2024-07-22,28.05 ( -0.53 %),12896,35834500,2778.73,7401,32147400,4344,3687100
2024-07-19,28.2 ( -0.7 %),8935,24430300,2734.22,6430,27435100,4267,-3004800
2024-07-18,28.4 ( 0.71 %),11167,38636500,3459.88,7349,33893100,4612,4743400
2024-07-17,28.2 ( -0.88 %),14967,38657100,2582.82,9071,44515200,4907,-5858100
2024-07-16,28.45 ( 0 %),7205,21175300,2938.97,6224,23348800,3751,-2173500
2024-07-15,28.45 ( -0.18 %),14990,28826900,1923.08,6834,32706200,4786,-3879300
2024-07-12,28.5 ( -1.21 %),12954,30488600,2353.61,7472,39809800,5328,-9321200
2024-07-11,0 ( 0 %),6047,23303500,3853.73,8589,39213700,4566,-15910200
2024-07-10,28.95 ( -0.17 %),11179,51360600,4594.38,16684,74134300,4443,-22773700
2024-07-09,29 ( 0.69 %),9477,38992300,4114.41,12181,48574800,3988,-9582500
2024-07-08,28.8 ( 0.52 %),7686,32540000,4233.67,11053,49191700,4451,-16651700
2024-07-05,28.65 ( -0.17 %),6706,23141300,3450.84,7315,38427600,5253,-15286300
2024-07-04,28.7 ( -0.17 %),6468,19821500,3064.55,7984,34975800,4381,-15154300
2024-07-03,28.75 ( 0.17 %),6699,35724900,5332.87,10197,45162200,4429,-9437300
2024-07-02,28.7 ( 1.23 %),11206,36044800,3216.56,8595,41486900,4827,-5442100
2024-07-01,28.35 ( 0.18 %),10785,28795900,2670,5621,32811100,5837,-4015200
2024-06-28,28.3 ( -1.91 %),11990,35797700,2985.63,8272,40063200,4843,-4265500
2024-06-27,28.85 ( -0.17 %),5473,19369800,3539.16,6060,28033800,4626,-8664000
2024-06-26,28.9 ( 0.7 %),9544,38946900,4080.77,8946,41701000,4661,-2754100
2024-06-25,28.7 ( 0 %),9955,34229800,3438.45,7890,34773900,4407,-544100
2024-06-24,28.7 ( -1.2 %),23707,59766300,2521.04,9964,65720300,6596,-5954000
2024-06-21,29.05 ( -1.02 %),9763,28817900,2951.75,6089,28873900,4742,-56000
2024-06-20,29.35 ( 0 %),15138,43894700,2899.64,8550,50045100,5853,-6150400
2024-06-19,29.35 ( -0.17 %),8769,34261000,3907.06,7955,38527300,4843,-4266300
2024-06-18,29.4 ( -0.17 %),7087,28558300,4029.67,10511,40097000,3815,-11538700
2024-06-17,29.45 ( 1.2 %),14511,62325700,4295.07,18841,68113700,3615,-5788000
2024-06-14,29.1 ( -1.36 %),11715,51030100,4355.96,19197,68316800,3559,-17286700
2024-06-13,29.5 ( -0.34 %),9842,36278600,3686.1,11768,46073600,3915,-9795000
2024-06-12,29.6 ( 1.72 %),10894,34372000,3155.13,8256,34790900,4214,-418900
2024-06-11,29.1 ( -0.68 %),14975,44274000,2956.53,10953,58754700,5364,-14480700
2024-06-10,29.3 ( 0 %),9685,38022700,3925.94,8020,38546100,4806,-523400
2024-06-07,29.3 ( 0 %),7266,28154700,3874.86,8697,34464100,3963,-6309400
2024-06-06,29.3 ( 0.17 %),7895,33013800,4181.61,14288,48389100,3387,-15375300
2024-06-05,29.25 ( -0.17 %),8509,33664800,3956.38,10826,50567000,4671,-16902200
2024-06-04,29.3 ( 1.03 %),13543,62348100,4603.71,20891,83160300,3981,-20812200
2024-06-03,29 ( 1.4 %),7118,31121600,4372.24,11948,43926900,3677,-12805300
2024-05-31,28.6 ( 1.24 %),12795,37854300,2958.52,7150,34451400,4818,3402900
2024-05-30,28.25 ( -1.22 %),23394,50703300,2167.36,8211,47138500,5741,3564800
2024-05-29,28.6 ( -1.89 %),14482,36058300,2489.87,9323,43412100,4656,-7353800
2024-05-28,29.15 ( 0.87 %),10069,33852500,3362.05,9976,37246400,3734,-3393900
2024-05-27,28.9 ( 0 %),10187,31743300,3116.06,7238,38465800,5314,-6722500
2024-05-24,28.9 ( -2.03 %),20729,47796400,2305.77,9513,52717100,5542,-4920700
2024-05-23,29.5 ( 3.69 %),24691,65936800,2670.48,10782,54488600,5054,11448200
2024-05-22,31.3 ( -1.73 %),20253,58026500,2865.08,13887,74073600,5334,-16047100
2024-05-21,31.85 ( -0.47 %),10054,35871500,3567.88,10984,44363100,4039,-8491600
2024-05-20,32 ( 1.27 %),10272,88491400,8614.82,22351,86691200,3879,1800200
2024-05-17,31.6 ( 0 %),13749,53471900,3889.15,10828,46752400,4318,6719500
2024-05-16,31.6 ( 1.28 %),8985,47193700,5252.5,21485,62285500,2899,-15091800
2024-05-15,31.2 ( 3.31 %),14036,87764900,6252.84,30101,81831500,2719,5933400
2024-05-14,30.2 ( 0 %),8209,34547100,4208.44,9762,36001200,3688,-1454100
2024-05-13,30.2 ( -0.82 %),7196,24370900,3386.73,7828,31842600,4068,-7471700
2024-05-10,30.45 ( 0 %),9373,40550700,4326.33,11826,42667900,3608,-2117200
2024-05-09,30.45 ( -0.81 %),9034,33529600,3711.49,14440,47306800,3276,-13777200
2024-05-08,30.7 ( 1.82 %),11047,53348300,4829.21,23090,68368900,2961,-15020600
2024-05-07,30.15 ( 2.9 %),9045,47990100,5305.7,17698,49967500,2823,-1977400
2024-05-06,29.3 ( 2.27 %),7728,38799100,5020.59,12454,44365100,3562,-5566000
2024-05-03,28.65 ( 1.06 %),7844,27170400,3463.84,12860,35302700,2745,-8132300
2024-05-02,28.35 ( -0.18 %),7298,15102200,2069.36,3919,17000800,4338,-1898600
2024-04-26,28.4 ( -0.53 %),12885,30360900,2356.3,6825,31157400,4565,-796500
2024-04-25,28.55 ( -0.87 %),8057,19765700,2453.23,6836,24864300,3637,-5098600
2024-04-24,28.8 ( 4.35 %),11984,39093900,3262.17,12719,41842500,3290,-2748600
2024-04-23,27.6 ( -1.43 %),12936,26916000,2080.71,6179,31084600,5031,-4168600
2024-04-22,28 ( 0.72 %),9517,19748600,2075.09,6462,26333400,4075,-6584800
2024-04-19,27.8 ( -0.71 %),18686,45141800,2415.81,12098,47336000,3913,-2194200
2024-04-17,28 ( -1.23 %),14202,28082000,1977.33,7341,29465500,4014,-1383500
2024-04-16,28.35 ( -0.53 %),26549,59838400,2253.89,13415,56791300,4233,3047100
2024-04-15,28.5 ( -4.84 %),17393,43006700,2472.64,10577,50907300,4813,-7900600
2024-04-12,29.95 ( 0.17 %),10685,24426900,2286.09,7526,31298800,4159,-6871900
2024-04-11,29.9 ( 0.84 %),14247,37287600,2617.22,12561,40463500,3221,-3175900
2024-04-10,29.65 ( -0.84 %),7480,16719900,2235.28,9609,33044200,3439,-16324300
2024-04-09,29.9 ( 1.01 %),9246,19504600,2109.52,7136,23132600,3242,-3628000
2024-04-08,29.6 ( 0.51 %),13912,31827000,2287.74,9043,32437100,3587,-610100
2024-04-05,29.45 ( -0.51 %),22273,46894600,2105.45,8082,41234900,5102,5659700
2024-04-04,29.6 ( -1.17 %),23630,43517100,1841.6,9314,43241100,4643,276000
2024-04-03,29.95 ( -1.48 %),15417,33756300,2189.55,7967,41269900,5180,-7513600
2024-04-02,30.4 ( 1 %),21755,50939500,2341.51,8779,45839300,5221,5100200
2024-04-01,30.1 ( -0.5 %),17678,37184600,2103.44,7382,40513100,5488,-3328500
2024-03-29,30.25 ( -0.98 %),13853,29097700,2100.46,7238,34295500,4738,-5197800
2024-03-28,30.55 ( -0.16 %),10790,31520000,2921.22,9862,43041700,4364,-11521700
2024-03-27,30.6 ( 0.16 %),12377,37602300,3038.08,17390,60959900,3505,-23357600
2024-03-26,30.55 ( 1.16 %),8741,25666100,2936.29,8221,29054400,3534,-3388300
2024-03-25,30.2 ( -1.15 %),14841,40655700,2739.42,12580,43142900,3429,-2487200
2024-03-22,30.55 ( 0.99 %),16642,63533000,3817.63,21411,73121200,3415,-9588200
2024-03-21,30.25 ( 0.83 %),9280,34895000,3760.24,15700,49394200,3146,-14499200
2024-03-20,30 ( 0.67 %),9991,29223800,2925.01,9356,32382500,3461,-3158700
2024-03-19,29.8 ( 0.68 %),19775,52099000,2634.59,14815,57709500,3895,-5610500
2024-03-18,29.6 ( -1.66 %),39259,89913600,2290.27,14745,81722300,5542,8191300
2024-03-15,30.1 ( -0.82 %),26660,65183200,2444.98,10942,64345200,5881,838000
2024-03-14,30.35 ( -1.46 %),20132,51599000,2563.03,12531,66585000,5314,-14986000
2024-03-13,30.8 ( 1.99 %),17555,53311100,3036.8,14421,61391100,4257,-8080000
2024-03-12,30.2 ( 1 %),21308,64471600,3025.7,11512,58423600,5075,6048000
2024-03-11,29.9 ( -1.32 %),23137,60148100,2599.65,10134,54085100,5337,6063000
2024-03-08,30.3 ( -2.26 %),34651,82949400,2393.85,10530,86657200,8230,-3707800
2024-03-07,31 ( 0.65 %),18436,62927700,3413.31,12653,63313400,5004,-385700
2024-03-06,30.6 ( -1.77 %),19350,50469700,2608.25,9175,49359200,5380,1110500
2024-03-05,31.15 ( 1.14 %),14335,59504500,4150.99,12546,50436000,4020,9068500
2024-03-04,30.8 ( -0.16 %),15511,46967000,3027.98,14728,63653300,4322,-16686300
2024-03-01,30.85 ( -0.48 %),17072,48785200,2857.61,12523,63638800,5082,-14853600
2024-02-29,31 ( 1.31 %),15608,54946800,3520.43,18180,61976500,3409,-7029700
2024-02-28,30.6 ( 0.82 %),20063,76591600,3817.55,19684,66547100,3381,10044500
2024-02-27,30.35 ( 5.38 %),30567,160816700,5261.12,37271,139641000,3747,21175700
2024-02-26,28.8 ( 1.41 %),11905,36999800,3107.92,7701,31278800,4062,5721000
2024-02-23,28.4 ( -0.53 %),12623,43578500,3452.31,10567,48491200,4589,-4912700
2024-02-22,28.55 ( -0.87 %),15229,39382100,2585.99,7105,39012000,5491,370100
2024-02-21,28.8 ( -1.37 %),16431,52456700,3192.54,10281,63934300,6219,-11477600
2024-02-20,29.2 ( 0 %),11731,36472400,3109.06,10974,51794900,4720,-15322500
2024-02-19,29.2 ( 2.1 %),17206,67798600,3940.4,17392,69848600,4016,-2050000
2024-02-16,28.6 ( -0.35 %),10486,29480900,2811.45,8910,36514300,4098,-7033400
2024-02-15,28.7 ( 1.95 %),11627,68997500,5934.25,15367,63828000,4154,5169500
2024-02-07,28.15 ( 0.36 %),0,0,0,0,0,0,0
2024-02-06,28.05 ( 0.18 %),6589,25174200,3820.64,7572,34285800,4528,-9111600
2024-02-05,28 ( 0.36 %),6185,27570700,4457.67,9432,40254700,4268,-12684000
2024-02-02,27.9 ( 0.18 %),7028,32227400,4585.57,7432,30514600,4106,1712800
2024-02-01,27.85 ( 0.36 %),6833,22778700,3333.63,5838,25305700,4335,-2527000
2024-01-31,27.75 ( -0.89 %),12113,36698800,3029.7,6664,44062300,6612,-7363500
2024-01-30,28 ( 0 %),9709,32080500,3304.2,5192,29979500,5774,2101000
2024-01-29,28 ( -1.23 %),11781,35840600,3042.24,7572,39560400,5225,-3719800
2024-01-26,28.35 ( 0.35 %),5712,26133700,4575.23,9003,29612400,3289,-3478700
2024-01-25,28.25 ( 0 %),8890,32646300,3672.25,7922,34507900,4356,-1861600
2024-01-24,28.25 ( -0.35 %),7637,30058000,3935.84,10127,38361600,3788,-8303600
2024-01-23,28.35 ( 0.18 %),8107,35081800,4327.35,10905,51364100,4710,-16282300
2024-01-22,28.3 ( 1.8 %),21151,108667600,5137.71,27411,119716100,4367,-11048500
2024-01-19,27.8 ( 0.54 %),5400,27136400,5025.26,9294,35763000,3848,-8626600
2024-01-18,27.65 ( 0 %),5251,26434500,5034.18,7649,33259700,4348,-6825200
2024-01-17,27.65 ( -0.54 %),8490,37878700,4461.57,13005,57968000,4457,-20089300
2024-01-16,27.8 ( 2.58 %),9107,43972700,4828.45,7628,35407400,4642,8565300
2024-01-15,27.1 ( -0.18 %),6799,26892800,3955.41,5014,27311300,5447,-418500
2024-01-12,27.15 ( -1.27 %),17060,57565000,3374.27,5696,47915600,8412,9649400
2024-01-11,27.5 ( 0.55 %),8221,39378700,4790.01,5759,30153100,5236,9225600
2024-01-10,27.35 ( -1.26 %),0,0,0,0,0,0,0
2024-01-09,27.7 ( -0.54 %),13353,48781500,3653.22,7843,55173300,7035,-6391800
2024-01-08,27.85 ( 0.18 %),9976,61701000,6184.94,15146,61613300,4068,87700
2024-01-05,27.8 ( 0.18 %),8893,39297900,4418.97,8229,43472200,5283,-4174300
2024-01-04,27.75 ( -0.18 %),11162,58104700,5205.58,16058,84877900,5286,-26773200
2024-01-03,27.8 ( 1.28 %),7874,32646700,4146.14,6183,34679300,5609,-2032600
2024-01-02,27.45 ( -1.79 %),10109,32609700,3225.81,8551,43827900,5125,-11218200
2023-12-29,27.95 ( 0 %),0,0,0,0,0,0,0
2023-12-28,27.95 ( 0.72 %),9352,55271400,5910.12,15888,58720900,3696,-3449500
2023-12-27,27.75 ( -0.18 %),6555,35808500,5462.78,14888,51499100,3459,-15690600
2023-12-26,27.8 ( 1.28 %),10257,63887800,6228.7,16734,70538700,4215,-6650900
2023-12-25,27.45 ( 1.48 %),6558,40929400,6241.14,10869,47096300,4333,-6166900
2023-12-22,27.05 ( -0.55 %),8968,30140500,3360.89,9287,38503900,4146,-8363400
2023-12-21,27.2 ( 0 %),9107,35779100,3928.75,7703,31714400,4117,4064700
2023-12-20,27.2 ( 0 %),6543,30715300,4694.38,9139,43253200,4733,-12537900
2023-12-19,27.2 ( 2.26 %),9557,39962100,4181.45,7466,36165500,4844,3796600
2023-12-18,26.6 ( -0.75 %),9348,30077900,3217.58,5678,31839200,5607,-1761300
2023-12-15,26.8 ( -0.92 %),17754,67310000,3791.26,11259,54855100,4872,12454900
2023-12-14,27.05 ( -1.1 %),12869,56128700,4361.54,8795,60118200,6835,-3989500
2023-12-13,27.35 ( -2.15 %),12866,49124100,3818.13,15432,71869200,4657,-22745100
2023-12-12,27.95 ( 1.64 %),8470,58007300,6848.56,19666,77713600,3952,-19706300
2023-12-11,27.5 ( -0.72 %),8410,35144100,4178.85,8082,39100700,4838,-3956600
2023-12-08,27.7 ( 0.36 %),13821,87756900,6349.53,27640,117159500,4239,-29402600
2023-12-07,27.6 ( 0 %),14829,81716800,5510.61,20870,96249800,4612,-14533000
2023-12-06,27.6 ( 1.28 %),8030,34039300,4239.02,10851,45020800,4149,-10981500
2023-12-05,27.25 ( -0.91 %),12423,41905200,3373.19,11948,47486100,3974,-5580900
2023-12-04,27.5 ( 2.23 %),12506,65902900,5269.7,22633,82727800,3655,-16824900
2023-12-01,26.9 ( 1.32 %),7527,34930400,4640.68,10720,37615100,3509,-2684700
2023-11-30,26.55 ( -1.67 %),9958,42397000,4257.58,12671,50981300,4023,-8584300
2023-11-29,27 ( 1.12 %),7827,36199300,4624.93,13448,52384200,3895,-16184900
2023-11-28,26.7 ( 1.52 %),10112,34023100,3364.63,9131,36011300,3944,-1988200
2023-11-27,26.3 ( -0.38 %),9044,29620700,3275.18,7257,36329600,5006,-6708900
2023-11-24,26.4 ( 2.13 %),16065,52876800,3291.43,9664,46843400,4847,6033400
2023-11-23,25.85 ( -4.96 %),10570,30335700,2869.98,10307,50367600,4887,-20031900
2023-11-22,27.2 ( 0.55 %),7685,34126900,4440.72,11333,44287300,3908,-10160400
2023-11-21,27.05 ( 1.5 %),7634,44013300,5765.43,18785,67407400,3588,-23394100
2023-11-20,26.65 ( 0.57 %),12007,40825200,3400.12,8528,35409400,4152,5415800
2023-11-17,26.5 ( -2.57 %),17195,58789500,3418.99,14524,72679700,5004,-13890200
2023-11-16,27.2 ( 0.74 %),9076,33859300,3730.64,7949,34570500,4349,-711200
2023-11-15,27 ( 0 %),10652,71405600,6703.49,20041,82326300,4108,-10920700
2023-11-14,27 ( -0.74 %),14800,43379100,2931.02,15205,52782700,3471,-9403600
2023-11-13,27.2 ( 2.64 %),13858,75280200,5432.26,24868,82203700,3306,-6923500
2023-11-10,26.5 ( -0.75 %),13674,52297800,3824.62,12999,48998900,3769,3298900
2023-11-09,26.7 ( -0.93 %),15674,50793900,3240.65,18858,66402000,3521,-15608100
2023-11-08,26.95 ( 4.46 %),12211,59850300,4901.34,14993,53967900,3600,5882400
2023-11-07,25.8 ( 0.19 %),10906,54942100,5037.79,11089,43539600,3926,11402500
2023-11-06,25.75 ( 2.59 %),8559,45840300,5355.8,13036,48782800,3742,-2942500
2023-11-03,25.1 ( -0.59 %),13999,45203100,3229.02,11578,40282300,3479,4920800
2023-11-01,23.95 ( 4.13 %),7750,35744700,4612.22,8690,31984800,3681,3759900
2023-10-31,23 ( 0 %),7922,36134100,4561.23,8023,39524100,4926,-3390000
2023-10-30,23 ( -1.5 %),7596,25939000,3414.82,5961,28764800,4825,-2825800
2023-10-27,23.35 ( 2.41 %),8483,32730100,3858.32,8925,24759000,2774,7971100
2023-10-26,22.8 ( -5.2 %),18950,53215100,2808.18,9691,50675700,5229,2539400
2023-10-25,24.05 ( 0.21 %),6800,25558800,3758.65,8017,27303000,3406,-1744200
2023-10-24,24 ( 0 %),7006,21706200,3098.23,6314,18919400,2996,2786800
2023-10-23,24 ( -1.44 %),9527,23485600,2465.16,5081,23117800,4550,367800
2023-10-20,24.35 ( 2.74 %),10769,30931300,2872.25,7422,26970300,3634,3961000
2023-10-19,23.7 ( -1.25 %),14040,44974600,3203.32,7302,34963800,4788,10010800
2023-10-18,0 ( 0 %),16647,47686800,2864.59,9542,50817000,5326,-3130200
2023-10-17,24.8 ( -0.8 %),8566,24696400,2883.07,6523,25941100,3977,-1244700
2023-10-16,25 ( -2.91 %),13513,27535400,2037.7,5239,26756000,5107,779400
2023-10-13,25.75 ( -0.19 %),17267,39917300,2311.77,6719,30760000,4578,9157300
2023-10-12,25.8 ( -1.53 %),15603,38200900,2448.3,8012,40180100,5015,-1979200
2023-10-11,26.2 ( 0.77 %),7998,25121000,3140.91,6651,27995400,4209,-2874400
2023-10-10,26 ( 1.96 %),13227,43287600,3272.67,11914,38078100,3196,5209500
2023-10-09,25.5 ( 2.2 %),7467,27900700,3736.53,7417,23104300,3115,4796400
2023-10-06,24.95 ( 0.2 %),10031,35539600,3542.98,7043,26566500,3772,8973100
2023-10-05,24.9 ( -1.39 %),8325,20715400,2488.34,6821,23369800,3426,-2654400
2023-10-04,25.25 ( 1.81 %),15028,41441800,2757.64,9492,34484100,3633,6957700
2023-10-03,24.8 ( -5.34 %),27419,67145100,2448.85,10648,65103500,6114,2041600
2023-10-02,26.2 ( -0.38 %),11748,23176200,1972.78,5061,23984100,4739,-807900
2023-09-29,26.3 ( -1.13 %),12098,25997900,2148.94,5781,33202000,5743,-7204100
2023-09-28,26.6 ( 0.38 %),12613,34756800,2755.63,7745,34258600,4423,498200
2023-09-27,26.5 ( 1.15 %),10951,35714100,3261.26,8964,34963300,3900,750800
2023-09-26,26.2 ( 0.77 %),14423,53749500,3726.65,12611,50145500,3976,3604000
2023-09-25,26 ( -4.76 %),18458,55728200,3019.19,11487,60195800,5240,-4467600
2023-09-22,27.3 ( -3.87 %),32012,86336300,2697,13148,114861900,8736,-28525600
2023-09-21,28.4 ( 0 %),17512,70788100,4042.26,22695,89585300,3947,-18797200
2023-09-20,28.4 ( 0.89 %),12103,48997500,4048.38,11169,46460400,4160,2537100
2023-09-19,28.15 ( 1.99 %),10728,40474400,3772.78,10629,39429600,3710,1044800
2023-09-18,27.6 ( 0 %),11734,41748800,3557.93,9452,39840800,4215,1908000
2023-09-15,27.6 ( -0.72 %),13516,43540000,3221.37,8499,40855800,4807,2684200
2023-09-14,27.8 ( -2.11 %),19082,59119000,3098.16,10390,58004200,5583,1114800
2023-09-13,28.4 ( -1.22 %),21340,83410800,3908.66,21948,93834400,4275,-10423600
2023-09-12,28.75 ( 2.68 %),13608,47564700,3495.35,11193,45181400,4037,2383300
2023-09-11,28 ( -2.61 %),26216,70539100,2690.69,16461,76433000,4643,-5893900
2023-09-08,28.75 ( 0.35 %),14970,65628300,4383.99,16724,63377300,3790,2251000
2023-09-07,28.65 ( -1.21 %),21098,59385300,2814.74,19513,71021100,3640,-11635800
2023-09-06,29 ( 4.32 %),20719,95979500,4632.44,26632,81349700,3055,14629800
2023-09-05,27.8 ( 0.72 %),13072,39415500,3015.26,12764,45549800,3569,-6134300
2023-08-31,27.6 ( 1.47 %),12485,45658700,3657.08,18816,57641000,3063,-11982300
2023-08-30,27.2 ( 0.74 %),11431,34613700,3028.06,9645,35582300,3689,-968600
2023-08-29,27 ( 0.56 %),10912,30201800,2767.76,11986,37541400,3132,-7339600
2023-08-28,26.85 ( 3.47 %),9539,52749700,5529.9,14301,38267400,2676,14482300
2023-08-25,25.95 ( -1.33 %),16278,44222300,2716.69,7946,38531500,4849,5690800
2023-08-24,26.3 ( 2.53 %),12672,41513100,3275.97,11078,30149100,2722,11364000
2023-08-23,25.65 ( -1.91 %),18543,41658000,2246.56,9137,38816900,4248,2841100
2023-08-22,26.15 ( -0.19 %),27081,67884800,2506.73,14242,55681200,3910,12203600
2023-08-21,26.2 ( -1.13 %),19214,54238700,2822.87,12755,54593700,4280,-355000
2023-08-18,26.5 ( -5.69 %),24657,69935100,2836.32,16448,82443500,5012,-12508400
2023-08-17,28.1 ( 0.36 %),20057,73558300,3667.46,23134,84243500,3642,-10685200
2023-08-16,27.95 ( -0.18 %),13326,27100300,2033.64,7640,28775700,3766,-1675400
2023-08-15,27.95 ( -0.89 %),13432,32575600,2425.22,10664,41725200,3913,-9149600
2023-08-14,28.15 ( 1.62 %),17667,71603200,4052.93,21019,80287500,3820,-8684300
2023-08-11,27.7 ( 1.28 %),13721,40638900,2961.8,11885,48670700,4095,-8031800
2023-08-10,27.35 ( -1.62 %),13909,28649200,2059.76,10616,40785800,3842,-12136600
2023-08-09,27.8 ( 2.21 %),18305,72984700,3987.15,18742,77167900,4117,-4183200
2023-08-08,27.2 ( -1.27 %),18733,42758100,2282.5,11248,60001800,5334,-17243700
2023-08-07,27.55 ( 0.73 %),11827,38969500,3294.96,11222,49803000,4438,-10833500
2023-08-04,27.35 ( 1.86 %),16098,40836100,2536.72,9520,37117200,3899,3718900
2023-08-03,26.85 ( -2.36 %),41484,88860000,2142.03,13275,107409400,8091,-18549400
2023-08-02,27.5 ( 0 %),16160,40921100,2532.25,9200,36865000,4007,4056100
2023-08-01,27.5 ( -2.48 %),15740,43335000,2753.18,7982,47657500,5971,-4322500
2023-07-31,28.2 ( -0.35 %),31071,79726700,2565.95,12537,73404200,5855,6322500
2023-07-28,28.3 ( -0.35 %),13644,39878200,2922.76,9802,43488900,4437,-3610700
2023-07-27,28.4 ( 0 %),13063,39421000,3017.76,9318,40958000,4396,-1537000
2023-07-26,28.4 ( 0.53 %),8570,36809200,4295.12,7822,37443100,4787,-633900
2023-07-25,28.25 ( -0.18 %),12163,37166500,3055.7,8151,36586800,4489,579700
2023-07-24,28.25 ( -0.53 %),12274,30294200,2468.16,7537,35066900,4653,-4772700
2023-07-21,28.4 ( 0.71 %),10306,33742100,3274.02,10356,32047500,3095,1694600
2023-07-20,28.2 ( 2.92 %),11084,64613800,5829.47,15023,49539300,3298,15074500
2023-07-19,27.4 ( 0.74 %),10745,30472000,2835.92,9513,37598300,3952,-7126300
2023-07-18,27.2 ( -0.37 %),9736,21876000,2246.92,5453,23384900,4288,-1508900
2023-07-17,27.3 ( -0.73 %),9837,21771500,2213.23,7908,29527000,3734,-7755500
2023-07-14,27.5 ( 1.48 %),8516,30500900,3581.6,9552,31202800,3267,-701900
2023-07-13,27.05 ( 0.19 %),10839,25479300,2350.71,7673,30170300,3932,-4691000
2023-07-12,27 ( -1.1 %),22194,55515900,2501.39,10224,49747000,4866,5768900
2023-07-11,27.3 ( -1.44 %),12419,37749400,3039.65,11798,43372100,3676,-5622700
2023-07-10,27.7 ( 0.73 %),10386,35256200,3394.59,11498,41758800,3632,-6502600
2023-07-07,27.45 ( 1.67 %),9288,39857300,4291.27,11959,38588200,3227,1269100
2023-07-06,27 ( 0 %),16455,43834600,2663.91,11989,48958700,4084,-5124100
2023-07-05,26.95 ( 2.47 %),9466,56784900,5998.83,15109,54557700,3611,2227200
2023-07-04,26.25 ( 0.19 %),10600,32367000,3053.49,6320,32302000,5111,65000
2023-07-03,26.2 ( 0 %),12675,28922100,2281.82,6662,30221900,4536,-1299800
2023-06-30,26.15 ( 1.36 %),10889,44862500,4119.98,10979,37334100,3401,7528400
2023-06-29,25.8 ( -3.01 %),19403,60194300,3102.32,13424,68394000,5095,-8199700
2023-06-28,26.6 ( 3.1 %),12614,51755400,4103.01,14412,52688800,3656,-933400
2023-06-27,25.8 ( 2.38 %),8567,60132500,7019.08,9235,33031000,3577,27101500
2023-06-26,25.2 ( -0.79 %),13652,44293600,3244.48,8619,37074600,4301,7219000
2023-06-23,25.4 ( 2.01 %),0,0,0,0,0,0,0
2023-06-22,24.85 ( 1.02 %),10488,44974600,4288.2,11031,43174500,3914,1800100
2023-06-21,24.6 ( 3.8 %),9125,78011300,8549.18,16750,54980000,3282,23031300
2023-06-20,23.65 ( 1.07 %),4876,26902900,5517.41,7549,26249900,3477,653000
2023-06-19,23.35 ( -0.64 %),5473,20274000,3704.37,7081,24854100,3510,-4580100
2023-06-16,23.45 ( 1.08 %),6858,49402700,7203.66,15609,58948000,3777,-9545300
2023-06-15,23.15 ( 0.22 %),7175,29958000,4175.33,9179,36695700,3998,-6737700
2023-06-14,23.1 ( -1.28 %),7463,32261100,4322.81,10856,46782200,4309,-14521100
2023-06-13,23.4 ( 1.96 %),9483,56766900,5986.18,18397,67926300,3692,-11159400
2023-06-12,22.95 ( 0.22 %),9842,34942900,3550.39,9576,47564900,4967,-12622000
2023-06-09,22.9 ( 0.44 %),10465,45667900,4363.87,9722,47846500,4921,-2178600
2023-06-08,22.8 ( 0.88 %),12537,62586700,4992.16,23818,86169000,3618,-23582300
2023-06-07,22.6 ( 3.91 %),17830,107388100,6022.89,27346,97261800,3557,10126300
2023-06-06,21.75 ( 0.46 %),6661,22475300,3374.16,7882,27886100,3538,-5410800
2023-06-05,21.65 ( 0.23 %),7934,32191700,4057.44,14376,49321100,3431,-17129400
2023-06-02,21.6 ( 0.93 %),7944,33979200,4277.34,11728,40357200,3441,-6378000
2023-06-01,21.4 ( 0.94 %),10552,24496100,2321.47,5811,21503100,3700,2993000
2023-05-31,21.2 ( -0.7 %),14006,24720800,1765.01,9287,31306600,3371,-6585800
2023-05-30,21.35 ( -0.47 %),9610,24642900,2564.3,7944,30764400,3873,-6121500
2023-05-29,21.45 ( 1.66 %),7358,21487000,2920.22,6572,22805700,3470,-1318700
2023-05-26,21.1 ( -0.47 %),17679,29848000,1688.33,6430,29245800,4548,602200
2023-05-25,21.2 ( -0.47 %),11735,24106200,2054.21,5807,26104100,4495,-1997900
2023-05-24,21.3 ( -1.84 %),13438,30091900,2239.31,6362,37643900,5917,-7552000
2023-05-23,21.7 ( -0.91 %),11176,25653200,2295.38,6530,29117100,4459,-3463900
2023-05-22,21.9 ( 0.46 %),9042,31101000,3439.62,6858,31158100,4543,-57100
2023-05-19,21.8 ( -0.68 %),8691,20829200,2396.64,5620,26782400,4766,-5953200
2023-05-18,21.95 ( 0.69 %),7557,30518300,4038.41,8372,34562500,4128,-4044200
2023-05-17,21.8 ( -0.91 %),13478,40346200,2993.49,6564,44985100,6853,-4638900
2023-05-16,22 ( -0.45 %),8694,30792000,3541.75,6808,35520400,5217,-4728400
2023-05-15,22.1 ( -1.12 %),8752,33141900,3786.78,9923,41248800,4157,-8106900
2023-05-12,22.35 ( 2.52 %),15111,79105800,5234.98,22517,80298500,3566,-1192700
2023-05-11,21.75 ( 0.23 %),7534,23657800,3140.14,8271,30881200,3734,-7223400
2023-05-10,21.7 ( -0.46 %),6104,17520400,2870.31,7117,26252700,3689,-8732300
2023-05-09,21.8 ( 0.93 %),8997,37049400,4117.97,16841,56029900,3327,-18980500
2023-05-08,21.6 ( 0.7 %),5033,19143800,3803.66,7203,29764000,4132,-10620200
2023-05-05,21.45 ( 0.7 %),6847,22694800,3314.56,6700,25614500,3823,-2919700
2023-05-04,21.3 ( -1.62 %),10861,30921900,2847.06,6199,29827300,4812,1094600
2023-04-28,21.65 ( -0.23 %),0,0,0,0,0,0,0
2023-04-27,21.7 ( -1.36 %),10521,31535000,2997.34,12733,42614100,3347,-11079100
2023-04-26,22 ( 4.27 %),0,0,0,0,0,0,0
2023-04-25,21.05 ( 1.69 %),8149,30457100,3737.53,14001,40972900,2926,-10515800
2023-04-24,20.65 ( -0.24 %),4914,19279900,3923.46,4548,22866100,5028,-3586200
2023-04-21,20.7 ( -0.48 %),4766,17444200,3660.13,4610,22138900,4802,-4694700
2023-04-20,20.8 ( 0 %),3900,14497000,3717.18,4615,14518900,3146,-21900
2023-04-19,20.8 ( -0.95 %),0,0,0,0,0,0,0
2023-04-18,20.95 ( 0.24 %),5784,21079100,3644.38,7307,26086100,3570,-5007000
2023-04-17,20.85 ( 0.72 %),5502,20417200,3710.87,5369,21009400,3913,-592200
2023-04-14,20.65 ( 0.73 %),7328,29890900,4079,6816,25333000,3717,4557900
2023-04-13,20.45 ( -1.68 %),11246,29229800,2599.13,5843,29777500,5096,-547700
2023-04-12,20.75 ( -0.24 %),8418,22625600,2687.76,5339,22689100,4250,-63500
2023-04-11,20.8 ( 0.48 %),9192,31402300,3416.26,6512,26092000,4007,5310300
2023-04-10,20.7 ( -2.36 %),17342,45648500,2632.25,10702,51286000,4792,-5637500
2023-04-07,21.2 ( -1.4 %),6778,31499600,4647.33,9455,41858900,4427,-10359300
2023-04-06,21.5 ( 0 %),10410,48006400,4611.57,16987,55498900,3267,-7492500
2023-04-05,21.5 ( 1.9 %),8730,44811100,5133,11209,43606800,3890,1204300
2023-04-04,21.1 ( 0.48 %),8109,36585000,4511.65,12755,46199600,3622,-9614600
2023-04-03,21 ( 0.96 %),8512,37260000,4377.35,13095,48873300,3732,-11613300
2023-03-31,20.8 ( 0 %),12529,40280300,3214.97,11054,50624900,4580,-10344600
2023-03-30,20.8 ( 0 %),8308,33714800,4058.11,13744,51740000,3765,-18025200
2023-03-29,20.8 ( 0.48 %),6469,33633400,5199.17,13537,45860900,3388,-12227500
2023-03-28,20.7 ( -0.48 %),6604,28228000,4274.38,10724,37758200,3521,-9530200
2023-03-27,20.8 ( 1.96 %),8001,40170800,5020.72,13747,44995000,3273,-4824200
2023-03-24,20.4 ( 0 %),8037,36473500,4538.2,7971,36582100,4589,-108600
2023-03-23,20.4 ( 0.49 %),9528,27882100,2926.33,6078,26129500,4299,1752600
2023-03-22,20.3 ( -0.98 %),8387,26899600,3207.3,7858,33254400,4232,-6354800
2023-03-21,20.45 ( 2.25 %),12314,38430300,3120.86,10438,38055300,3646,375000
2023-03-20,20 ( -1.96 %),18618,41135100,2209.43,7778,42729700,5494,-1594600
2023-03-17,20.4 ( -2.39 %),19456,68888100,3540.71,8741,66148800,7568,2739300
2023-03-16,20.85 ( -2.11 %),20059,51174000,2551.17,7282,57188200,7853,-6014200
2023-03-15,21.3 ( 4.93 %),9905,49862600,5034.08,9068,41094500,4532,8768100
2023-03-14,20.3 ( -3.79 %),22833,53244900,2331.93,7210,56384900,7820,-3140000
2023-03-13,21.1 ( -0.94 %),11306,38233100,3381.66,7138,36602300,5128,1630800
2023-03-10,21.3 ( 0.47 %),11847,42746300,3608.2,9558,44232300,4628,-1486000
2023-03-09,21.2 ( 0 %),8872,39408700,4441.92,13291,47226500,3553,-7817800
2023-03-08,21.2 ( 0.47 %),9539,29554600,3098.29,7703,32428800,4210,-2874200
2023-03-07,21.1 ( 3.43 %),11398,49022100,4300.94,17080,56986900,3336,-7964800
2023-03-06,20.4 ( 0 %),5987,20625900,3445.11,6423,26081900,4061,-5456000
2023-03-03,20.35 ( -1.21 %),7268,24076400,3312.66,8851,34902700,3943,-10826300
2023-03-02,20.6 ( -1.44 %),5849,18440600,3152.78,7358,28480200,3871,-10039600
2023-03-01,20.9 ( 4.5 %),9934,36639600,3688.3,9211,34649600,3762,1990000
2023-02-28,20 ( -0.5 %),10341,30166000,2917.13,6578,30828100,4687,-662100
2023-02-27,20.1 ( -3.37 %),19630,54616700,2782.31,9386,50601000,5391,4015700
2023-02-24,20.8 ( -3.26 %),10740,30217200,2813.52,7059,37433900,5303,-7216700
2023-02-23,21.5 ( 1.42 %),18304,60439600,3301.99,11136,57596900,5172,2842700
2023-02-22,21.2 ( -1.85 %),15131,64485200,4261.79,14649,58250200,3976,6235000
2023-02-21,21.6 ( -1.37 %),11456,34016700,2969.33,16688,51964000,3114,-17947300
2023-02-20,21.9 ( 4.29 %),8988,45408500,5052.13,15129,47289300,3126,-1880800
2023-02-17,21 ( -1.41 %),8943,24257100,2712.41,8816,30440100,3453,-6183000
2023-02-16,21.3 ( 2.4 %),12753,45459100,3564.58,12908,46864600,3631,-1405500
2023-02-15,20.8 ( 0.97 %),9421,35659700,3785.13,11748,44687900,3804,-9028200
2023-02-14,20.6 ( 1.98 %),11273,35680600,3165.14,11047,35381700,3203,298900
2023-02-13,20.2 ( -1.46 %),14923,38315200,2567.53,7507,34019300,4532,4295900
2023-02-10,20.5 ( -0.49 %),9570,32621400,3408.71,7792,34593200,4440,-1971800
2023-02-09,20.6 ( -1.44 %),9788,29217400,2985.02,8293,39192300,4726,-9974900
2023-02-08,20.85 ( 5.3 %),13897,60632400,4362.98,13225,47830700,3617,12801700
2023-02-07,19.75 ( -6.84 %),30527,71573300,2344.59,9729,77450100,7961,-5876800
2023-02-06,21.15 ( 0.24 %),15040,44582400,2964.26,6352,36261900,5709,8320500
2023-02-03,21.1 ( -0.94 %),14904,37109500,2489.9,6525,39583600,6066,-2474100
2023-02-02,21.3 ( 0.95 %),12911,49567400,3839.16,10795,49462300,4582,105100
2023-02-01,21.1 ( -4.52 %),19949,73760700,3697.46,15283,87367400,5717,-13606700
2023-01-31,22.1 ( 1.38 %),11132,45362200,4074.94,12029,52996100,4406,-7633900
2023-01-30,21.75 ( 1.16 %),13905,61493900,4422.43,13609,70808200,5203,-9314300
2023-01-27,21.5 ( 1.42 %),14588,45092300,3091.05,7958,40870900,5136,4221400
2023-01-19,21.15 ( -2.53 %),20854,69815300,3347.81,9362,76608900,8183,-6793600
2023-01-18,21.7 ( 0 %),9913,43662800,4404.6,12933,48146900,3723,-4484100
2023-01-17,21.65 ( 6.65 %),10278,87300700,8493.94,18469,56044100,3034,31256600
2023-01-16,20.25 ( 1.25 %),7918,49388900,6237.55,11868,38189400,3218,11199500
2023-01-13,19.95 ( -0.75 %),7472,33648500,4503.28,10512,40700100,3872,-7051600
2023-01-12,20.05 ( -0.74 %),10214,36219800,3546.09,9340,43851900,4695,-7632100
2023-01-11,20.2 ( 2.02 %),8638,45203200,5233.06,15989,58124500,3635,-12921300
2023-01-10,19.8 ( 1.02 %),10585,45944000,4340.48,14104,71472600,5068,-25528600
2023-01-09,19.6 ( 1.03 %),5529,27042900,4891.1,12954,47452600,3663,-20409700
2023-01-06,19.4 ( -2.02 %),8861,31091900,3508.85,14007,50185800,3583,-19093900
2023-01-05,19.8 ( 2.06 %),6534,35699900,5463.71,14857,45295300,3049,-9595400
2023-01-04,19.4 ( 0.52 %),7010,34923500,4981.95,13765,43482800,3159,-8559300
2023-01-03,19.25 ( 6.94 %),8385,48696800,5807.61,12451,48300200,3879,396600
2022-12-30,18 ( 0 %),7248,26806200,3698.43,7516,32708200,4352,-5902000
2022-12-29,18 ( -1.1 %),6485,31682700,4885.54,9839,36430700,3703,-4748000
2022-12-28,18.2 ( -0.55 %),9530,28371500,2977.07,9798,33329500,3402,-4958000
2022-12-27,18.25 ( 6.73 %),13883,50814600,3660.2,10783,35539900,3296,15274700
2022-12-26,17.1 ( -7.07 %),18676,41625000,2228.8,8626,53784300,6235,-12159300
2022-12-23,18.35 ( -2.91 %),19993,48482100,2424.95,8780,51617400,5879,-3135300
2022-12-22,18.9 ( 0 %),10880,34969600,3214.12,11821,40785400,3450,-5815800
2022-12-21,18.9 ( -0.53 %),17249,50683100,2938.32,13381,51340100,3837,-657000
2022-12-20,19 ( -5 %),27233,73104900,2684.42,15921,85485900,5369,-12381000
2022-12-19,20 ( -1.96 %),19829,72405800,3651.51,22818,89080000,3904,-16674200
2022-12-16,20.4 ( 5.15 %),22827,95329500,4176.17,27910,101157700,3624,-5828200
2022-12-15,19.35 ( 0.78 %),9619,35468600,3687.35,15152,50471400,3331,-15002800
2022-12-14,19.2 ( 1.05 %),12301,54934100,4465.82,16136,70063600,4342,-15129500
2022-12-13,19 ( 2.15 %),12776,39449900,3087.81,9389,39160700,4171,289200
2022-12-12,18.6 ( -3.12 %),16466,57843600,3512.91,14263,65516800,4593,-7673200
2022-12-09,19.2 ( 1.59 %),12617,57134500,4528.37,14384,59925600,4166,-2791100
2022-12-08,18.9 ( 3.28 %),10674,50954900,4773.74,14838,62789300,4232,-11834400
2022-12-07,18.25 ( -1.88 %),18002,73694200,4093.67,17255,63304400,3669,10389800
2022-12-06,18.6 ( -7 %),25744,83695500,3251.07,21278,115617600,5434,-31922100
2022-12-05,20 ( 2.56 %),15912,72182400,4536.35,19634,79579600,4053,-7397200
2022-12-02,19.45 ( 6.87 %),17944,82610200,4603.78,20256,65626300,3240,16983900
2022-12-01,18.2 ( -1.09 %),26224,100609700,3836.55,28113,109214300,3885,-8604600
2022-11-30,18.4 ( 5.75 %),15509,90753500,5851.67,22272,94285100,4233,-3531600
2022-11-29,17.4 ( 6.1 %),19476,103622300,5320.51,23826,95856800,4023,7765500
2022-11-28,16.35 ( 6.86 %),17952,98246300,5472.72,19361,78458600,4052,19787700
2022-11-25,15.3 ( 6.25 %),9979,45944600,4604.13,12513,44171600,3530,1773000
2022-11-24,14.35 ( 3.99 %),17891,71249200,3982.4,9507,50207400,5281,21041800
2022-11-23,13.8 ( -6.76 %),14907,45329400,3040.81,8092,53694000,6635,-8364600
2022-11-22,14.8 ( -1.33 %),22519,71608600,3179.92,12233,68572700,5606,3035900
2022-11-21,14.95 ( -0.99 %),18711,65490400,3500.1,8928,55559200,6223,9931200
2022-11-18,15.1 ( 5.59 %),28820,163104000,5659.4,27580,142345200,5161,20758800
2022-11-17,14.25 ( 6.34 %),12400,96618500,7791.81,5985,24696000,4126,71922500
2022-11-16,13.35 ( 6.8 %),16474,93516200,5676.59,10149,44122200,4347,49394000
2022-11-15,12.5 ( 2.46 %),14008,74098400,5289.72,14123,59718200,4228,14380200
2022-11-14,12.2 ( -0.81 %),14716,93712800,6368.09,9143,77111800,8434,16601000
2022-11-11,12.3 ( 1.65 %),15366,107680500,7007.71,14405,82576800,5733,25103700
2022-11-10,12.1 ( -6.92 %),21277,92637500,4353.88,10520,113961000,10833,-21323500
2022-11-09,13 ( -1.52 %),14568,54712400,3755.66,7775,49599600,6379,5112800
2022-11-08,13.15 ( -4.01 %),21772,83246600,3823.56,10570,64772400,6128,18474200
2022-11-07,13.7 ( -6.8 %),18003,59192600,3287.93,10155,56227400,5537,2965200
2022-11-04,14.65 ( -3.62 %),21878,82422800,3767.38,11929,66879900,5606,15542900
2022-11-03,15.2 ( -1.3 %),14110,50657700,3590.2,8005,38996900,4872,11660800
2022-11-02,15.35 ( 2.33 %),22379,83281200,3721.4,11337,57877600,5105,25403600
2022-11-01,15 ( -4.46 %),43817,158751700,3623.06,12615,121570900,9637,37180800
2022-10-31,15.65 ( -6.85 %),27076,76445000,2823.35,9502,106923000,11253,-30478000
2022-10-28,16.8 ( -3.45 %),17426,44628600,2561.04,7059,54845800,7770,-10217200
2022-10-27,17.4 ( 2.96 %),8907,35772700,4016.25,7566,34905500,4613,867200
2022-10-26,16.9 ( -1.17 %),8782,20928800,2383.15,5730,26384300,4605,-5455500
2022-10-25,17.1 ( 4.27 %),13627,58210800,4271.73,11371,48546800,4269,9664000
2022-10-24,16.4 ( -2.96 %),14620,47997200,3282.98,7853,40888300,5207,7108900
2022-10-21,16.9 ( -6.63 %),27857,66449300,2385.37,8339,64231600,7703,2217700
2022-10-20,18.1 ( -1.63 %),14471,51629900,3567.82,3921,44835000,11435,6794900
2022-10-19,18.4 ( -2.65 %),11804,40981300,3471.81,5875,31063900,5287,9917400
2022-10-18,18.85 ( -2.33 %),10685,42937300,4018.47,6885,43877600,6373,-940300
2022-10-17,19.25 ( -1.28 %),8046,31843700,3957.71,5433,27163000,5000,4680700
2022-10-14,19.45 ( -0.26 %),10809,38366800,3549.52,10313,42149100,4087,-3782300
2022-10-13,19.5 ( 4.28 %),10232,52343800,5115.7,11515,39111400,3397,13232400
2022-10-12,18.7 ( 6.86 %),8843,67593000,7643.67,9312,35214100,3782,32378900
2022-10-11,17.5 ( -4.89 %),13106,42936600,3276.1,5810,40444700,6961,2491900
2022-10-10,18.35 ( 4.26 %),14497,48061700,3315.29,9112,33496900,3676,14564800
2022-10-07,17.6 ( -2.22 %),19117,65706600,3437.08,7858,49433500,6291,16273100
2022-10-06,18 ( -6.25 %),18379,52463000,2854.51,7239,57902800,7999,-5439800
2022-10-05,19.2 ( 1.59 %),12909,37477400,2903.2,6150,35547300,5780,1930100
2022-10-04,18.85 ( -4.8 %),15113,45294500,2997.06,7510,48029000,6395,-2734500
2022-10-03,19.75 ( -6.84 %),17251,41534100,2407.63,8049,49132300,6104,-7598200
2022-09-30,21.2 ( -2.3 %),12046,35983300,2987.16,6136,34796700,5671,1186600
2022-09-29,21.65 ( -0.69 %),5455,15834300,2902.71,4837,20817500,4304,-4983200
2022-09-28,21.8 ( -2.68 %),8746,23004000,2630.23,3821,23657800,6192,-653800
2022-09-27,22.4 ( 0 %),5541,16373100,2954.9,4339,16218400,3738,154700
2022-09-26,22.4 ( -1.32 %),12398,37959800,3061.77,6778,38396200,5665,-436400
2022-09-23,22.7 ( -1.3 %),5729,23174100,4045.05,5675,27335300,4817,-4161200
2022-09-22,23 ( 0.44 %),6490,23551000,3628.81,5047,19268400,3818,4282600
2022-09-21,22.9 ( -0.43 %),5828,20784900,3566.39,3603,16541400,4591,4243500
2022-09-20,23 ( 1.32 %),6514,23508100,3608.86,5400,20938500,3878,2569600
2022-09-19,22.65 ( -1.52 %),11883,36174700,3044.24,8081,46054400,5699,-9879700
2022-09-16,23 ( -2.54 %),9325,39596700,4246.29,5703,43239700,7582,-3643000
2022-09-15,23.6 ( -0.42 %),6557,23674800,3610.61,7341,31849800,4339,-8175000
2022-09-14,23.7 ( 0 %),10740,51378900,4783.88,7691,42779500,5562,8599400
2022-09-13,23.7 ( -0.42 %),7072,26549600,3754.19,8397,35466800,4224,-8917200
2022-09-12,23.8 ( 0 %),8624,41030400,4757.7,17554,61512800,3504,-20482400
2022-09-09,23.8 ( 3.03 %),6873,52529700,7642.91,12171,48438200,3980,4091500
2022-09-08,23.1 ( 0.43 %),9839,37862800,3848.24,9021,41552100,4606,-3689300
2022-09-07,23 ( -2.54 %),9251,36612100,3957.64,10287,46856700,4555,-10244600
2022-09-06,23.55 ( -1.46 %),9492,24367800,2567.19,12613,44020400,3490,-19652600
2022-09-05,23.9 ( 3.91 %),11755,45664400,3884.68,15133,49106100,3245,-3441700
2022-08-31,23 ( -0.43 %),11551,29265900,2533.62,4923,25346200,5149,3919700
2022-08-30,23.05 ( 0.22 %),7922,24520600,3095.25,6974,28728700,4119,-4208100
2022-08-29,23 ( -2.13 %),18717,51646400,2759.33,9041,55864300,6179,-4217900
2022-08-26,23.5 ( -1.67 %),8167,24806500,3037.41,9054,42226800,4664,-17420300
2022-08-25,23.85 ( 1.49 %),8677,35272000,4065,12839,38147900,2971,-2875900
2022-08-24,23.5 ( -0.84 %),8885,24057500,2707.65,7669,24600300,3208,-542800
2022-08-23,23.65 ( 1.07 %),10638,41658400,3916,7190,32783500,4560,8874900
2022-08-22,23.35 ( -1.89 %),13167,38861700,2951.45,7776,43934800,5650,-5073100
2022-08-19,23.75 ( -1.86 %),14229,45554800,3201.55,8567,58152400,6788,-12597600
2022-08-18,24.15 ( -0.62 %),13155,50433800,3833.81,8764,44494700,5077,5939100
2022-08-17,24.3 ( -1.22 %),16474,49727500,3018.54,11630,56433400,4852,-6705900
2022-08-16,24.55 ( 2.29 %),17098,112112000,6557.02,25289,112204400,4437,-92400
2022-08-15,24 ( 0 %),12696,55640700,4382.54,14136,65831500,4657,-10190800
2022-08-12,23.95 ( 2.35 %),15463,74163200,4796.17,13520,63063900,4664,11099300
2022-08-11,23.4 ( -1.68 %),17069,52257700,3061.56,14320,69274000,4838,-17016300
2022-08-10,23.8 ( -1.24 %),18399,55253100,3003.05,12730,57748100,4536,-2495000
2022-08-09,24.1 ( 2.12 %),17767,83761200,4714.43,19364,86037900,4443,-2276700
2022-08-08,23.6 ( 1.29 %),13898,54386100,3913.23,13280,57563700,4335,-3177600
2022-08-05,23.3 ( -1.69 %),22881,70735100,3091.43,9484,65076000,6862,5659100
2022-08-04,23.65 ( -0.63 %),16257,52660500,3239.25,14210,53206700,3744,-546200
2022-08-03,23.75 ( 3.71 %),21951,100838500,4593.8,23365,88812600,3801,12025900
2022-08-02,22.9 ( 0.44 %),11322,43919300,3879.11,18652,54968600,2947,-11049300
2022-08-01,22.8 ( 6.05 %),11271,77540200,6879.62,22623,58523600,2587,19016600
2022-07-29,21.5 ( 0.47 %),10131,33213900,3278.44,10101,38041000,3766,-4827100
2022-07-28,21.4 ( 0.47 %),11877,35515000,2990.23,8893,41120300,4624,-5605300
2022-07-27,21.25 ( -2.07 %),17052,42563000,2496.07,8887,45817900,5156,-3254900
2022-07-26,21.65 ( -1.14 %),15143,40672700,2685.91,9280,43381000,4675,-2708300
2022-07-25,21.9 ( -1.35 %),11431,30916000,2704.58,6403,32062600,5007,-1146600
2022-07-22,22.2 ( -2.2 %),12927,27254600,2108.35,7138,33185800,4649,-5931200
2022-07-21,22.7 ( 1.34 %),10829,48570700,4485.24,13543,49550700,3659,-980000
2022-07-20,22.35 ( 0.68 %),9573,33343600,3483.09,9166,32539500,3550,804100
2022-07-19,22.15 ( -1.99 %),12954,27915800,2154.99,6268,27577000,4400,338800
2022-07-18,22.6 ( -2.59 %),12374,30653500,2477.25,9102,36693600,4031,-6040100
2022-07-15,23.2 ( 4.5 %),20445,82780400,4048.93,18194,69551500,3823,13228900
2022-07-14,22.2 ( -0.45 %),8843,22701100,2567.13,5223,24100400,4614,-1399300
2022-07-13,22.3 ( 0 %),8873,30408900,3427.13,9626,32283700,3354,-1874800
2022-07-12,22.3 ( 0.9 %),7581,19988400,2636.64,6102,21771600,3568,-1783200
2022-07-11,22.05 ( -2 %),9026,20923700,2318.16,6623,23081300,3485,-2157600
2022-07-08,22.45 ( 2.98 %),7320,32581300,4451,12040,32507300,2700,74000
2022-07-07,21.75 ( 1.16 %),7273,19903300,2736.6,5412,17941200,3315,1962100
2022-07-06,21.45 ( -2.05 %),10210,27430900,2686.67,9107,31293200,3436,-3862300
2022-07-05,21.9 ( -0.45 %),10424,29030900,2785.01,8791,28429600,3234,601300
2022-07-04,22 ( -1.79 %),9370,18682300,1993.84,6393,23935000,3744,-5252700
2022-07-01,22.4 ( 0.45 %),11795,24915100,2112.34,6951,26149400,3762,-1234300
2022-06-30,22.3 ( -2.19 %),12777,32730700,2561.69,11173,36759300,3290,-4028600
2022-06-29,22.75 ( 1.11 %),13588,36184600,2662.98,9810,33161400,3380,3023200
2022-06-28,22.5 ( -1.75 %),14691,31502200,2144.32,7799,31504900,4040,-2700
2022-06-27,22.9 ( 5.05 %),12614,34858700,2763.49,9942,29364200,2954,5494500
2022-06-24,21.8 ( 0 %),8338,20012000,2400.1,7792,25029200,3212,-5017200
2022-06-23,21.8 ( 1.4 %),6643,12486600,1879.66,5794,13448000,2321,-961400
2022-06-22,21.5 ( 3.37 %),10781,35723300,3313.54,9347,31880500,3411,3842800
2022-06-21,20.8 ( -3.7 %),13203,53497200,4051.9,8905,57514800,6459,-4017600
2022-06-20,21.6 ( -6.9 %),17662,44429300,2515.53,8085,53572300,6626,-9143000
2022-06-17,23.2 ( -1.28 %),21509,45642700,2122.03,7411,52300000,7057,-6657300
2022-06-16,31 ( 5.44 %),14957,52828100,3532,13859,48078800,3469,4749300
2022-06-15,29.4 ( -2.97 %),19238,45147200,2346.77,12486,48968200,3922,-3821000
2022-06-14,30.3 ( -4.72 %),22233,42447500,1909.21,10469,47094300,4498,-4646800
2022-06-13,31.8 ( -5.36 %),17815,30956800,1737.68,10375,36216300,3491,-5259500
2022-06-10,33.6 ( -0.59 %),10833,23599300,2178.46,11415,32590000,2855,-8990700
2022-06-09,33.8 ( 2.74 %),17535,49221800,2807.06,15943,46453200,2914,2768600
2022-06-08,32.9 ( -0.9 %),20688,37993000,1836.48,11342,40057300,3532,-2064300
2022-06-07,33.2 ( -0.3 %),16072,29755000,1851.36,9228,32823600,3557,-3068600
2022-06-06,33.3 ( -0.3 %),12881,26730500,2075.19,9798,31808000,3246,-5077500
2022-06-03,33.4 ( 0.6 %),13366,28778800,2153.13,9851,25054900,2543,3723900
2022-06-02,33.15 ( -3.63 %),26824,40105900,1495.15,9474,44041900,4649,-3936000
2022-06-01,34.35 ( -1.01 %),22688,37352600,1646.36,9156,37034500,4045,318100
2022-05-31,34.7 ( -2.25 %),21870,31124700,1423.17,8356,33720200,4035,-2595500
2022-05-30,35.45 ( -0.14 %),15430,26005400,1685.38,10223,29691700,2904,-3686300
2022-05-27,35.45 ( 1.29 %),16113,29472600,1829.12,10571,30010200,2839,-537600
2022-05-26,35 ( 1.45 %),13669,29532500,2160.55,9932,28367300,2856,1165200
2022-05-25,34.45 ( -1.29 %),38464,72522000,1885.45,18268,60893700,3333,11628300
2022-05-24,34.9 ( -5.16 %),30374,60534600,1992.97,11758,64327200,5471,-3792600
2022-05-23,36.75 ( -2.52 %),8063,14463800,1793.85,5288,18594500,3516,-4130700
2022-05-20,37.65 ( -0.66 %),9553,22716300,2377.92,6119,20927900,3420,1788400
2022-05-19,37.9 ( -0.79 %),11984,27767200,2317.02,5731,25334000,4421,2433200
2022-05-18,38.2 ( 0 %),11496,24327100,2116.14,6289,26982700,4290,-2655600
2022-05-17,38.2 ( 5.23 %),11363,36205700,3186.28,7247,30688000,4235,5517700
2022-05-16,36.3 ( 1.11 %),0,0,0,0,0,0,0
2022-05-13,35.9 ( -6.14 %),15014,58531900,3898.49,13353,61000100,4568,-2468200
2022-05-12,38.25 ( -5.9 %),14021,34222500,2440.8,7214,35296700,4893,-1074200
2022-05-11,40.65 ( -1.09 %),10774,15613600,1449.19,5307,15602800,2940,10800
2022-05-10,41.1 ( 2.75 %),11908,37491000,3148.39,7715,27241900,3531,10249100
2022-05-09,39.95 ( -4.43 %),13327,36534000,2741.35,8984,39592200,4407,-3058200
2022-05-06,41.8 ( -0.71 %),9469,26795200,2829.78,7612,25957800,3410,837400
2022-05-05,42.05 ( 0.12 %),9319,20978500,2251.15,5651,22315600,3949,-1337100
2022-05-04,42 ( -3 %),14148,21098000,1491.24,5883,25127600,4271,-4029600
2022-04-29,43.3 ( 0.46 %),9119,22924400,2513.92,7202,22163200,3077,761200
2022-04-28,43.1 ( 1.41 %),9235,30582000,3311.53,8511,24913000,2927,5669000
2022-04-27,42.5 ( 3.16 %),11980,35395500,2954.55,6863,27407400,3994,7988100
2022-04-26,41.2 ( 0.98 %),0,0,0,0,0,0,0
2022-04-25,40.75 ( -6.96 %),17673,37853300,2141.87,7966,44478700,5584,-6625400
2022-04-22,43.8 ( 1.04 %),9571,18726100,1956.55,7254,22904600,3158,-4178500
2022-04-21,43.35 ( 0.35 %),11625,32512200,2796.75,9176,27381400,2984,5130800
2022-04-20,43.2 ( -0.23 %),8104,22023900,2717.66,7470,23050100,3086,-1026200
2022-04-18,42.65 ( -3.51 %),15187,29920800,1970.16,9401,35241700,3749,-5320900
2022-04-15,44.2 ( -1.56 %),13961,25514800,1827.58,6937,27950700,4029,-2435900
2022-04-14,44.9 ( -0.66 %),12238,20901500,1707.92,5852,19966000,3412,935500
2022-04-13,45.2 ( 0.22 %),12842,21319700,1660.15,5652,21007300,3717,312400
2022-04-12,0 ( 0 %),15132,27135600,1793.26,6770,31366100,4633,-4230500
2022-04-08,46.4 ( -0.43 %),6921,20740900,2996.81,9732,26994600,2774,-6253700
2022-04-07,46.55 ( -1.59 %),8342,22507500,2698.09,12264,31300300,2552,-8792800
2022-04-06,47.25 ( 2.49 %),12017,46733400,3888.94,24792,52747900,2128,-6014500
2022-04-05,46.1 ( 0.44 %),8499,20624500,2426.7,9709,23802300,2452,-3177800
2022-04-04,45.85 ( 0.33 %),9350,18921000,2023.64,9066,23689900,2613,-4768900
2022-04-01,45.7 ( 1.33 %),20436,37659700,1842.81,12865,32647100,2538,5012600
2022-03-31,45.1 ( -0.88 %),18256,30105000,1649.05,8346,32001700,3834,-1896700
2022-03-30,45.5 ( -0.87 %),18341,27756600,1513.36,8784,27707900,3154,48700
2022-03-29,45.85 ( -0.11 %),12868,20064600,1559.26,7890,24153800,3061,-4089200
2022-03-28,45.9 ( -1.08 %),18909,30734500,1625.39,9415,33301200,3537,-2566700
2022-03-25,46.4 ( 0 %),12336,26096100,2115.44,8649,27856300,3221,-1760200
2022-03-24,46.4 ( -0.85 %),13483,24625900,1826.44,8011,29708500,3708,-5082600
2022-03-23,46.8 ( -0.21 %),11407,27454600,2406.82,11748,37183100,3165,-9728500
2022-03-22,46.9 ( 0 %),20365,37684200,1850.44,9551,37599900,3937,84300
2022-03-21,46.85 ( 0.75 %),11545,30484700,2640.51,9126,33806300,3704,-3321600
2022-03-18,46.5 ( 1.09 %),11394,30265800,2656.29,9205,32242100,3503,-1976300
2022-03-17,45.95 ( -0.54 %),15080,24570800,1629.36,7108,25563700,3596,-992900
2022-03-16,46.2 ( 0 %),10025,20206600,2015.62,7762,22373600,2882,-2167000
2022-03-15,46.15 ( 0.76 %),22510,37173100,1651.4,10221,34443200,3370,2729900
2022-03-14,45.8 ( -3.78 %),0,0,0,0,0,0,0
2022-03-11,47.6 ( -3.25 %),36188,62066400,1715.11,14919,70301900,4712,-8235500
2022-03-10,49.15 ( -1.5 %),20923,45135500,2157.22,12397,47122900,3801,-1987400
2022-03-09,49.85 ( 0.71 %),20925,56878000,2718.18,17176,56032200,3262,845800
2022-03-08,49.45 ( -3.23 %),25555,64208200,2512.55,18813,70816800,3764,-6608600
2022-03-07,51.1 ( 2.61 %),19061,62900800,3299.97,31578,74056100,2345,-11155300
2022-03-04,49.8 ( -0.6 %),19495,53797700,2759.56,32067,73965700,2307,-20168000
2022-03-03,50.1 ( 6.82 %),37184,125709800,3380.75,51925,109587900,2111,16121900
2022-03-02,46.9 ( 0 %),12386,32493700,2623.42,14505,41909400,2889,-9415700
2022-03-01,46.9 ( -0.64 %),14662,33512200,2285.65,21455,54379600,2535,-20867400
2022-02-28,47.2 ( 2.83 %),18362,52642100,2866.9,23818,63115500,2650,-10473400
2022-02-25,45.9 ( -0.22 %),11131,21388900,1921.56,9052,23806900,2630,-2418000
2022-02-24,46 ( -1.5 %),20793,36848300,1772.15,10813,39017300,3608,-2169000
2022-02-23,46.7 ( 0.65 %),11556,22203000,1921.34,10366,26362600,2543,-4159600
2022-02-22,46.4 ( -0.64 %),18682,29518500,1580.05,7218,28790100,3989,728400
2022-02-21,46.65 ( -0.96 %),11775,20414000,1733.67,10676,30019200,2812,-9605200
2022-02-18,47.05 ( 1.18 %),14499,36380000,2509.14,18226,45320700,2487,-8940700
2022-02-17,46.5 ( 1.09 %),8484,19937700,2350.04,9943,27308800,2747,-7371100
2022-02-16,46 ( 0 %),9035,16814400,1861.03,7447,22018600,2957,-5204200
2022-02-15,46 ( -0.43 %),15014,24600100,1638.48,8914,28048600,3147,-3448500
2022-02-14,46.2 ( -2.12 %),14123,30219400,2139.73,11232,35064000,3122,-4844600
2022-02-11,47.15 ( 0.32 %),13776,34970300,2538.49,14077,33367300,2370,1603000
2022-02-10,47 ( -0.63 %),13756,36040500,2619.98,20170,48130600,2386,-12090100
2022-02-09,47.3 ( 3.73 %),25556,61936100,2423.54,26641,69610400,2613,-7674300
2022-02-08,45.55 ( 5.68 %),18339,44110600,2405.29,17393,36704400,2110,7406200
2022-02-07,43.05 ( 2.01 %),13877,30054700,2165.79,9748,23644500,2426,6410200
2022-01-28,42.2 ( 0 %),14493,32243800,2224.78,6743,22943900,3403,9299900
2022-01-27,42.15 ( -3.1 %),12396,23786000,1918.84,6171,23067400,3738,718600
2022-01-26,43.45 ( 0.35 %),8824,24198500,2742.35,10458,26952100,2577,-2753600
2022-01-25,43.25 ( 6.27 %),0,0,0,0,0,0,0
2022-01-24,40.7 ( -6 %),23503,40114900,1706.8,13585,44387500,3267,-4272600
2022-01-21,43.3 ( -1.59 %),15646,24586000,1571.39,6800,27370000,4025,-2784000
2022-01-20,44 ( 1.15 %),11634,26341200,2264.16,7419,23025800,3104,3315400
2022-01-19,43.55 ( -1.02 %),14417,27256600,1890.59,9045,26376300,2916,880300
2022-01-18,44 ( -1.57 %),19449,35157400,1807.67,8424,34538600,4100,618800
2022-01-17,44.7 ( -3.35 %),16217,28960500,1785.81,8046,35153500,4369,-6193000
2022-01-14,46.25 ( -0.96 %),6683,12699400,1900.25,7544,17592400,2332,-4893000
2022-01-13,46.7 ( 1.08 %),12255,35679300,2911.41,18503,41355000,2235,-5675700
2022-01-12,46.2 ( 2.44 %),10106,24862400,2460.16,11668,24303400,2083,559000
2022-01-11,45.1 ( -1.31 %),10620,19757800,1860.43,7698,23365300,3035,-3607500
2022-01-10,45.65 ( -0.33 %),12956,26903700,2076.54,14153,31044900,2194,-4141200
2022-01-07,45.8 ( -0.65 %),18167,26786100,1474.44,12144,24953900,2055,1832200
2022-01-06,46.1 ( -1.5 %),15104,25065900,1659.55,8706,26909000,3091,-1843100
2022-01-05,46.8 ( 0 %),9611,28148600,2928.79,14791,31970000,2161,-3821400
2022-01-04,46.75 ( 0.75 %),11069,27804300,2511.91,13555,34605900,2553,-6801600
2021-12-31,46.4 ( 1.53 %),9300,26212100,2818.51,12515,26604800,2126,-392700
2021-12-30,45.7 ( -0.22 %),9668,17762900,1837.29,8400,20200900,2405,-2438000
2021-12-29,45.8 ( 0 %),11679,24053200,2059.53,8987,26003700,2893,-1950500
2021-12-28,45.8 ( -0.22 %),12103,21154800,1747.9,11936,24926000,2088,-3771200
2021-12-27,45.9 ( -0.43 %),10076,16215900,1609.36,8049,20225400,2513,-4009500
2021-12-24,46.05 ( 2.33 %),12523,32934000,2629.88,15196,30205400,1988,2728600
2021-12-23,44.95 ( -0.33 %),27556,39008000,1415.59,14908,43068100,2889,-4060100
2021-12-22,45.1 ( -2.17 %),31156,38419300,1233.13,13883,39747700,2863,-1328400
2021-12-21,46.1 ( -1.71 %),22550,28706900,1273.03,9145,27855900,3046,851000
2021-12-20,46.9 ( 0.43 %),12017,20803700,1731.19,9034,21118700,2338,-315000
2021-12-17,46.7 ( -1.68 %),23390,38770500,1657.57,10875,37132400,3414,1638100
2021-12-16,47.5 ( -0.63 %),10523,18506300,1758.65,8416,24036400,2856,-5530100
2021-12-15,47.8 ( 0.21 %),9845,17493100,1776.85,11279,26443500,2344,-8950400
2021-12-14,47.7 ( 2.47 %),24579,61066400,2484.49,24569,60475900,2461,590500
2021-12-13,46.55 ( 0.11 %),13964,24150000,1729.45,11515,23359400,2029,790600
2021-12-10,46.5 ( -1.27 %),22573,33677100,1491.92,9799,30312900,3093,3364200
2021-12-09,47.1 ( -0.21 %),14746,21926000,1486.91,7214,17200500,2384,4725500
2021-12-08,47.2 ( -0.84 %),14872,21239500,1428.15,7931,22053100,2781,-813600
2021-12-07,47.6 ( 4.04 %),20267,41961000,2070.41,13146,29645300,2255,12315700
2021-12-06,45.75 ( -4.09 %),34949,52824800,1511.48,14172,54431500,3841,-1606700
2021-12-03,47.7 ( -1.85 %),22115,31097800,1406.19,10665,35185700,3299,-4087900
2021-12-02,48.6 ( -0.82 %),17424,23460300,1346.44,9013,26151500,2902,-2691200
2021-12-01,49 ( 0.1 %),13322,24031000,1803.86,10096,27203600,2694,-3172600
2021-11-30,48.95 ( 1.14 %),20805,40479300,1945.65,16957,38272900,2257,2206400
2021-11-29,48.4 ( -1.33 %),29760,40904000,1374.46,9172,38872400,4238,2031600
2021-11-26,49.05 ( -0.41 %),24645,43990400,1784.96,14101,43116300,3058,874100
2021-11-25,49.25 ( 1.23 %),22231,41257600,1855.86,14974,35029400,2339,6228200
2021-11-24,48.65 ( -1.82 %),30606,45478900,1485.95,14075,42349500,3009,3129400
2021-11-23,49.55 ( 1.85 %),16011,30803800,1923.91,11679,27354600,2342,3449200
2021-11-22,48.65 ( 1.35 %),26747,47405700,1772.37,15916,39639300,2491,7766400
2021-11-19,48 ( -3.9 %),50447,76436400,1515.18,23987,75307500,3140,1128900
2021-11-18,49.95 ( -2.82 %),67193,104081600,1548.99,32969,94035300,2852,10046300
2021-11-17,51.4 ( -1.15 %),33965,49800700,1466.24,17011,49236100,2894,564600
2021-11-16,52 ( -2.99 %),42802,58529000,1367.44,18002,64499900,3583,-5970900
2021-11-15,53.6 ( -1.83 %),29392,43704300,1486.95,15298,56859900,3717,-13155600
2021-11-12,54.6 ( 1.11 %),23007,40371200,1754.74,14141,33456400,2366,6914800
2021-11-11,54 ( -2.35 %),52524,83071700,1581.6,22132,92649800,4186,-9578100
2021-11-10,55.3 ( -2.12 %),0,0,0,0,0,0,0
2021-11-09,56.5 ( -0.53 %),16202,44091300,2721.35,16861,45061000,2672,-969700
2021-11-08,56.8 ( 0.35 %),11959,32599700,2725.96,14335,43807300,3056,-11207600
2021-11-05,56.6 ( 0.53 %),16629,35658500,2144.36,13011,46345200,3562,-10686700
2021-11-04,56.3 ( 1.26 %),14396,31331400,2176.4,10767,31484400,2924,-153000
2021-11-03,55.6 ( 0.18 %),18629,49638900,2664.6,15011,44044500,2934,5594400
2021-11-02,55.5 ( -0.36 %),29292,46762900,1596.44,11978,43712000,3649,3050900
2021-11-01,55.7 ( -2.45 %),37561,66122200,1760.4,15035,63979800,4255,2142400
2021-10-29,57.1 ( -1.55 %),17262,37484900,2171.53,14491,42591200,2939,-5106300
2021-10-28,58 ( 0.17 %),12281,37161900,3025.97,16291,40506700,2486,-3344800
2021-10-27,57.9 ( 2.84 %),12568,42949400,3417.36,18106,44911000,2480,-1961600
2021-10-26,56.3 ( 2.18 %),30184,60044000,1989.27,13687,43442200,3174,16601800
2021-10-25,55.1 ( -2.82 %),34891,57284600,1641.82,15595,63166800,4050,-5882200
2021-10-22,56.7 ( -0.87 %),20446,33817800,1654.01,8972,37875300,4222,-4057500
2021-10-21,57.2 ( 0.53 %),24970,70828200,2836.53,18285,68445500,3743,2382700
2021-10-20,56.9 ( -0.52 %),29487,56975700,1932.23,14360,54459900,3792,2515800
2021-10-19,57.2 ( -1.21 %),19792,41388600,2091.18,11284,38478500,3410,2910100
2021-10-18,57.9 ( 1.05 %),11358,35729000,3145.71,15718,38099800,2424,-2370800
2021-10-15,57.3 ( 0.88 %),11368,34734200,3055.44,14511,34948100,2408,-213900
2021-10-14,56.8 ( 0 %),16016,35977200,2246.33,11458,34270500,2991,1706700
2021-10-13,56.8 ( -0.35 %),12461,26431700,2121.15,13476,30334200,2251,-3902500
2021-10-12,57 ( -0.35 %),16116,31930200,1981.27,15596,35559600,2280,-3629400
2021-10-11,57.2 ( 2.69 %),16966,48718900,2871.56,22063,42362900,1920,6356000
2021-10-08,55.7 ( 0.18 %),18687,43658800,2336.32,17772,42381400,2385,1277400
2021-10-07,55.6 ( -0.89 %),20973,47178200,2249.47,18186,49861300,2742,-2683100
2021-10-06,56.1 ( 1.45 %),14687,43928100,2990.95,21510,45282400,2105,-1354300
2021-10-05,55.3 ( -0.36 %),18615,46766600,2512.31,21400,49566400,2316,-2799800
2021-10-04,55.5 ( 3.93 %),21193,78292600,3694.27,32656,73934200,2264,4358400
2021-10-01,53.4 ( 0.95 %),14897,62648300,4205.43,21859,54489600,2493,8158700
2021-09-30,52.9 ( -0.75 %),14949,39186100,2621.32,19722,49953600,2533,-10767500
2021-09-29,53.3 ( 1.33 %),20374,63383600,3111,33377,70435000,2110,-7051400
2021-09-28,52.6 ( 3.54 %),15058,60895600,4044.07,24563,54733100,2228,6162500
2021-09-27,50.8 ( 0 %),12513,45350600,3624.28,21016,57902900,2755,-12552300
2021-09-24,50.8 ( -0.39 %),10699,25479500,2381.48,13723,37264100,2715,-11784600
2021-09-23,51 ( 0.2 %),8958,30363700,3389.56,19303,43434800,2250,-13071100
2021-09-22,50.9 ( 0.2 %),11793,25643100,2174.43,8717,24232400,2780,1410700
2021-09-21,50.8 ( -0.97 %),24092,51554600,2139.91,12630,49764400,3940,1790200
2021-09-20,51.3 ( -0.97 %),21273,47184900,2218.07,22765,61438800,2699,-14253900
2021-09-17,51.8 ( 0.97 %),10386,36138900,3479.58,21394,52337100,2446,-16198200
2021-09-16,51.3 ( -0.58 %),10631,28936000,2721.85,22758,47720100,2097,-18784100
2021-09-15,51.6 ( 2.58 %),15480,46933200,3031.86,20511,46885200,2286,48000
2021-09-14,50.3 ( -0.98 %),15667,36187100,2309.77,12665,36970900,2919,-783800
2021-09-13,50.8 ( -1.36 %),18561,43556500,2346.67,14020,45937600,3277,-2381100
2021-09-10,51.5 ( -0.77 %),12612,29692100,2354.27,19128,44608000,2332,-14915900
2021-09-09,51.9 ( 1.17 %),19974,63180600,3163.14,29383,72237900,2458,-9057300
2021-09-08,51.3 ( 1.18 %),19301,57360300,2971.88,31940,69658200,2181,-12297900
2021-09-07,50.7 ( -0.98 %),17658,46999300,2661.64,32558,64402200,1978,-17402900
2021-09-06,51.2 ( 4.07 %),18276,72666400,3976.06,35097,72518800,2066,147600
2021-09-01,49.2 ( -0.2 %),9787,24177500,2470.37,14998,34204500,2281,-10027000
2021-08-31,49.3 ( 1.23 %),11883,42263100,3556.6,21439,47486400,2215,-5223300
2021-08-30,48.7 ( 2.31 %),11197,29069300,2596.17,14956,29368300,1964,-299000
2021-08-27,47.6 ( -0.21 %),21710,44372600,2043.88,11165,42462700,3803,1909900
2021-08-26,47.7 ( -1.45 %),15568,24531500,1575.76,8578,27868100,3249,-3336600
2021-08-25,48.4 ( 1.36 %),14214,33421900,2351.34,11730,28776400,2453,4645500
2021-08-24,47.75 ( 0.53 %),15578,38951400,2500.41,16794,37582000,2238,1369400
2021-08-23,47.5 ( -3.06 %),26356,53238900,2019.99,19552,56543600,2892,-3304700
2021-08-20,49 ( -3.73 %),37069,73180900,1974.18,24238,82293900,3395,-9113000
2021-08-19,50.9 ( 0.99 %),16787,49540700,2951.13,24401,57576600,2360,-8035900
2021-08-18,50.4 ( 0 %),12338,35754300,2897.9,21513,45190300,2101,-9436000
2021-08-17,50.4 ( 1.92 %),28524,73601100,2580.32,35979,82981000,2306,-9379900
2021-08-16,49.45 ( 1.64 %),11172,33430600,2992.36,18579,40192900,2163,-6762300
2021-08-13,48.65 ( 0.52 %),20655,45847200,2219.67,13411,43198700,3221,2648500
2021-08-12,48.4 ( -1.12 %),17313,36452200,2105.48,12834,36764900,2865,-312700
2021-08-11,48.95 ( -0.91 %),14233,32814400,2305.52,15091,44535000,2951,-11720600
2021-08-10,49.4 ( -0.6 %),18875,39638400,2100.05,20484,48255400,2356,-8617000
2021-08-09,49.7 ( 2.69 %),18126,52835700,2914.91,22206,47393200,2134,5442500
2021-08-06,48.4 ( -0.82 %),16581,34382600,2073.61,17936,43909700,2448,-9527100
2021-08-05,48.8 ( 2.74 %),21526,55300200,2569,29332,59737900,2037,-4437700
2021-08-04,47.5 ( 0.53 %),18929,43936400,2321.12,21545,48449000,2249,-4512600
2021-08-03,47.25 ( 0 %),19580,44651800,2280.48,16628,49496300,2977,-4844500
2021-08-02,47.25 ( -0.11 %),19388,41879800,2160.09,18409,45541300,2474,-3661500
2021-07-30,47.3 ( 0.42 %),16317,37873800,2321.13,16939,45208900,2669,-7335100
2021-07-29,47.1 ( 0.86 %),19525,54862400,2809.85,23039,57470800,2495,-2608400
2021-07-28,46.7 ( 1.08 %),14735,37971000,2576.93,17776,45201900,2543,-7230900
2021-07-27,46.2 ( 1.32 %),11600,33484200,2886.57,15759,33449400,2123,34800
2021-07-26,45.6 ( -0.44 %),24288,51598100,2124.43,11275,37965700,3367,13632400
2021-07-23,45.8 ( -2.97 %),25776,49759600,1930.46,12388,47082600,3801,2677000
2021-07-22,47.2 ( 0.96 %),12598,38865300,3085.04,21578,39793300,1844,-928000
2021-07-21,46.75 ( -1.16 %),16446,36124600,2196.56,19137,43569300,2277,-7444700
2021-07-20,47.3 ( 6.77 %),19942,78940400,3958.5,31168,60208300,1932,18732100
2021-07-19,44.3 ( -5.24 %),36844,72775300,1975.23,18182,67688300,3723,5087000
2021-07-16,46.75 ( 0.54 %),18419,41267700,2240.5,19356,45917700,2372,-4650000
2021-07-15,46.5 ( 3.33 %),22348,57620800,2578.34,23414,45675400,1951,11945400
2021-07-14,45 ( -1.1 %),21298,48045600,2255.87,17138,47293300,2760,752300
2021-07-13,45.5 ( 1.22 %),23857,53146400,2227.71,18159,45215700,2490,7930700
2021-07-12,44.95 ( -4.97 %),46177,100130500,2168.41,28814,108524700,3766,-8394200
2021-07-09,47.3 ( -3.47 %),53511,71350400,1333.38,19716,79973300,4056,-8622900
2021-07-08,49 ( -1.8 %),0,0,0,0,0,0,0
2021-07-07,49.9 ( 3.96 %),45312,69716400,1538.59,21273,65846500,3095,3869900
2021-07-06,48 ( -6.25 %),0,0,0,0,0,0,0
2021-07-02,52.3 ( -0.95 %),0,0,0,0,0,0,0
2021-07-01,52.8 ( 2.52 %),16667,68693100,4121.5,26300,64578800,2455,4114300
2021-06-30,51.5 ( -0.58 %),17595,28062000,1594.88,12561,36455800,2902,-8393800
2021-06-29,51.8 ( -1.15 %),17239,28516400,1654.18,15158,36341600,2398,-7825200
2021-06-28,52.4 ( 3.35 %),0,0,0,0,0,0,0
2021-06-25,50.7 ( 0.2 %),33708,50296100,1492.11,16856,43312100,2570,6984000
2021-06-24,50.6 ( -1.56 %),22843,29380300,1286.18,13430,40615100,3024,-11234800
2021-06-23,51.4 ( -0.58 %),17297,30115100,1741.06,9906,33959200,3428,-3844100
2021-06-22,0 ( 0 %),13313,31763900,2385.93,13057,33362500,2555,-1598600
2021-06-21,51.2 ( -1.73 %),24870,38570500,1550.88,9115,38059300,4175,511200
2021-06-18,52.1 ( 1.36 %),22570,52142900,2310.27,13771,46637800,3387,5505100
2021-06-17,51.4 ( -0.77 %),26596,40652400,1528.52,8075,29832300,3694,10820100
2021-06-16,51.8 ( -2.63 %),33230,43809700,1318.38,9726,49267000,5065,-5457300
2021-06-15,53.2 ( -0.75 %),20618,33541300,1626.8,12326,36092100,2928,-2550800
2021-06-14,53.6 ( 0.94 %),19325,44067100,2280.32,18585,49130000,2644,-5062900
2021-06-11,53.1 ( 2.91 %),15043,46944200,3120.67,20129,44242200,2198,2702000
2021-06-10,51.6 ( 2.58 %),21357,48770400,2283.58,16559,47248000,2853,1522400
2021-06-09,50.3 ( 0.6 %),40510,64731200,1597.91,25213,51735900,2052,12995300
2021-06-08,50 ( -5.12 %),34953,47120700,1348.12,15275,68433700,4480,-21313000
2021-06-07,52.7 ( -3.3 %),31942,44797200,1402.45,16588,66118100,3986,-21320900
2021-06-04,54.5 ( 0.37 %),22542,44463200,1972.46,13768,41498400,3014,2964800
2021-06-03,54.3 ( 0.56 %),0,0,0,0,0,0,0
2021-06-02,54 ( -2.7 %),38249,60111100,1571.57,10340,65745300,6358,-5634200
2021-06-01,55.5 ( 5.31 %),45090,73267600,1624.92,6374,46840300,7349,26427300
2021-05-31,52.7 ( -21.46 %),64453,117371700,1821.04,9721,78040700,8028,39331000
2021-05-28,67.1 ( 0.45 %),21995,53660400,2439.66,21814,53669400,2460,-9000
2021-05-27,66.8 ( -1.47 %),14129,30503300,2158.91,11870,39569700,3334,-9066400
2021-05-26,67.8 ( 0.59 %),14050,29306300,2085.86,10850,27864600,2568,1441700
2021-05-25,67.4 ( 3.06 %),20398,48349700,2370.32,13551,37465000,2765,10884700
2021-05-24,65.4 ( -0.3 %),22092,41797900,1891.99,13272,40824500,3076,973400
2021-05-21,65.6 ( -1.5 %),22173,35555200,1603.54,12662,37715300,2979,-2160100
2021-05-20,66.6 ( 0.76 %),23868,43158000,1808.2,11177,37207700,3329,5950300
2021-05-19,66.1 ( 4.26 %),22011,61292400,2784.63,20426,47737100,2337,13555300
2021-05-18,63.4 ( 2.42 %),19434,72321200,3721.37,11996,54022400,4503,18298800
2021-05-17,61.9 ( 0.81 %),28321,65318200,2306.35,19080,55099800,2888,10218400
2021-05-14,61.4 ( -0.16 %),22055,55190800,2502.42,16991,55288200,3254,-97400
2021-05-13,61.5 ( -1.91 %),15088,36646600,2428.86,9693,44717900,4613,-8071300
2021-05-12,62.7 ( 1.13 %),21522,51690300,2401.74,11264,47164100,4187,4526200
2021-05-11,62 ( -1.59 %),21570,44595800,2067.49,15140,51837600,3424,-7241800
2021-05-10,63 ( 3.62 %),16005,49410100,3087.17,9616,44437800,4621,4972300
2021-05-07,60.8 ( 2.36 %),20161,59909500,2971.55,18882,47585100,2520,12324400
2021-05-06,59.4 ( 0.17 %),15746,42199200,2679.99,11467,39692200,3461,2507000
2021-05-05,59.3 ( -0.84 %),15660,41152100,2627.85,11300,44898400,3973,-3746300
2021-05-04,59.8 ( 2.93 %),22418,63153800,2817.1,13738,53267500,3877,9886300
2021-04-29,58.1 ( 3.75 %),14287,56104500,3926.96,17318,52639200,3040,3465300
2021-04-28,56 ( -0.53 %),12428,29076700,2339.61,5463,29597500,5418,-520800
2021-04-27,56.3 ( 2.18 %),15578,41206100,2645.15,8806,40242000,4570,964100
2021-04-23,56.4 ( 2.55 %),17389,51188600,2943.73,10126,45862500,4529,5326100
2021-04-22,0 ( 0 %),17760,48960200,2756.77,12589,64523600,5125,-15563400
2021-04-20,57.2 ( -1.04 %),22762,63255100,2778.98,17958,68641900,3822,-5386800
2021-04-19,57.8 ( 5.86 %),12873,63216400,4910.77,13570,53050700,3909,10165700
2021-04-16,54.6 ( 0.18 %),13415,45399500,3384.23,14010,55256900,3944,-9857400
2021-04-15,54.5 ( 2.83 %),12598,57166500,4537.74,16182,54309700,3356,2856800
2021-04-14,53 ( 5.79 %),16710,61948100,3707.25,12547,45173500,3600,16774600
2021-04-13,50.1 ( -2.15 %),12855,40149500,3123.26,10051,45401700,4517,-5252200
2021-04-12,51.2 ( 3.33 %),13613,44382700,3260.32,9269,39973800,4313,4408900
2021-04-09,49.55 ( 0.41 %),9172,31409300,3424.48,6073,28683500,4723,2725800
2021-04-08,49.35 ( -0.2 %),7098,21338700,3006.3,4833,20493200,4240,845500
2021-04-07,49.45 ( 0.1 %),7942,26405100,3324.74,5674,25041100,4413,1364000
2021-04-06,49.4 ( 0.2 %),6709,25776500,3842.08,6974,26953400,3865,-1176900
2021-04-05,49.3 ( 0.51 %),6482,26473900,4084.22,8065,31776700,3940,-5302800
2021-04-02,49.05 ( 1.13 %),7952,31832400,4003.07,8950,30975800,3461,856600
2021-04-01,48.5 ( 3.63 %),11387,51919900,4559.58,16185,44950000,2777,6969900
2021-03-31,46.8 ( 0.75 %),7836,29000700,3700.96,11070,36198500,3270,-7197800
2021-03-30,46.45 ( 0.32 %),5825,22874000,3926.87,6500,24984600,3844,-2110600
2021-03-29,46.3 ( 0.22 %),5286,20132400,3808.63,6094,26741400,4388,-6609000
2021-03-26,46.2 ( 2.67 %),12323,50888900,4129.59,12084,50314700,4164,574200
2021-03-25,45 ( -0.99 %),9882,33519200,3391.94,7074,37947600,5364,-4428400
2021-03-24,45.45 ( -2.47 %),11953,32963200,2757.73,6851,45398800,6627,-12435600
2021-03-23,46.6 ( -0.32 %),6895,23327800,3383.29,7088,26104600,3683,-2776800
2021-03-22,46.75 ( -0.85 %),6809,18117800,2660.86,6377,25976700,4073,-7858900
2021-03-19,47.15 ( 1.18 %),10369,36022700,3474.08,10041,38323700,3817,-2301000
2021-03-18,46.6 ( 0.65 %),6032,18303400,3034.38,6838,25886500,3786,-7583100
2021-03-17,46.3 ( 0.33 %),6479,2176550,335.94,5232,2701300,516,-524750
2021-03-16,46.1 ( -0.86 %),9943,26415000,2656.64,5519,30398900,5508,-3983900
2021-03-15,46.5 ( 0.11 %),6848,2177220,317.94,8402,3036430,361,-859210
2021-03-12,46.45 ( 0.11 %),5774,22726200,3935.95,6783,26654000,3930,-3927800
2021-03-11,46.4 ( 1.75 %),6783,31731500,4678.09,10000,32525100,3253,-793600
2021-03-10,45.6 ( -0.55 %),12921,28444900,2201.45,6166,31592000,5124,-3147100
2021-03-09,45.85 ( -0.97 %),0,0,0,0,0,0,0
2021-03-08,46.3 ( 0.65 %),8353,3419640,409.39,8222,3528190,429,-108550
2021-03-05,46 ( 0.22 %),16824,42976500,2554.48,7983,37899900,4748,5076600
2021-03-04,45.9 ( -1.92 %),15410,41606300,2699.95,11438,48622400,4251,-7016100
2021-03-03,46.8 ( 0.21 %),10515,43738700,4159.65,9971,40356300,4047,3382400
2021-03-02,46.7 ( 1.08 %),9266,4542820,490.27,13919,4505940,324,36880
2021-03-01,46.2 ( 1.32 %),11304,38644900,3418.69,11930,36067900,3023,2577000
2021-02-26,45.6 ( 3.28 %),22894,80757300,3527.44,18754,65466800,3491,15290500
2021-02-25,44.15 ( 1.26 %),11070,41810000,3776.87,13704,45075500,3289,-3265500
2021-02-24,43.6 ( 0.69 %),14415,47011500,3261.29,14993,53776000,3587,-6764500
2021-02-23,43.3 ( -0.23 %),11935,32695400,2739.46,7792,30915200,3968,1780200
2021-02-22,43.4 ( -0.12 %),11721,35099900,2994.62,12331,47532700,3855,-12432800
2021-02-19,43.45 ( -0.91 %),9978,28753300,2881.67,8455,32201800,3809,-3448500
2021-02-18,43.85 ( 0.92 %),11797,37200600,3153.39,12238,38726100,3164,-1525500
2021-02-17,43.45 ( 3.95 %),9742,38390200,3940.69,8569,34465900,4022,3924300
2021-02-09,41.8 ( 2.2 %),13007,5186550,398.75,7984,4152480,520,1034070
2021-02-08,40.9 ( -3.76 %),24611,5276760,214.41,7468,5867400,786,-590640
2021-02-05,42.5 ( 1.67 %),8774,47137700,5372.43,10909,38509000,3530,8628700
2021-02-04,41.8 ( -0.48 %),12647,42657800,3372.96,10751,44403000,4130,-1745200
2021-02-03,42 ( 3.7 %),12591,62325200,4949.98,13970,52162500,3734,10162700
2021-02-02,40.5 ( 5.61 %),10748,61949400,5763.81,13929,43765100,3142,18184300
2021-02-01,38.35 ( -2.04 %),12363,37023100,2994.67,7076,45250500,6395,-8227400
2021-01-29,39.15 ( 4.4 %),24228,97527000,4025.38,10434,57831900,5543,39695100
2021-01-28,37.5 ( -6.95 %),19920,72107100,3619.83,11698,110683500,9462,-38576400
2021-01-27,40.3 ( -4.73 %),15432,44319800,2871.94,6598,48962400,7421,-4642600
2021-01-26,42.3 ( -3.2 %),16037,3780410,235.73,7188,4425260,616,-644850
2021-01-25,43.7 ( 0.11 %),13350,5554050,416.03,11710,5425070,463,128980
2021-01-22,43.65 ( -1.24 %),7639,2675030,350.18,6152,2890390,470,-215360
2021-01-21,44.2 ( 6 %),9339,41324400,4424.93,6241,31695900,5079,9628500
2021-01-20,41.7 ( 0.24 %),16907,66468100,3931.4,10038,65768100,6552,700000
2021-01-19,41.6 ( -6.73 %),9231,32693000,3541.65,9119,43458200,4766,-10765200
2021-01-18,44.6 ( 0.22 %),6218,25277000,4065.13,6429,30704200,4776,-5427200
2021-01-15,44.5 ( 0.11 %),5634,23332800,4141.43,5475,21782300,3979,1550500
2021-01-14,44.45 ( -0.56 %),11442,31768700,2776.5,6149,27441800,4463,4326900
2021-01-13,44.7 ( -0.45 %),7457,24763700,3320.87,8916,28923800,3244,-4160100
2021-01-12,44.9 ( 4.3 %),8246,48461800,5877.01,10606,34114300,3217,14347500
2021-01-11,43.05 ( 0.7 %),5492,28112300,5118.77,7106,25099000,3532,3013300
2021-01-08,42.75 ( -0.12 %),6079,29290300,4818.28,5962,32226200,5405,-2935900
2021-01-07,42.8 ( 0 %),8734,33820300,3872.26,5477,31884100,5821,1936200
2021-01-06,42.8 ( 1.06 %),4864,29201900,6003.68,7299,28065400,3845,1136500
2021-01-05,42.35 ( 0.12 %),8614,32570800,3781.15,5836,29642700,5079,2928100
2021-01-04,42.3 ( 2.05 %),0,0,0,0,0,0,0
2020-12-31,41.45 ( 1.34 %),0,0,0,0,0,0,0
2020-12-30,40.9 ( -1.68 %),11525,33330960,2892.06,6061,33432690,5516,-101730
2020-12-29,41.6 ( 0.12 %),6598,26408550,4002.51,6916,25051120,3622,1357430
2020-12-28,41.55 ( 1.96 %),8181,36997410,4522.36,8249,39026850,4731,-2029440
2020-12-25,40.75 ( 2 %),8145,45691870,5609.81,11617,40584410,3494,5107460
2020-12-24,39.95 ( -0.12 %),9004,36088920,4008.1,9092,35955000,3955,133920
2020-12-23,40 ( 1.65 %),9513,52438980,5512.35,16699,50924560,3050,1514420
2020-12-22,39.35 ( 2.08 %),0,0,0,0,0,0,0
2020-12-21,38.55 ( -0.13 %),7066,22306240,3156.84,9017,33521730,3718,-11215490
2020-12-18,38.6 ( 2.52 %),9108,43031380,4724.57,7049,31674020,4493,11357360
2020-12-17,37.65 ( -2.96 %),22049,47250480,2142.98,6802,51401490,7557,-4151010
2020-12-16,38.8 ( 0.52 %),7947,27844070,3503.72,6613,34933190,5283,-7089120
2020-12-15,38.6 ( -1.66 %),12410,31456530,2534.77,7783,34519030,4435,-3062500
2020-12-14,39.25 ( 1.16 %),6540,23679310,3620.69,7805,30203330,3870,-6524020
2020-12-11,38.8 ( 3.19 %),7633,33787350,4426.48,7664,27753680,3621,6033670
2020-12-10,37.6 ( -2.34 %),20176,51758110,2565.33,9738,57569800,5912,-5811690
2020-12-09,38.5 ( 0.26 %),8080,28836060,3568.82,8031,29933190,3727,-1097130
2020-12-08,38.4 ( 0.52 %),0,0,0,0,0,0,0
2020-12-07,38.2 ( 3.38 %),8303,44899110,5407.58,11946,40495340,3390,4403770
2020-12-04,36.95 ( 0.27 %),6687,33387850,4992.95,11711,34747420,2967,-1359570
2020-12-03,36.85 ( 4.39 %),9848,47351750,4808.26,11194,34884940,3116,12466810
2020-12-02,35.3 ( -0.84 %),10384,34061980,3280.24,5733,26730920,4663,7331060
2020-12-01,35.6 ( 0.28 %),16066,56082830,3490.78,7527,33655640,4471,22427190
2020-11-30,35.5 ( -2.07 %),11708,36066830,3080.53,8660,37002790,4273,-935960
2020-11-27,36.25 ( 3.28 %),12001,43629070,3635.45,7758,29337930,3782,14291140
2020-11-26,35.1 ( -1.4 %),26753,73907340,2762.58,11206,56148230,5011,17759110
2020-11-25,35.6 ( -5.07 %),39642,92239570,2326.81,12578,87005470,6917,5234100
2020-11-23,0 ( 0 %),13462,45739560,3397.68,8721,37079020,4252,8660540
2020-11-20,35.7 ( 1.42 %),7957,32174690,4043.57,7233,29540690,4084,2634000
2020-11-19,35.2 ( 1.73 %),12626,46793970,3706.16,10704,45184060,4221,1609910
2020-11-18,34.6 ( 3.75 %),10832,42874020,3958.09,7462,32846480,4402,10027540
2020-11-17,33.35 ( 3.41 %),7905,33330600,4216.39,6867,25370330,3695,7960270
2020-11-16,32.25 ( 0.94 %),9767,44596680,4566.06,10341,42668610,4126,1928070
2020-11-13,31.95 ( 1.59 %),5981,28781570,4812.17,6706,25908700,3864,2872870
2020-11-12,31.45 ( 0.48 %),5020,20510190,4085.7,3809,20058100,5266,452090
2020-11-11,31.3 ( 0 %),7460,23625570,3166.97,4756,27137170,5706,-3511600
2020-11-10,31.3 ( -0.63 %),9313,29321890,3148.49,7291,44770210,6140,-15448320
2020-11-09,31.5 ( 3.62 %),8216,35509960,4322.05,7075,28146870,3978,7363090
2020-11-06,30.4 ( 0.5 %),8038,26016850,3236.73,3697,24335020,6582,1681830
2020-11-05,30.25 ( -1.31 %),7378,18274860,2476.94,3776,23572200,6243,-5297340
2020-11-04,30.65 ( -0.16 %),11071,35703880,3224.99,4470,31644680,7079,4059200
2020-11-03,30.7 ( 0.33 %),6985,29225110,4183.98,5796,31956390,5514,-2731280
2020-11-02,30.6 ( 0.16 %),5593,23819940,4258.88,3471,18338930,5283,5481010
2020-10-30,30.55 ( -0.16 %),11444,35648080,3115,4298,32821640,7636,2826440
2020-10-29,30.6 ( 0.66 %),11367,38525600,3389.25,6571,35746160,5440,2779440
2020-10-28,30.4 ( -3.18 %),0,0,0,0,0,0,0
2020-10-27,31.4 ( 1.95 %),0,0,0,0,0,0,0
2020-10-26,30.8 ( -0.32 %),10917,37676500,3451.18,8327,36118170,4337,1558330
2020-10-23,30.9 ( 4.39 %),10445,52122680,4990.2,11914,49387940,4145,2734740
2020-10-22,29.6 ( 1.72 %),5857,25023680,4272.44,5755,20570340,3574,4453340
2020-10-21,29.1 ( -0.85 %),6172,16839360,2728.35,5911,23593170,3991,-6753810
2020-10-20,29.35 ( 1.56 %),8356,24502120,2932.28,3962,20220610,5104,4281510
2020-10-19,28.9 ( -0.69 %),6768,17428710,2575.16,4512,21280320,4716,-3851610
2020-10-16,29.1 ( 0.17 %),8007,28846770,3602.69,6017,33270360,5529,-4423590
2020-10-15,29.05 ( 2.47 %),12530,43582470,3478.25,11357,64200040,5653,-20617570
2020-10-14,28.35 ( 1.25 %),6206,23318650,3757.44,4699,23619390,5026,-300740
2020-10-13,28 ( -0.88 %),6754,19855220,2939.77,3641,20787740,5709,-932520
2020-10-12,28.25 ( -0.88 %),5393,20163520,3738.83,5193,26837400,5168,-6673880
2020-10-09,28.5 ( 1.42 %),4980,20674530,4151.51,5880,23261580,3956,-2587050
2020-10-08,28.1 ( 1.08 %),6279,31887140,5078.38,5878,30948640,5265,938500
2020-10-07,27.8 ( -1.59 %),6168,23089470,3743.43,6804,30901260,4542,-7811790
2020-10-06,28.25 ( 3.29 %),7660,44720590,5838.2,8782,39597610,4509,5122980
2020-10-05,27.35 ( 2.43 %),5141,28218940,5489,5840,22539070,3859,5679870
2020-10-02,26.7 ( -1.11 %),8254,34861750,4223.62,6377,39896390,6256,-5034640
2020-10-01,27 ( 2.27 %),5056,30504790,6033.38,7728,30690080,3971,-185290
2020-09-30,26.4 ( 0.19 %),5541,25639300,4627.2,5614,22705020,4044,2934280
2020-09-29,26.35 ( -0.19 %),5539,28410770,5129.22,7461,35069010,4700,-6658240
2020-09-28,26.4 ( 2.52 %),6029,35228020,5843.1,6703,28991530,4325,6236490
2020-09-25,25.75 ( 0.39 %),4317,18576160,4303.03,4450,19534220,4390,-958060
2020-09-24,25.65 ( -0.58 %),5642,26070630,4620.81,4663,21779610,4671,4291020
2020-09-23,25.8 ( 0.98 %),4691,26923010,5739.29,6307,23151860,3671,3771150
2020-09-22,25.55 ( -0.58 %),0,0,0,0,0,0,0
2020-09-21,25.7 ( 0 %),4870,16923260,3475,6221,28002840,4501,-11079580
2020-09-18,25.7 ( 1.18 %),4906,21695770,4422.29,6893,25509520,3701,-3813750
2020-09-17,25.4 ( 2.83 %),12192,51941070,4260.26,13235,48814950,3688,3126120
2020-09-16,24.7 ( 0 %),3930,13685830,3482.4,4330,16617630,3838,-2931800
2020-09-15,24.7 ( 0.41 %),5143,15734140,3059.33,7095,23190890,3269,-7456750
2020-09-14,24.6 ( 0.61 %),5245,20701580,3946.92,4749,23452390,4938,-2750810
2020-09-11,24.45 ( -0.41 %),5833,18710720,3207.74,3559,25708600,7224,-6997880
2020-09-10,24.55 ( 0.2 %),5443,23147810,4252.77,4620,25728500,5569,-2580690
2020-09-09,24.5 ( -0.61 %),9433,29794510,3158.54,4647,32969930,7095,-3175420
2020-09-08,24.65 ( 0.61 %),7004,21566260,3079.13,4149,19701810,4749,1864450
2020-09-07,24.5 ( -1.8 %),6712,19658490,2928.86,5934,28157310,4745,-8498820
2020-09-04,24.95 ( -0.2 %),9234,31391670,3399.57,6412,29031280,4528,2360390
2020-09-03,25 ( 0.81 %),6178,24800850,4014.38,8977,27890260,3107,-3089410
2020-09-01,24.8 ( 1.02 %),7042,30471800,4327.15,10519,30707570,2919,-235770
2020-08-31,24.55 ( 1.03 %),5897,24920560,4225.97,12015,31131400,2591,-6210840
2020-08-28,24.3 ( 0 %),6023,21922220,3639.75,5409,20558160,3801,1364060
2020-08-27,24.3 ( 0.41 %),6869,20757730,3021.94,3893,17151130,4406,3606600
2020-08-26,24.2 ( -1.43 %),10681,30235580,2830.78,5170,30785240,5955,-549660
2020-08-25,24.55 ( -1.01 %),6405,16265300,2539.47,6781,25383100,3743,-9117800
2020-08-24,24.8 ( 1.85 %),6705,24436190,3644.47,7941,27055020,3407,-2618830
2020-08-21,24.35 ( 1.04 %),5039,18975140,3765.66,5106,17931420,3512,1043720
2020-08-20,24.1 ( -0.62 %),7182,18055280,2513.96,4121,19414070,4711,-1358790
2020-08-19,24.25 ( 0.41 %),4781,18986400,3971.22,4558,21758610,4774,-2772210
2020-08-18,24.15 ( -0.62 %),4697,11788670,2509.83,3335,13214510,3962,-1425840
2020-08-17,24.3 ( 0.83 %),7618,18038510,2367.88,4742,15598910,3290,2439600
2020-08-14,24.1 ( -1.63 %),11500,26485480,2303.09,5888,29137300,4949,-2651820
2020-08-13,24.5 ( 0.82 %),5503,15104410,2744.76,5108,17542850,3434,-2438440
2020-08-12,24.3 ( 0.21 %),6242,16843200,2698.37,5105,18651870,3654,-1808670
2020-08-11,24.25 ( -0.21 %),7867,23685350,3010.72,5682,19992820,3519,3692530
2020-08-10,24.3 ( 0.41 %),7930,23938630,3018.74,6578,26291780,3997,-2353150
2020-08-07,24.2 ( 0.62 %),8464,24915310,2943.68,6465,24194070,3742,721240
2020-08-06,24.05 ( -0.21 %),10106,29594870,2928.45,7535,32640200,4332,-3045330
2020-08-05,24.1 ( 4.78 %),15477,51574730,3332.35,12096,46747710,3865,4827020
2020-08-04,23 ( 0.44 %),7945,20975900,2640.14,7345,29758000,4051,-8782100
2020-08-03,22.9 ( 5.53 %),8180,35085590,4289.19,7874,30601510,3886,4484080
2020-07-31,21.7 ( -1.81 %),7854,17018490,2166.86,3844,14164140,3685,2854350
2020-07-30,22.1 ( 1.61 %),6361,19392520,3048.66,5510,19963300,3623,-570780
2020-07-29,21.75 ( -20.48 %),15967,33013010,2067.58,5121,37086660,7242,-4073650
2020-07-28,27.35 ( 5.39 %),8995,29917990,3326.07,5325,22834570,4288,7083420
2020-07-27,25.95 ( -3.35 %),13523,37730110,2790.07,7124,32308030,4535,5422080
2020-07-24,26.85 ( -4.79 %),12003,38550930,3211.77,6833,41030870,6005,-2479940
2020-07-23,28.2 ( 0.36 %),7028,19383920,2758.1,3383,17758380,5249,1625540
2020-07-22,28.1 ( 0 %),3858,12720050,3297.06,3371,15283200,4534,-2563150
2020-07-21,28.1 ( 0.36 %),6869,24218950,3525.83,4449,19763170,4442,4455780
2020-07-20,28 ( -1.93 %),0,0,0,0,0,0,0
2020-07-17,28.55 ( -0.17 %),5353,11266180,2104.65,5726,17525190,3061,-6259010
2020-07-16,28.6 ( 1.96 %),7878,34697800,4404.39,9394,35508990,3780,-811190
2020-07-15,28.05 ( 0.54 %),2830,11160420,3943.61,4907,16249250,3311,-5088830
2020-07-14,27.9 ( 0.9 %),4299,13418590,3121.33,3662,11995830,3276,1422760
2020-07-13,27.65 ( -0.36 %),9592,27436960,2860.4,4338,22546160,5197,4890800
2020-07-10,27.75 ( -1.42 %),8512,25151480,2954.83,4149,22797290,5495,2354190
2020-07-09,28.15 ( 0.36 %),0,0,0,0,0,0,0
2020-07-08,28.05 ( -1.06 %),7476,16573420,2216.88,4951,22954380,4636,-6380960
2020-07-07,28.35 ( 2.72 %),12652,49680760,3926.71,12439,50714200,4077,-1033440
2020-07-06,27.6 ( 0.36 %),3871,15952920,4121.14,4691,21406330,4563,-5453410
2020-07-03,27.5 ( -0.36 %),4102,17467620,4258.32,5494,22205490,4042,-4737870
2020-07-02,27.6 ( 0.73 %),4556,22761710,4995.99,8152,29276340,3591,-6514630
2020-07-01,27.4 ( 2.24 %),3652,22239530,6089.69,6234,23641260,3792,-1401730
2020-06-30,26.8 ( 0.56 %),6109,30372420,4971.75,7359,32091020,4361,-1718600
2020-06-29,26.65 ( -2.02 %),6727,20847530,3099.08,4041,21940090,5429,-1092560
2020-06-26,27.2 ( -0.37 %),4387,17042470,3884.77,5696,27715460,4866,-10672990
2020-06-25,27.3 ( 1.11 %),9666,40757030,4216.54,11905,47585260,3997,-6828230
2020-06-24,27 ( 0 %),3964,11845950,2988.38,4588,18848250,4108,-7002300
2020-06-23,27 ( -1.1 %),6142,18222590,2966.88,6808,26899750,3951,-8677160
2020-06-22,27.3 ( -0.18 %),5505,15837550,2876.94,6908,27180410,3935,-11342860
2020-06-19,27.35 ( 2.05 %),5130,16917060,3297.67,6466,21858150,3380,-4941090
2020-06-18,26.8 ( 2.1 %),5554,18353180,3304.5,5931,18205290,3070,147890
2020-06-17,26.25 ( 0.19 %),4674,13449820,2877.58,4122,14465970,3509,-1016150
2020-06-16,26.2 ( 3.15 %),4107,18902000,4602.39,5596,18015230,3219,886770
2020-06-15,25.4 ( -4.15 %),6825,19478740,2854.03,4093,24111330,5891,-4632590
2020-06-12,26.5 ( 3.92 %),11949,41368850,3462.12,6350,30833280,4856,10535570
2020-06-11,25.5 ( -5.56 %),13918,32231580,2315.82,5473,36775190,6719,-4543610
2020-06-10,27 ( -0.37 %),9087,21802620,2399.32,4067,16542240,4067,5260380
2020-06-09,27.1 ( -2.17 %),12131,28968770,2388,4957,34784250,7017,-5815480
2020-06-08,27.7 ( 2.4 %),0,0,0,0,0,0,0
2020-06-05,27.05 ( 1.69 %),15447,49410740,3198.73,10526,46060860,4376,3349880
2020-06-04,26.6 ( -1.3 %),8546,20300520,2375.44,4487,24080970,5367,-3780450
2020-06-03,26.95 ( -0.37 %),7571,21822920,2882.44,4195,21210530,5056,612390
2020-06-02,27.05 ( -2.17 %),7430,16914490,2276.51,4188,22989640,5489,-6075150
2020-06-01,27.65 ( 0.91 %),3859,13652680,3537.88,3241,14537270,4485,-884590
2020-05-29,27.4 ( 0.74 %),5557,20403670,3671.71,3739,23398910,6258,-2995240
2020-05-28,27.2 ( 0 %),6833,23274950,3406.26,4373,23744940,5430,-469990
2020-05-27,27.2 ( -4.23 %),10310,29184120,2830.66,6433,37292630,5797,-8108510
2020-05-26,28.4 ( 4.03 %),5911,21722300,3674.89,5728,18424750,3217,3297550
2020-05-25,27.3 ( 0.18 %),5994,18230000,3041.37,6132,22376990,3649,-4146990
2020-05-22,27.25 ( 2.83 %),6168,31833400,5161.06,6998,28240130,4035,3593270
2020-05-21,26.5 ( 0.19 %),5977,18644830,3119.43,5498,18855690,3430,-210860
2020-05-20,26.45 ( 1.15 %),6639,20372670,3068.64,5866,20608950,3513,-236280
2020-05-19,26.15 ( 4.18 %),9566,29426380,3076.14,6619,31418660,4747,-1992280
2020-05-18,25.1 ( 6.81 %),6256,34363210,5492.84,5707,19656170,3444,14707040
2020-05-15,23.5 ( -1.88 %),4656,13314750,2859.7,2903,15924940,5486,-2610190
2020-05-14,23.95 ( -0.62 %),4078,11566190,2836.24,2796,12285930,4394,-719740
2020-05-13,24.1 ( 1.9 %),4788,17573090,3670.24,3822,15256870,3992,2316220
2020-05-12,23.65 ( -1.25 %),6503,18263830,2808.52,3401,16123420,4741,2140410
2020-05-11,23.95 ( 2.35 %),0,0,0,0,0,0,0
2020-05-08,23.4 ( -0.85 %),5856,17548060,2996.59,6790,23099990,3402,-5551930
2020-05-07,23.6 ( 6.31 %),6394,26012250,4068.23,6135,23051900,3757,2960350
2020-05-06,22.2 ( 3.74 %),3207,14598580,4552.1,5078,12432840,2448,2165740
2020-05-05,21.4 ( 1.9 %),2846,10824610,3803.45,3069,10272840,3347,551770
2020-05-04,21 ( -2.33 %),3264,7473640,2289.72,1757,8141780,4634,-668140
2020-04-29,21.5 ( 0.47 %),4366,14306900,3276.89,2653,12129520,4572,2177380
2020-04-28,21.4 ( -2.51 %),5030,12102730,2406.11,3246,14468480,4457,-2365750
2020-04-27,21.95 ( -0.68 %),4741,12581580,2653.78,3544,12952900,3655,-371320
2020-04-24,22.1 ( 2.31 %),5393,17361070,3219.19,4244,14756000,3477,2605070
2020-04-23,21.6 ( 3.85 %),5309,14917620,2809.87,3444,14803040,4298,114580
2020-04-22,20.8 ( 2.97 %),4719,19753250,4185.9,7211,14861030,2061,4892220
2020-04-21,20.2 ( -4.72 %),4884,16648400,3408.76,4208,18297280,4348,-1648880
2020-04-20,21.2 ( 2.42 %),4680,16954710,3622.8,3596,15434030,4292,1520680
2020-04-17,20.7 ( 2.22 %),4115,15172960,3687.23,3273,14393330,4398,779630
2020-04-16,20.25 ( 0.75 %),3074,12831030,4174.05,2662,10608780,3985,2222250
2020-04-15,20.1 ( 0.75 %),2671,10483760,3925.03,2593,10156780,3917,326980
2020-04-14,19.95 ( 3.1 %),4735,14275420,3014.87,3777,13067340,3460,1208080
2020-04-13,19.35 ( 2.93 %),3672,14971380,4077.17,4158,13157150,3164,1814230
2020-04-10,18.8 ( 1.35 %),2955,10053100,3402.06,3020,10261430,3398,-208330
2020-04-09,18.55 ( -0.8 %),3720,11670270,3137.17,4602,12109060,2631,-438790
2020-04-08,18.7 ( -1.58 %),3458,9245270,2673.59,3395,8086040,2382,1159230
2020-04-07,19 ( 0.8 %),4082,14157530,3468.28,4173,12548710,3007,1608820
2020-04-06,18.85 ( 6.8 %),3881,16925240,4361.05,2913,12844520,4409,4080720
2020-04-03,17.65 ( 2.32 %),2702,11626770,4303.02,3083,10642990,3452,983780
2020-04-01,17.25 ( 2.37 %),2158,9614220,4455.15,2571,9237670,3593,376550
2020-03-31,16.85 ( 3.06 %),3125,19808670,6338.77,4280,20081410,4692,-272740
2020-03-30,16.35 ( 0.93 %),3784,19252130,5087.77,2943,15016620,5102,4235510
2020-03-27,16.2 ( -4.42 %),5705,20417290,3578.84,2149,17229370,8017,3187920
2020-03-26,16.95 ( -4.78 %),3765,11738570,3117.81,1826,12584260,6892,-845690
2020-03-25,17.8 ( 4.09 %),3263,14111610,4324.73,2366,11392900,4815,2718710
2020-03-24,17.1 ( -1.16 %),3191,23882060,7484.19,2483,16319440,6572,7562620
2020-03-23,17.3 ( -6.99 %),3113,15332870,4925.43,2410,27009720,11207,-11676850
2020-03-20,18.6 ( -2.87 %),2890,17489300,6051.66,4160,17044520,4097,444780
2020-03-19,19.15 ( -2.79 %),2988,12523190,4191.16,2076,10775450,5190,1747740
2020-03-18,19.7 ( 2.6 %),2890,20612250,7132.27,5529,14700610,2659,5911640
2020-03-17,19.2 ( 0.52 %),2486,11466340,4612.37,2899,8323760,2871,3142580
2020-03-16,19.1 ( 0.26 %),3436,16582490,4826.1,2729,13792120,5054,2790370
2020-03-13,19.05 ( -1.04 %),4575,22737710,4969.99,3378,17552180,5196,5185530
2020-03-12,19.25 ( -6.33 %),3236,16422500,5074.94,3424,17141760,5006,-719260
2020-03-11,0 ( 0 %),3636,14831920,4079.19,2320,13459130,5801,1372790
2020-03-10,21.65 ( 3.84 %),3195,13617970,4262.28,2814,10598770,3766,3019200
2020-03-09,20.85 ( -6.92 %),3736,22295560,5967.76,3743,22698660,6064,-403100
2020-03-06,22.4 ( 0.22 %),2095,6106670,2914.88,1670,4973700,2978,1132970
2020-03-05,22.35 ( 0 %),1586,5115100,3225.16,1330,5510140,4143,-395040
2020-03-04,22.35 ( 0.22 %),1804,6803010,3771.07,1566,5294430,3381,1508580
2020-03-03,22.3 ( 0 %),2181,8143620,3733.89,1977,7888080,3990,255540
2020-03-02,22.3 ( -0.22 %),0,0,0,0,0,0,0
2020-02-28,22.35 ( -2.61 %),3465,11274200,3253.74,1943,10187090,5243,1087110
2020-02-27,22.95 ( 0.88 %),1636,6306270,3854.69,1884,5485850,2912,820420
2020-02-26,22.75 ( -1.52 %),2442,6978390,2857.65,1561,6726450,4309,251940
2020-02-25,23.1 ( 1.76 %),2176,9767290,4488.64,2198,7533220,3427,2234070
2020-02-24,22.7 ( -3.61 %),0,0,0,0,0,0,0
2020-02-21,23.55 ( -0.84 %),0,0,0,0,0,0,0
2020-02-20,23.75 ( 2.15 %),3708,11011560,2969.68,1952,7747830,3969,3263730
2020-02-19,23.25 ( -0.21 %),5458,11309610,2072.12,1943,9330310,4802,1979300
2020-02-18,23.3 ( -1.89 %),5424,13401190,2470.72,1892,13739210,7262,-338020
2020-02-17,23.75 ( 0.21 %),2697,7279640,2699.16,1474,6189570,4199,1090070
2020-02-14,23.7 ( 0 %),3405,9455770,2777.02,1909,8537610,4472,918160
2020-02-13,23.7 ( -0.42 %),3216,9469150,2944.39,1533,8890850,5800,578300
2020-02-12,23.8 ( 0.85 %),5365,16164640,3012.98,2876,16138650,5611,25990
2020-02-11,23.6 ( -3.08 %),6490,17532160,2701.41,2873,19695770,6855,-2163610
2020-02-10,24.35 ( 0 %),4214,10297320,2443.6,1707,8586540,5030,1710780
2020-02-07,24.35 ( -3.37 %),6589,12638500,1918.12,2214,15589590,7041,-2951090
2020-02-06,25.2 ( 3.07 %),4173,15300510,3666.55,2195,13456010,6130,1844500
2020-02-05,24.45 ( -0.61 %),3609,10551100,2923.55,1668,12221260,7327,-1670160
2020-02-04,24.6 ( 0.2 %),4304,14425550,3351.66,1769,13958040,7890,467510
2020-02-03,24.55 ( 1.87 %),5051,22574580,4469.33,3055,16413670,5373,6160910
2020-01-31,24.1 ( -4.74 %),3781,16027240,4238.89,2614,16464590,6299,-437350
2020-01-30,25.3 ( -3.8 %),5593,18792020,3359.92,2940,19203680,6532,-411660
2020-01-22,26.3 ( 1.74 %),6337,12282200,1938.17,2622,14570390,5557,-2288190
2020-01-21,25.85 ( 1.37 %),2857,11334560,3967.29,2223,9932320,4468,1402240
2020-01-20,25.5 ( 2 %),3121,11211680,3592.34,1956,8226170,4206,2985510
2020-01-17,25 ( -1.19 %),3045,11740490,3855.66,2539,12653310,4984,-912820
2020-01-16,25.3 ( 0.6 %),3841,12018720,3129.06,2148,10528290,4901,1490430
2020-01-15,25.15 ( 0.6 %),3395,12003800,3535.73,2609,10727800,4112,1276000
2020-01-14,25 ( 3.09 %),3786,19264070,5088.24,3487,14589800,4184,4674270
2020-01-13,24.25 ( 0.21 %),1897,9086420,4789.89,1754,7499920,4276,1586500
2020-01-10,24.2 ( 0.83 %),2965,14501410,4890.86,3196,15550570,4866,-1049160
2020-01-09,24 ( 2.35 %),1932,8228020,4258.81,1849,8566830,4633,-338810
2020-01-08,23.45 ( -1.05 %),3128,10555310,3374.46,1494,10871270,7277,-315960
2020-01-07,23.7 ( -1.25 %),2430,8142950,3351.01,1968,9958060,5060,-1815110
2020-01-06,24 ( -0.62 %),2086,9811090,4703.3,1894,9037440,4772,773650
2020-01-03,24.15 ( 0.62 %),2168,11843770,5462.99,2626,13006870,4953,-1163100
2020-01-02,24 ( 2.13 %),2085,8033110,3852.81,1880,5942740,3161,2090370
2019-12-31,23.5 ( -0.63 %),1387,4517500,3257.03,1349,7692280,5702,-3174780
2019-12-30,23.65 ( 0.42 %),2108,4964940,2355.28,1555,5899890,3794,-934950
2019-12-27,23.55 ( 2.39 %),2243,7289310,3249.8,1344,5333270,3968,1956040
2019-12-26,23 ( -0.65 %),1722,4784890,2778.68,1114,5864200,5264,-1079310
2019-12-25,23.15 ( -0.22 %),1072,4288600,4000.56,1144,4864950,4253,-576350
2019-12-24,23.2 ( 0.65 %),1854,5583380,3011.53,1215,6156660,5067,-573280
2019-12-23,23.05 ( 0.22 %),0,0,0,0,0,0,0
2019-12-20,23 ( 0.88 %),2767,12650350,4571.86,1192,7724530,6480,4925820
2019-12-19,22.8 ( 1.11 %),3430,9954010,2902.04,1501,8237320,5488,1716690
2019-12-18,22.55 ( -2.59 %),2881,11705400,4062.96,2036,11824970,5808,-119570
2019-12-17,23.15 ( -2.53 %),3447,14773080,4285.78,2027,14655810,7230,117270
2019-12-16,23.75 ( -0.21 %),2282,9509000,4166.96,1583,9034560,5707,474440
2019-12-13,23.8 ( -1.65 %),2761,14025970,5080.03,2648,15273110,5768,-1247140
2019-12-12,24.2 ( -0.82 %),2221,8401070,3782.56,1725,7195610,4171,1205460
2019-12-11,24.4 ( 0 %),2372,8960440,3777.59,2626,9253290,3524,-292850
2019-12-10,24.4 ( 0.83 %),3882,15900440,4095.94,3193,16188670,5070,-288230
2019-12-09,24.2 ( 1.47 %),3258,12967480,3980.2,3317,14112620,4255,-1145140
2019-12-06,23.85 ( 3.25 %),2696,14835770,5502.88,3184,12186300,3827,2649470
2019-12-05,23.1 ( -1.49 %),1968,7807090,3967.02,2035,9221140,4531,-1414050
2019-12-04,23.45 ( 0 %),0,0,0,0,0,0,0
2019-12-03,23.45 ( 2.18 %),3695,17170560,4646.97,4131,14400630,3486,2769930
2019-12-02,22.95 ( 0.44 %),2558,12833030,5016.82,3355,14039620,4185,-1206590
2019-11-29,22.85 ( 1.11 %),1469,9322770,6346.34,2041,11268430,5521,-1945660
2019-11-28,22.6 ( 0 %),1505,6705840,4455.71,1592,5985290,3760,720550
2019-11-27,22.6 ( -0.22 %),1427,5989580,4197.32,1726,7228510,4188,-1238930
2019-11-26,22.65 ( 1.8 %),1816,10528780,5797.79,2292,8929440,3896,1599340
2019-11-25,22.25 ( 0.68 %),1240,7935830,6399.86,1248,6049140,4847,1886690
2019-11-22,22.1 ( 0.45 %),1570,8355520,5321.99,2112,8129430,3849,226090
2019-11-21,22 ( -1.79 %),2902,12902320,4446.01,2277,10281500,4515,2620820
2019-11-20,22.4 ( -1.75 %),2735,10967800,4010.16,1968,11524760,5856,-556960
2019-11-19,22.8 ( -0.44 %),1411,6732620,4771.52,1911,8492600,4444,-1759980
2019-11-18,22.9 ( 1.1 %),1359,6384290,4697.79,2113,7573570,3584,-1189280
2019-11-15,22.65 ( 0 %),1235,5723430,4634.36,1523,6268880,4116,-545450
2019-11-14,22.65 ( 0 %),2556,9135690,3574.21,1759,8396520,4773,739170
2019-11-13,22.65 ( -1.52 %),2727,8888960,3259.61,2894,13702490,4735,-4813530
2019-11-12,23 ( 0.88 %),2566,11752230,4579.98,2934,13140640,4479,-1388410
2019-11-11,22.8 ( 0.44 %),2838,11741840,4137.36,3882,15113800,3893,-3371960
2019-11-08,22.7 ( 0 %),2600,10264880,3948.03,2675,9564810,3576,700070
2019-11-07,22.7 ( 3.18 %),5452,21169800,3882.94,4974,22246260,4473,-1076460
2019-11-06,22 ( 0.46 %),1457,6528260,4480.62,2150,8950660,4163,-2422400
2019-11-05,21.9 ( 0.69 %),1964,8176180,4163.02,2338,10282180,4398,-2106000
2019-11-04,21.75 ( -0.68 %),2307,8902990,3859.12,2294,12506220,5452,-3603230
2019-11-01,21.9 ( 0.46 %),1381,7372400,5338.45,2128,8021910,3770,-649510
2019-10-31,21.8 ( -0.91 %),1993,7984190,4006.12,1942,9958220,5128,-1974030
2019-10-30,22 ( -0.9 %),1249,5082170,4068.99,2028,5999000,2958,-916830
2019-10-29,22.2 ( 0 %),1965,9595600,4883.26,2963,11183190,3774,-1587590
2019-10-28,22.2 ( 1.83 %),2715,13756560,5066.87,3273,12148350,3712,1608210
2019-10-25,21.8 ( -0.91 %),1343,4265810,3176.33,2015,6424660,3188,-2158850
2019-10-24,22 ( 0.69 %),2080,8472340,4073.24,2721,10487210,3854,-2014870
2019-10-23,21.85 ( 1.16 %),2717,10596480,3900.07,3391,12929940,3813,-2333460
2019-10-22,21.6 ( 1.89 %),2440,7198980,2950.4,1784,6350000,3559,848980
2019-10-21,21.2 ( -0.93 %),2214,5311690,2399.14,1160,5254050,4529,57640
2019-10-18,21.4 ( 0 %),1834,4102390,2236.85,1032,4381180,4245,-278790
2019-10-17,21.4 ( 0.47 %),2625,8082370,3079,1473,7742790,5256,339580
2019-10-16,21.3 ( -0.23 %),2272,5128050,2257.06,1338,4780910,3573,347140
2019-10-15,21.35 ( -0.47 %),2265,5388150,2378.87,1478,6750230,4567,-1362080
2019-10-14,21.45 ( -0.23 %),1963,5047960,2571.55,1383,6420340,4642,-1372380
2019-10-11,21.5 ( 0 %),2830,6960300,2459.47,1320,6897650,5225,62650
2019-10-10,21.5 ( -1.83 %),2302,5800620,2519.82,1906,8271830,4340,-2471210
2019-10-09,21.9 ( 0 %),1602,5017100,3131.77,1636,5710190,3490,-693090
2019-10-08,21.9 ( 2.82 %),2592,7992070,3083.36,1754,6185500,3527,1806570
2019-10-07,21.3 ( -0.23 %),2560,4875970,1904.68,1542,5436000,3525,-560030
2019-10-04,21.35 ( -0.93 %),3690,7084260,1919.85,2219,8663170,3904,-1578910
2019-10-03,21.55 ( -0.92 %),3913,7558250,1931.57,2648,6085580,2298,1472670
2019-10-02,21.75 ( -0.68 %),2985,6871080,2301.87,1285,7046330,5484,-175250
2019-10-01,21.9 ( -0.23 %),2163,5798780,2680.9,1303,6852170,5259,-1053390
2019-09-30,21.95 ( -0.9 %),2253,5202140,2308.98,1486,7149490,4811,-1947350
2019-09-27,22.15 ( -0.45 %),1504,4621100,3072.54,1676,6795180,4054,-2174080
2019-09-26,22.25 ( 1.6 %),2433,6441060,2647.37,1169,5556680,4753,884380
2019-09-25,21.9 ( -1.13 %),2523,5498080,2179.18,940,5397290,5742,100790
2019-09-24,22.15 ( 0.68 %),1907,3947760,2070.14,950,3146930,3313,800830
2019-09-23,22 ( -2.87 %),2864,7312730,2553.33,1551,8248820,5318,-936090
2019-09-20,22.65 ( -1.31 %),1646,6730440,4088.97,1717,9552300,5563,-2821860
2019-09-19,22.95 ( -0.22 %),1544,5189610,3361.15,1850,8518460,4605,-3328850
2019-09-18,23 ( 1.32 %),1980,9420990,4758.08,2637,11490460,4357,-2069470
2019-09-17,22.7 ( 0.22 %),1357,5449650,4015.95,1670,6839200,4095,-1389550
2019-09-16,22.65 ( 0.22 %),2053,7912840,3854.28,1900,9465490,4982,-1552650
2019-09-13,22.6 ( 0.22 %),1643,6966490,4240.1,2042,8160550,3996,-1194060
2019-09-12,22.55 ( 2.27 %),2126,9478090,4458.18,2179,8903770,4086,574320
2019-09-11,22.05 ( 3.52 %),2257,8559670,3792.5,2073,7729150,3728,830520
2019-09-10,21.3 ( 0.47 %),2048,6248480,3051.02,987,4536470,4596,1712010
2019-09-09,21.2 ( -0.93 %),1797,4786350,2663.52,1125,5872390,5220,-1086040
2019-09-06,21.4 ( -1.38 %),2175,5535870,2545.23,1194,6434270,5389,-898400
2019-09-05,21.7 ( 0.46 %),1676,5786500,3452.57,1070,4189990,3916,1596510
2019-09-04,21.6 ( -0.23 %),3735,9105770,2437.96,1459,7944060,5445,1161710
2019-09-03,21.65 ( -2.48 %),3905,8160100,2089.65,1589,8819080,5550,-658980
2019-08-30,22.2 ( 0.23 %),1943,6906470,3554.54,1189,6767650,5692,138820
2019-08-29,22.15 ( -0.45 %),2478,8295020,3347.47,1546,7405360,4790,889660
2019-08-28,22.25 ( -0.67 %),2230,8025310,3598.79,1470,6824760,4643,1200550
2019-08-27,22.4 ( -1.75 %),3679,12274050,3336.25,1891,14389310,7609,-2115260
2019-08-26,22.8 ( -2.56 %),2514,8468530,3368.55,1539,10010610,6505,-1542080
2019-08-23,23.4 ( 1.52 %),2095,9362150,4468.81,2223,9948180,4475,-586030
2019-08-22,23.05 ( -0.65 %),1229,5140790,4182.9,1400,7995780,5711,-2854990
2019-08-21,23.2 ( 1.31 %),2033,9159670,4505.49,1627,7178920,4412,1980750
2019-08-20,22.9 ( -0.65 %),2041,8382250,4106.93,1501,7863760,5239,518490
2019-08-19,23.05 ( 0 %),1239,5251270,4238.31,1171,4955940,4232,295330
2019-08-16,23.05 ( -0.86 %),2735,13052890,4772.54,1559,11717920,7516,1334970
2019-08-15,23.25 ( -0.85 %),3449,12218170,3542.53,1458,10084200,6916,2133970
2019-08-14,23.45 ( 0 %),1698,6135220,3613.2,2001,7961620,3979,-1826400
2019-08-13,23.45 ( -0.64 %),3248,11931210,3673.4,3088,11489750,3721,441460
2019-08-12,23.6 ( 2.16 %),2586,14365650,5555.16,3526,12781540,3625,1584110
2019-08-09,23.1 ( -0.86 %),1799,7764890,4316.23,2618,7479150,2857,285740
2019-08-08,23.3 ( 5.43 %),2945,18134750,6157.81,5411,16364420,3024,1770330
2019-08-07,22.1 ( 1.61 %),1255,8955730,7136.04,1481,5668490,3827,3287240
2019-08-06,21.75 ( -1.81 %),2165,8878510,4100.93,2059,8339270,4050,539240
2019-08-05,22.15 ( -1.34 %),1451,7562010,5211.59,2285,9298190,4069,-1736180
2019-08-02,22.45 ( -0.66 %),1650,10065090,6100.05,2369,12580020,5310,-2514930
2019-08-01,22.6 ( 0.22 %),1903,8880780,4666.73,3533,11765180,3330,-2884400
2019-07-31,22.55 ( 4.88 %),2101,12862760,6122.21,3312,11765400,3552,1097360
2019-07-30,21.5 ( -2.71 %),2195,8988660,4095.06,1789,12587100,7036,-3598440
2019-07-29,22.1 ( -2 %),3046,11436680,3754.66,2405,11848870,4927,-412190
2019-07-26,22.55 ( 0.67 %),3678,13319770,3621.47,4671,18267700,3911,-4947930
2019-07-25,22.4 ( 3.94 %),3433,15104710,4399.86,4082,13600340,3332,1504370
2019-07-24,21.55 ( -0.69 %),2098,6479490,3088.41,2498,7614110,3048,-1134620
2019-07-23,21.7 ( 4.58 %),2780,15310140,5507.24,3557,12222560,3436,3087580
2019-07-22,20.75 ( 0.73 %),3184,11664590,3663.5,2568,9788790,3812,1875800
2019-07-19,20.6 ( -1.67 %),5272,18114570,3436,2513,16628570,6617,1486000
2019-07-18,20.95 ( -1.87 %),3958,11216430,2833.86,1798,12011440,6680,-795010
2019-07-17,21.35 ( -1.16 %),2693,7457410,2769.18,1617,8275710,5118,-818300
2019-07-16,21.6 ( 0.7 %),1918,5731560,2988.3,1486,6256720,4210,-525160
2019-07-15,21.45 ( -2.05 %),2526,6509670,2577.07,1641,7372710,4493,-863040
2019-07-12,21.9 ( 1.62 %),2543,6271430,2466.15,2048,5849700,2856,421730
2019-07-11,21.55 ( 0.94 %),1889,5150230,2726.43,2714,5588540,2059,-438310
2019-07-10,21.35 ( 0 %),2999,6164800,2055.62,2412,6267780,2599,-102980
2019-07-09,21.35 ( -1.84 %),4156,8758600,2107.46,2649,12359640,4666,-3601040
2019-07-08,21.75 ( -2.47 %),3784,10796940,2853.31,2628,12051510,4586,-1254570
2019-07-05,22.3 ( 0 %),1889,5150090,2726.36,1977,7603470,3846,-2453380
2019-07-04,22.3 ( 0.68 %),0,0,0,0,0,0,0
2019-07-03,22.15 ( -1.99 %),2436,5986450,2457.49,1965,8479570,4315,-2493120
2019-07-02,22.6 ( -1.74 %),2436,5986450,2457.49,1965,8479570,4315,-2493120
2019-07-01,23 ( -2.13 %),2150,7090490,3297.9,1595,8569730,5373,-1479240
2019-06-28,23.5 ( 4.21 %),0,0,0,0,0,0,0
2019-06-27,22.55 ( -1.53 %),2250,5960220,2648.99,972,5618270,5780,341950
2019-06-26,22.9 ( -0.87 %),1502,3427950,2282.26,890,3871340,4350,-443390
2019-06-25,23.1 ( -1.07 %),2002,5070290,2532.61,1171,5061590,4322,8700
2019-06-24,23.35 ( -1.48 %),1681,4214490,2507.13,1656,6351390,3835,-2136900
2019-06-21,23.7 ( 0.42 %),1963,7528470,3835.19,1574,7970240,5064,-441770
2019-06-20,23.6 ( -1.05 %),2436,5986450,2457.49,1965,8479570,4315,-2493120
2019-06-19,23.85 ( 3.47 %),6349,11722550,1846.36,2135,10926290,5118,796260
2019-06-18,23.05 ( 2.67 %),3159,8379910,2652.71,1524,7233010,4746,1146900
2019-06-17,22.45 ( -2.18 %),1908,5275770,2765.08,1329,8393840,6316,-3118070
2019-06-14,22.95 ( -0.22 %),822,3013910,3666.56,921,3735850,4056,-721940
2019-06-13,23 ( -0.43 %),1348,3627310,2690.88,1044,4273530,4093,-646220
2019-06-12,23.1 ( 0.43 %),1572,6024740,3832.53,1092,4287220,3926,1737520
2019-06-11,23 ( 0.44 %),2039,7023180,3444.42,1176,6475200,5506,547980
2019-06-10,22.9 ( -0.22 %),2291,8675460,3786.76,1862,10115080,5432,-1439620
2019-06-07,22.95 ( 1.1 %),2366,9830670,4154.97,1367,6685890,4891,3144780
2019-06-06,22.7 ( -4.62 %),4244,10813890,2548.04,1643,9776540,5950,1037350
2019-06-05,23.8 ( -2.06 %),2363,4079980,1726.61,862,5259440,6101,-1179460
2019-06-04,24.3 ( -22.86 %),3680,5072050,1378.27,1072,7363910,6869,-2291860
2019-06-03,31.5 ( -1.87 %),0,0,0,0,0,0,0
2019-05-31,32.1 ( 0.31 %),1344,5145090,3828.19,865,5184960,5994,-39870
2019-05-30,32 ( -1.54 %),1662,5514800,3318.17,869,5892180,6780,-377380
2019-05-29,32.5 ( 1.4 %),1174,3090860,2632.76,776,2913020,3754,177840
2019-05-28,32.05 ( -0.47 %),1309,4799330,3666.41,1445,5074210,3512,-274880
2019-05-27,32.2 ( 0.16 %),1054,3283070,3114.87,788,2885470,3662,397600
2019-05-24,32.15 ( -1.83 %),1877,5395380,2874.47,1351,5784070,4281,-388690
2019-05-23,32.75 ( -0.76 %),1211,4247940,3507.8,1472,5026940,3415,-779000
2019-05-22,33 ( 0.3 %),1247,4029680,3231.5,1814,5226020,2881,-1196340
2019-05-21,32.9 ( 0.3 %),948,4329670,4567.16,1587,4637710,2922,-308040
2019-05-20,32.8 ( 1.71 %),1162,4022290,3461.52,1342,4571010,3406,-548720
2019-05-17,32.25 ( -0.15 %),970,2575680,2655.34,777,2889730,3719,-314050
2019-05-16,32.3 ( -0.31 %),1150,3380910,2939.92,967,3813630,3944,-432720
2019-05-15,32.4 ( 0 %),1383,4089030,2956.64,1052,4803820,4566,-714790
2019-05-14,32.4 ( 1.09 %),1602,4528060,2826.5,863,2804610,3250,1723450
2019-05-13,32.05 ( -2.44 %),2326,6455110,2775.2,1513,6311680,4172,143430
2019-05-10,32.85 ( -0.15 %),1074,3528430,3285.32,1066,3925150,3682,-396720
2019-05-09,32.9 ( -0.75 %),1225,3990100,3257.22,1024,4235670,4136,-245570
2019-05-08,33.15 ( -1.04 %),1323,5184570,3918.8,1242,4724750,3804,459820
2019-05-07,33.5 ( 0.15 %),1210,4049700,3346.86,1326,4598180,3468,-548480
2019-05-06,33.45 ( -2.05 %),2437,6746980,2768.56,1672,6792570,4063,-45590
2019-05-03,34.15 ( 0.44 %),1802,5555890,3083.18,2482,7270260,2929,-1714370
2019-05-02,34 ( 1.19 %),1533,5402610,3524.21,1886,5425440,2877,-22830
2019-04-26,33.6 ( 1.51 %),1204,4590140,3812.41,2495,6033180,2418,-1443040
2019-04-25,33.1 ( -0.75 %),1707,6378180,3736.49,2722,8616360,3165,-2238180
2019-04-24,33.35 ( 4.55 %),2521,10455200,4147.24,3537,8396830,2374,2058370
2019-04-23,31.9 ( 0.16 %),657,2786340,4241,1154,3001050,2601,-214710
2019-04-22,31.85 ( 0.79 %),815,3431380,4210.28,1473,3092140,2099,339240
2019-04-19,31.6 ( 0.96 %),708,2591040,3659.66,944,2031520,2152,559520
2019-04-18,31.3 ( -0.95 %),1310,3796290,2897.93,862,3295750,3823,500540
2019-04-17,31.6 ( -0.47 %),1446,2999100,2074.07,921,3226250,3503,-227150
2019-04-16,31.75 ( -0.94 %),0,0,0,0,0,0,0
2019-04-12,32.05 ( 0.31 %),931,3680250,3953.01,807,2234190,2769,1446060
2019-04-11,31.95 ( 0 %),850,3352210,3943.78,796,2414100,3033,938110
2019-04-10,31.95 ( -0.47 %),1507,4421740,2934.13,1021,3576130,3503,845610
2019-04-09,32.1 ( -0.93 %),1253,4028700,3215.24,1379,5942300,4309,-1913600
2019-04-08,32.4 ( -0.31 %),859,3129400,3643.07,1415,4043010,2857,-913610
2019-04-05,32.5 ( 0.31 %),993,4260940,4290.98,1914,4934600,2578,-673660
2019-04-04,32.4 ( 0.93 %),1017,4654020,4576.22,1480,4731610,3197,-77590
2019-04-03,32.1 ( 0 %),1069,6184250,5785.08,1499,5758380,3841,425870
2019-04-02,32.1 ( 0.47 %),976,3127830,3204.74,1551,5099420,3288,-1971590
2019-04-01,31.95 ( -0.78 %),1506,5992210,3978.89,1379,6519870,4728,-527660
2019-03-29,32.2 ( -0.77 %),2503,9986950,3989.99,2422,11437950,4723,-1451000
2019-03-28,32.45 ( 0.31 %),1343,4260530,3172.4,1837,5537270,3014,-1276740
2019-03-27,32.35 ( 2.37 %),1374,5582530,4062.98,2192,4770010,2176,812520
2019-03-26,31.6 ( 0.64 %),1395,6180650,4430.57,1339,5072600,3788,1108050
2019-03-25,31.4 ( -1.72 %),2637,5995860,2273.74,1739,5619410,3231,376450
2019-03-22,31.95 ( -0.16 %),1758,6961370,3959.82,3226,7202610,2233,-241240
2019-03-21,32 ( -0.93 %),1752,4635730,2645.96,2101,7411270,3527,-2775540
2019-03-20,32.3 ( 1.25 %),3111,10379600,3336.42,3346,10526720,3146,-147120
2019-03-19,31.9 ( 0.16 %),4722,11901470,2520.43,2555,10294370,4029,1607100
2019-03-18,31.85 ( -0.16 %),7132,19028330,2668.02,3946,15695650,3978,3332680
2019-03-15,31.9 ( -6.73 %),10326,24489960,2371.68,4467,28008140,6270,-3518180
2019-03-14,34.2 ( -0.44 %),2255,7181340,3184.63,2123,7438950,3504,-257610
2019-03-13,34.35 ( 1.48 %),1733,5802490,3348.23,1845,5347440,2898,455050
2019-03-12,33.85 ( 0.15 %),2202,7544320,3426.12,1856,9075790,4890,-1531470
2019-03-11,33.8 ( -0.44 %),2128,7254990,3409.3,1566,7340100,4687,-85110
2019-03-08,33.95 ( -0.44 %),3435,8790240,2559.02,1618,7472020,4618,1318220
2019-03-07,34.1 ( -2.57 %),3561,7067660,1984.74,2036,9136150,4487,-2068490
2019-03-06,35 ( -0.14 %),2856,6017290,2106.89,1846,7311550,3961,-1294260
2019-03-05,35.05 ( -0.85 %),3069,8743830,2849.08,2867,10719230,3739,-1975400
2019-03-04,35.35 ( 3.21 %),2771,9560360,3450.15,2835,7305970,2577,2254390
2019-03-01,34.25 ( 1.93 %),2369,7452820,3145.98,1981,6884400,3475,568420
2019-02-28,33.6 ( -2.33 %),2731,10262910,3757.93,3016,11121290,3687,-858380
2019-02-27,34.4 ( -0.29 %),2253,7168780,3181.88,2528,9351480,3699,-2182700
2019-02-26,34.5 ( -0.86 %),3874,9950960,2568.65,4153,13959080,3361,-4008120
2019-02-25,34.8 ( 2.65 %),4843,17418540,3596.64,4625,17113130,3700,305410
2019-02-22,33.9 ( 3.67 %),3570,14901220,4174.01,4342,12064330,2779,2836890
2019-02-21,32.7 ( 1.55 %),2461,8399670,3413.11,2986,9043240,3029,-643570
2019-02-20,32.2 ( 1.58 %),2855,12107870,4240.94,3158,9617430,3045,2490440
2019-02-19,31.7 ( -1.4 %),3564,8120710,2278.54,3305,11453050,3465,-3332340
2019-02-18,32.15 ( 1.74 %),2966,9253600,3119.89,3138,11357230,3619,-2103630
2019-02-15,31.6 ( 1.94 %),4109,14947750,3637.81,4658,15711200,3373,-763450
2019-02-14,31 ( 0.32 %),3035,11061900,3644.78,3742,10989920,2937,71980
2019-02-13,30.9 ( 4.75 %),4552,17683040,3884.67,5004,15563800,3110,2119240
2019-02-12,29.5 ( 2.08 %),5063,11479910,2267.41,3518,12720520,3616,-1240610
2019-02-11,28.9 ( 5.86 %),3262,5333530,1635.05,2057,3736030,1816,1597500
2019-02-01,27.3 ( -1.44 %),4607,13880960,3013.01,2113,10371620,4908,3509340
2019-01-31,27.7 ( -4.48 %),4823,11166770,2315.32,2358,10764520,4565,402250
2019-01-30,29 ( -2.36 %),3899,12692030,3255.2,1827,9713260,5317,2978770
2019-01-29,29.7 ( -0.17 %),1187,3350400,2822.58,954,3122170,3273,228230
2019-01-28,29.75 ( 0.17 %),1057,3964310,3750.53,1164,2975370,2556,988940
2019-01-25,29.7 ( -0.5 %),1223,2620720,2142.86,1171,3340690,2853,-719970
2019-01-24,29.85 ( -0.67 %),1471,3776240,2567.12,1499,4542340,3030,-766100
2019-01-23,30.05 ( 1.86 %),2037,6750610,3314,2184,5565080,2548,1185530
2019-01-22,29.5 ( -0.17 %),1021,4451260,4359.71,1447,3714500,2567,736760
2019-01-21,29.55 ( 1.2 %),999,3728510,3732.24,1320,3135080,2375,593430
2019-01-18,29.2 ( 1.04 %),1202,3614570,3007.13,1452,3633290,2502,-18720
2019-01-17,28.9 ( -1.87 %),1546,3132480,2026.18,1098,3476010,3166,-343530
2019-01-16,29.45 ( 0.51 %),1519,5450010,3587.89,1802,5040180,2797,409830
2019-01-15,29.3 ( 0 %),1816,4030760,2219.58,1325,4149180,3131,-118420
2019-01-14,29.3 ( -0.17 %),1831,5495420,3001.32,1405,4473060,3184,1022360
2019-01-11,29.35 ( -1.51 %),1323,3564330,2694.13,1603,5229070,3262,-1664740
2019-01-10,29.8 ( 1.02 %),1075,3208760,2984.89,1714,3579420,2088,-370660
2019-01-09,29.5 ( 2.25 %),1383,3521820,2546.51,1679,3194800,1903,327020
2019-01-08,28.85 ( -1.7 %),2459,5305490,2157.58,1935,4811100,2486,494390
2019-01-07,29.35 ( -1.18 %),2100,3937040,1874.78,2093,4661940,2227,-724900
2019-01-04,29.7 ( 0.68 %),2557,8356380,3268.04,2024,8090280,3997,266100
2019-01-03,29.5 ( -4.22 %),2308,9456910,4097.45,2436,9573670,3930,-116760
2019-01-02,30.8 ( -0.48 %),1595,6794960,4260.16,2363,6989820,2958,-194860
2018-12-28,30.95 ( 0 %),1691,10342910,6116.45,2058,10985510,5338,-642600
2018-12-27,30.95 ( 2.15 %),1740,7474370,4295.61,2764,9469000,3426,-1994630
2018-12-26,30.3 ( -0.33 %),1710,6271160,3667.35,1714,6048040,3529,223120
2018-12-25,30.4 ( -0.33 %),3208,7746810,2414.84,1941,6913860,3562,832950
2018-12-24,30.5 ( 1.84 %),1917,6043690,3152.68,2060,5272130,2559,771560
2018-12-21,29.95 ( 0 %),3029,11847840,3911.47,1461,5794780,3966,6053060
2018-12-20,29.95 ( 0.84 %),4040,15472630,3829.86,2306,8616200,3736,6856430
2018-12-19,29.7 ( -4.5 %),6901,17481030,2533.12,3526,16205930,4596,1275100
2018-12-18,31.1 ( -4.01 %),4920,12215050,2482.73,2951,12139840,4114,75210
2018-12-17,32.4 ( -3.28 %),3031,5828540,1922.98,2175,7196550,3309,-1368010
2018-12-14,33.5 ( -1.47 %),2722,6545720,2404.75,3250,7546040,2322,-1000320
2018-12-13,34 ( 1.19 %),2477,9450380,3815.25,2475,8364690,3380,1085690
2018-12-12,33.6 ( 0.45 %),3173,9609560,3028.54,2496,6276410,2515,3333150
2018-12-11,33.45 ( -0.89 %),6191,14181660,2290.69,3355,12008250,3579,2173410
2018-12-10,33.75 ( -2.6 %),5111,7933900,1552.32,2049,8611500,4203,-677600
2018-12-07,34.65 ( 0.14 %),2465,5940840,2410.08,1885,6086710,3229,-145870
2018-12-06,34.6 ( -1.98 %),3502,6707080,1915.21,2396,8208180,3426,-1501100
2018-12-05,35.3 ( 2.02 %),4088,12851430,3143.7,4096,12474390,3046,377040
2018-12-04,34.6 ( -0.57 %),2990,6476550,2166.07,2707,7650240,2826,-1173690
2018-12-03,34.8 ( 4.82 %),3034,9632460,3174.84,2144,5296160,2470,4336300
2018-11-30,33.2 ( -2.92 %),4415,11041120,2500.82,1754,10149340,5786,891780
2018-11-29,34.2 ( -2.84 %),3158,5274800,1670.3,1786,7363180,4123,-2088380
2018-11-28,35.2 ( -1.12 %),2957,5988310,2025.13,1459,5798210,3974,190100
2018-11-27,35.6 ( 0 %),2161,2755130,1274.93,1436,3920890,2730,-1165760
2018-11-26,35.6 ( 0.14 %),1480,3867400,2613.11,1254,3798850,3029,68550
2018-11-23,35.55 ( -0.7 %),1832,4067040,2220,1245,3863730,3103,203310
2018-11-22,35.8 ( -1.92 %),2264,4341830,1917.77,1560,5581970,3578,-1240140
2018-11-21,36.5 ( 0 %),2109,6087590,2886.48,1519,6468320,4258,-380730
2018-11-20,36.5 ( 2.96 %),3335,9742620,2921.33,1933,7985370,4131,1757250
2018-11-19,35.45 ( 0.71 %),1987,3520000,1771.51,1034,3032810,2933,487190
2018-11-16,35.2 ( 0.57 %),1848,4167540,2255.16,1442,4049700,2808,117840
2018-11-15,35 ( -2.23 %),3111,8991240,2890.14,2255,10013880,4441,-1022640
2018-11-14,35.8 ( -2.98 %),3910,11101840,2839.35,2414,12614200,5225,-1512360
2018-11-13,36.9 ( -1.73 %),2858,8069190,2823.37,1445,7984940,5526,84250
2018-11-12,37.55 ( -0.13 %),1636,4708640,2878.14,998,4116500,4125,592140
2018-11-09,37.6 ( -3.34 %),3475,7437600,2140.32,1456,8717570,5987,-1279970
2018-11-08,38.9 ( -0.64 %),2025,4681960,2312.08,1334,6530880,4896,-1848920
2018-11-07,39.15 ( -1.14 %),1499,4294920,2865.19,1205,5749710,4772,-1454790
2018-11-06,39.6 ( -1 %),889,2559030,2878.55,1205,4121940,3421,-1562910
2018-11-05,40 ( 0 %),1237,3226640,2608.44,969,3674400,3792,-447760
2018-11-02,40 ( 1.01 %),1167,5260400,4507.63,1756,6207510,3535,-947110
2018-11-01,39.6 ( -1.61 %),1234,3204030,2596.46,1304,5095070,3907,-1891040
2018-10-31,40.25 ( 4.01 %),1298,6109650,4706.97,1611,6078150,3773,31500
2018-10-30,38.7 ( -0.39 %),818,2745890,3356.83,859,2694120,3136,51770
2018-10-29,38.85 ( -0.13 %),904,6527090,7220.23,2563,6259580,2442,267510
2018-10-26,38.9 ( -0.26 %),1249,6617200,5298,2642,9199730,3482,-2582530
2018-10-25,39 ( -0.51 %),2614,13772360,5268.69,2974,9874900,3320,3897460
2018-10-24,39.2 ( -0.76 %),1911,8085630,4231.1,3385,8201040,2423,-115410
2018-10-23,39.5 ( -1.5 %),3139,13714940,4369.21,3717,13901600,3740,-186660
2018-10-22,40.1 ( -1.6 %),1500,3466810,2311.21,1288,4609810,3579,-1143000
2018-10-19,40.75 ( -0.61 %),2060,9960990,4835.43,1668,7536780,4518,2424210
2018-10-18,41 ( 0 %),1452,6304800,4342.15,1705,7834530,4595,-1529730
2018-10-17,41 ( 0.61 %),1664,7688010,4620.2,1957,9627740,4920,-1939730
2018-10-16,40.75 ( 0.99 %),1455,5875110,4037.88,1589,4830040,3040,1045070
2018-10-15,40.35 ( -1.1 %),2103,7694580,3658.86,1551,7362500,4747,332080
2018-10-12,40.8 ( 2.26 %),3429,13882400,4048.53,2761,10273170,3721,3609230
2018-10-11,39.9 ( -3.62 %),5482,23303790,4250.96,5196,24166020,4651,-862230
2018-10-10,41.4 ( 0.98 %),2763,11972580,4333.18,3247,10540840,3246,1431740
2018-10-09,41 ( -0.49 %),1917,5948390,3102.97,2638,7080420,2684,-1132030
2018-10-08,41.2 ( -0.6 %),2177,7657070,3517.26,1549,5505340,3554,2151730
2018-10-05,41.45 ( 0.12 %),2502,11291850,4513.13,2307,9538480,4135,1753370
2018-10-04,41.4 ( 0.24 %),4356,20574410,4723.23,1987,14621520,7359,5952890
2018-10-03,41.3 ( 0 %),2964,9885060,3335.04,2536,8169600,3221,1715460
2018-10-02,41.3 ( -2.59 %),5381,15832490,2942.3,3443,17458410,5071,-1625920
2018-10-01,42.4 ( 0.24 %),2798,10041290,3588.74,3365,11705570,3479,-1664280
2018-09-28,42.3 ( 1.81 %),3182,17552220,5516.1,4452,14629230,3286,2922990
2018-09-27,41.55 ( 1.34 %),2077,10320060,4968.73,2540,8787430,3460,1532630
2018-09-26,41 ( -0.61 %),2784,7573170,2720.25,2187,8233810,3765,-660640
2018-09-25,41.25 ( -0.12 %),2804,7652710,2729.21,2385,7526770,3156,125940
2018-09-24,41.3 ( 0 %),2446,7328620,2996.17,2367,9063010,3829,-1734390
2018-09-20,40.9 ( 3.15 %),3829,18687060,4880.4,3898,14017410,3596,4669650
2018-09-19,39.65 ( 0.51 %),1635,7397620,4524.54,2286,8205720,3590,-808100
2018-09-18,39.45 ( 0 %),4107,12075650,2940.26,1557,10575660,6792,1499990
2018-09-17,39.45 ( -0.13 %),2426,5288410,2179.89,1450,4846820,3343,441590
2018-09-14,39.5 ( -0.63 %),2253,6627230,2941.51,2154,8965450,4162,-2338220
2018-09-13,39.75 ( 0.63 %),2151,7259450,3374.92,2724,9873360,3625,-2613910
2018-09-12,39.5 ( -1.25 %),3033,7870850,2595.07,2492,11266660,4521,-3395810
2018-09-11,40 ( 2.04 %),2723,10472410,3845.91,3243,11847000,3653,-1374590
2018-09-10,39.2 ( -1.26 %),1745,4001190,2292.95,1665,4901280,2944,-900090
2018-09-07,39.7 ( 2.72 %),2019,9256170,4584.53,2540,8343600,3285,912570
2018-09-06,38.65 ( 0.13 %),1968,6994350,3554.04,1878,7077840,3769,-83490
2018-09-05,38.6 ( -1.03 %),2807,7967340,2838.38,2064,8683370,4207,-716030
2018-09-04,39 ( -2.38 %),2638,6532180,2476.19,2086,7606100,3646,-1073920
2018-08-31,39.95 ( 0.76 %),2407,8579330,3564.32,3557,11868680,3337,-3289350
2018-08-30,39.65 ( 0.13 %),3572,10561510,2956.75,2137,9637120,4510,924390
2018-08-29,39.6 ( -0.75 %),3979,11120050,2794.68,4441,14292370,3218,-3172320
2018-08-28,0 ( 0 %),4583,18017320,3931.34,5405,18320250,3390,-302930
2018-08-27,38.95 ( 1.56 %),2728,8993710,3296.81,3861,11087210,2872,-2093500
2018-08-24,38.35 ( 0.66 %),2174,8549460,3932.59,2174,8982360,4132,-432900
2018-08-23,38.1 ( 0.26 %),1864,5606650,3007.86,2581,7877060,3052,-2270410
2018-08-22,38 ( 1.33 %),2610,9096300,3485.17,3382,10821880,3200,-1725580
2018-08-21,37.5 ( 0.67 %),2069,6102820,2949.65,1631,5826940,3573,275880
2018-08-20,37.25 ( -1.19 %),1915,5663250,2957.31,1714,5869750,3425,-206500
2018-08-17,37.7 ( 0.53 %),1696,6114980,3605.53,2537,7405040,2919,-1290060
2018-08-16,37.5 ( 0 %),3107,11906380,3832.11,2110,9926890,4705,1979490
2018-08-15,37.5 ( -2.6 %),3137,7596340,2421.53,2513,9439520,3756,-1843180
2018-08-14,38.5 ( 0.52 %),2836,9160020,3229.91,3217,9935050,3088,-775030
2018-08-13,38.3 ( 3.51 %),4427,20350100,4596.81,5081,16534280,3254,3815820
2018-08-10,37 ( 1.23 %),1818,8381120,4610.08,2108,8986170,4263,-605050
2018-08-09,36.55 ( -0.41 %),1849,6976420,3773.08,2224,8571960,3854,-1595540
2018-08-08,36.7 ( 1.52 %),1898,6612230,3483.79,1902,7261750,3818,-649520
2018-08-07,36.15 ( 0 %),2513,9053960,3602.85,1214,7808080,6432,1245880
2018-08-06,36.15 ( -0.41 %),3095,7901360,2552.94,1311,7016890,5352,884470
2018-08-03,36.3 ( -2.55 %),3991,7766530,1946.01,1900,10118080,5325,-2351550
2018-08-02,37.25 ( -0.93 %),3512,9661710,2751.06,1732,9286030,5361,375680
2018-08-01,37.6 ( 0.67 %),2742,10281730,3749.72,3054,11569400,3788,-1287670
2018-07-31,37.35 ( 0.81 %),3172,9863100,3109.43,2135,8894160,4166,968940
2018-07-30,37.05 ( -0.67 %),2894,9365200,3236.07,2929,11836580,4041,-2471380
2018-07-27,37.3 ( 2.19 %),1658,8713630,5255.51,2733,8098000,2963,615630
2018-07-26,36.5 ( 2.82 %),2032,12405540,6105.09,2253,11418380,5068,987160
2018-07-25,35.5 ( 0.28 %),2117,9924600,4688.05,2120,8061760,3803,1862840
2018-07-24,35.4 ( -4.19 %),5166,17808760,3447.3,2621,17754630,6774,54130
2018-07-23,36.95 ( 0.68 %),2098,7852350,3742.78,2487,8611620,3463,-759270
2018-07-20,36.7 ( -1.34 %),2151,8279520,3849.15,1824,7701420,4222,578100
2018-07-19,37.2 ( 0 %),2179,5608550,2573.91,2573,6333460,2462,-724910
2018-07-18,37.2 ( 3.05 %),2903,10615780,3656.83,2817,8896500,3158,1719280
2018-07-17,36.1 ( 1.69 %),1878,7225050,3847.2,1919,4784530,2493,2440520
2018-07-16,35.5 ( -0.28 %),1924,5206810,2706.24,2294,5874040,2561,-667230
2018-07-13,35.6 ( 5.48 %),2343,10336860,4411.81,3160,7051210,2231,3285650
2018-07-12,33.75 ( -1.89 %),2345,6539530,2788.71,1915,5612580,2931,926950
2018-07-11,34.4 ( -3.1 %),2656,9163320,3450.05,2123,9992310,4707,-828990
2018-07-10,35.5 ( -0.56 %),2169,4582490,2112.72,1389,5256640,3784,-674150
2018-07-09,35.7 ( -2.99 %),3529,5656630,1602.9,1666,6993470,4198,-1336840
2018-07-06,36.8 ( 1.94 %),3044,9132210,3000.07,2045,8478850,4146,653360
2018-07-05,36.1 ( -2.7 %),2224,6057820,2723.84,1669,6585170,3946,-527350
2018-07-04,37.1 ( 2.2 %),2647,6608350,2496.54,2900,7490130,2583,-881780
2018-07-03,36.3 ( -5.47 %),2801,8370730,2988.48,2273,9035000,3975,-664270
2018-07-02,38.4 ( 0 %),2544,9567340,3760.75,2462,9493440,3856,73900
2018-06-29,38.4 ( -1.16 %),3434,9200040,2679.1,1881,9020430,4796,179610
2018-06-28,38.85 ( -1.65 %),3584,7314680,2040.93,1702,7156010,4204,158670
2018-06-27,39.5 ( -3.89 %),2510,4421590,1761.59,1633,6303210,3860,-1881620
2018-06-26,41.1 ( -0.96 %),2683,5255620,1958.86,1906,5113290,2683,142330
2018-06-25,41.5 ( 1.34 %),2543,5491490,2159.45,2653,7379030,2781,-1887540
2018-06-22,40.95 ( 4.33 %),3517,12197280,3468.09,2533,9641910,3807,2555370
2018-06-21,39.25 ( -1.88 %),2394,6794670,2838.21,1603,7061630,4405,-266960
2018-06-20,40 ( 4.3 %),3676,9696220,2637.71,2216,10096970,4556,-400750
2018-06-19,38.35 ( -4.6 %),5560,18989220,3415.33,3330,18747300,5630,241920
2018-06-18,40.2 ( -6.51 %),5752,11929800,2074.03,2459,11680630,4750,249170
2018-06-15,43 ( 0.94 %),3363,8376030,2490.64,1470,6601200,4491,1774830
2018-06-14,42.6 ( -1.84 %),5108,10847110,2123.55,2102,10509960,5000,337150
2018-06-13,43.4 ( 2.12 %),3169,6223420,1963.84,1600,6070460,3794,152960
2018-06-12,42.5 ( -1.82 %),8472,16227430,1915.42,2969,16820650,5665,-593220
2018-06-11,60.6 ( -1.14 %),4196,11771020,2805.3,4022,13930320,3464,-2159300
2018-06-08,61.3 ( -0.97 %),2541,5715870,2249.46,2668,7429090,2785,-1713220
2018-06-07,61.9 ( 1.81 %),3154,9152140,2901.76,3471,8731110,2515,421030
2018-06-06,60.8 ( 3.05 %),3967,11617210,2928.46,2955,8847640,2994,2769570
2018-06-05,59 ( -1.67 %),4809,10131330,2106.74,3120,10577840,3390,-446510
2018-06-04,60 ( 5.26 %),3735,9786730,2620.28,2888,8169380,2829,1617350
2018-06-01,57 ( 1.6 %),3704,11121980,3002.69,2773,10205030,3680,916950
2018-05-31,56.1 ( 6.25 %),3479,15600280,4484.13,3372,12525950,3715,3074330
2018-05-30,52.8 ( 1.54 %),2251,10659590,4735.49,2225,8835220,3971,1824370
2018-05-29,52 ( 6.78 %),2707,9142360,3377.3,1696,6420390,3786,2721970
2018-05-28,48.7 ( -6.53 %),1916,6799230,3548.66,2066,7719880,3737,-920650
2018-05-25,52.1 ( -0.57 %),1721,8165040,4744.36,1894,8036810,4243,128230
2018-05-24,52.4 ( 1.35 %),1543,6412440,4155.83,1464,5331600,3642,1080840
2018-05-23,51.7 ( 2.38 %),1826,6284410,3441.63,1667,6707550,4024,-423140
2018-05-22,50.5 ( -5.08 %),2302,8562780,3719.71,1782,9163690,5142,-600910
2018-05-21,53.2 ( -1.3 %),1506,3333740,2213.64,1088,3852820,3541,-519080
2018-05-18,53.9 ( 1.7 %),1839,5852940,3182.68,1615,5076710,3143,776230
2018-05-17,53 ( -1.85 %),2723,6393760,2348.06,1252,5700860,4553,692900
2018-05-15,55.4 ( -0.72 %),2007,4593280,2288.63,1299,4423030,3405,170250
2018-05-11,55.7 ( 0.91 %),1579,4673120,2959.54,1116,3767440,3376,905680
2018-05-10,55.2 ( -3.16 %),1710,4089930,2391.77,1228,4699210,3827,-609280
2018-05-09,57 ( 0 %),1638,3778900,2307.02,1552,4268270,2750,-489370
2018-05-08,57 ( 1.79 %),2562,7526280,2937.66,2329,7920540,3401,-394260
2018-05-07,0 ( 0 %),1939,6939620,3578.97,1320,5415070,4102,1524550
2018-05-04,0 ( 0 %),1833,4360400,2378.83,1356,4367940,3221,-7540
2018-05-03,54.3 ( -0.18 %),2099,7159380,3410.85,2175,6723960,3091,435420
2018-05-02,54.4 ( 1.12 %),2418,6385480,2640.81,2027,6126260,3022,259220
2018-04-27,53.8 ( 0.56 %),3402,8608030,2530.29,2334,8187250,3508,420780
2018-04-26,53.5 ( -4.46 %),1948,6306190,3237.26,2105,6848000,3253,-541810
2018-04-24,56 ( 0.72 %),1784,6619530,3710.5,2116,5855180,2767,764350
2018-04-23,55.6 ( -5.44 %),2538,3880490,1528.96,1502,4643360,3091,-762870
2018-04-20,58.8 ( 3.16 %),2406,5779260,2402.02,1571,4594150,2924,1185110
2018-04-19,57 ( -3.39 %),2180,7543410,3460.28,2142,7571220,3535,-27810
2018-04-18,59 ( -1.17 %),1322,3931550,2973.94,1601,4916050,3071,-984500
2018-04-17,59.7 ( -0.67 %),2393,5542040,2315.94,1748,5905850,3379,-363810
2018-04-16,60.1 ( -1.8 %),1492,4070480,2728.2,1435,4033270,2811,37210
2018-04-13,61.2 ( -0.81 %),1723,4394560,2550.53,2771,7243880,2614,-2849320
2018-04-12,61.7 ( 1.98 %),2357,7459700,3164.91,2649,7302740,2757,156960
2018-04-11,60.5 ( -0.49 %),2823,9641950,3415.5,3820,12203120,3195,-2561170
2018-04-10,60.8 ( 0 %),2105,6633840,3151.47,2519,7331500,2910,-697660
2018-04-09,60.8 ( 0.66 %),2330,6226350,2672.25,2762,7245420,2623,-1019070
2018-04-06,60.4 ( 2.72 %),3040,7116320,2340.89,2906,7682640,2644,-566320
2018-04-05,58.8 ( -0.34 %),1854,3550810,1915.22,1920,5108200,2661,-1557390
2018-04-04,59 ( 0.85 %),2473,4859710,1965.11,1961,5390400,2749,-530690
2018-04-03,58.5 ( -0.85 %),5471,11069410,2023.29,2857,9324380,3264,1745030
2018-04-02,59 ( -2.32 %),4929,8211990,1666.06,2388,8954260,3750,-742270
2018-03-30,60.4 ( -0.66 %),1867,3925250,2102.44,1928,5924710,3073,-1999460
2018-03-29,60.8 ( 1.5 %),2052,5613750,2735.75,2133,6195580,2905,-581830
2018-03-28,59.9 ( 0.84 %),2117,5497010,2596.6,1924,3979380,2068,1517630
2018-03-27,59.4 ( 0.85 %),4363,10585030,2426.09,2699,8607940,3189,1977090
2018-03-26,58.9 ( -4.07 %),7655,15375940,2008.61,3423,16290790,4759,-914850
2018-03-23,61.4 ( -2.23 %),6127,11324520,1848.3,2008,8913520,4439,2411000
2018-03-22,62.8 ( -0.32 %),4193,9420650,2246.76,4159,13493810,3244,-4073160
2018-03-21,63 ( 2.44 %),2842,7679190,2702.04,3919,9667300,2467,-1988110
2018-03-20,61.5 ( -2.54 %),2807,5113640,1821.75,2020,6128120,3034,-1014480
2018-03-19,63.1 ( 4.82 %),3123,9709410,3109,3678,8460100,2300,1249310
2018-03-16,60.2 ( -0.66 %),5588,19931930,3566.92,2791,15738030,5639,4193900
2018-03-15,60.6 ( -1.94 %),4007,6938440,1731.58,2322,6940110,2989,-1670
2018-03-14,61.8 ( 0.49 %),1998,4421010,2212.72,2175,6055950,2784,-1634940
2018-03-13,61.5 ( -0.81 %),2808,5216730,1857.81,1674,5908680,3530,-691950
2018-03-12,62 ( 0.81 %),2464,5673480,2302.55,2603,6425510,2469,-752030
2018-03-09,61.5 ( -0.49 %),3989,8565280,2147.22,2805,9060340,3230,-495060
2018-03-08,61.8 ( 1.15 %),3665,9520020,2597.55,3294,8620520,2617,899500
2018-03-07,61.1 ( -4.38 %),6399,12375720,1934.01,2873,11234740,3910,1140980
2018-03-06,63.9 ( 3.57 %),6999,18505700,2644.05,4180,13691860,3276,4813840
2018-03-05,61.7 ( -6.94 %),14454,23660780,1636.97,6097,31509170,5168,-7848390
2018-03-02,66.3 ( -0.6 %),6159,13175320,2139.2,2647,11245960,4249,1929360
2018-03-01,66.7 ( 1.06 %),5965,11296610,1893.82,3440,11637440,3383,-340830
2018-02-28,66 ( 2.96 %),6216,18352360,2952.44,3807,16730640,4395,1621720
2018-02-27,64.1 ( -0.47 %),4860,11499960,2366.25,3563,12933070,3630,-1433110
2018-02-26,64.4 ( 4.55 %),4985,13712090,2750.67,4616,14006160,3034,-294070
2018-02-23,61.6 ( 4.58 %),4431,17782390,4013.18,3267,14638660,4481,3143730
2018-02-22,58.9 ( -1.83 %),4078,8188680,2008.01,2046,7597320,3713,591360
2018-02-21,60 ( -0.99 %),4959,11043870,2227.04,2319,12799390,5519,-1755520
2018-02-13,60.6 ( 3.06 %),3054,9146660,2994.98,1997,7206340,3609,1940320
2018-02-12,58.8 ( 0.86 %),3547,10332970,2913.16,1751,8868900,5065,1464070
2018-02-09,58.3 ( -2.35 %),4788,16813950,3511.69,2719,12221670,4495,4592280
2018-02-08,59.7 ( 0.34 %),2272,7160110,3151.46,2259,7461110,3303,-301000
2018-02-07,59.5 ( 2.59 %),3327,9246900,2779.35,1999,9056440,4530,190460
2018-02-06,58 ( 1.75 %),4719,20681820,4382.67,4571,18796290,4112,1885530
2018-02-05,57 ( -6.71 %),3852,9752300,2531.75,2442,10583490,4334,-831190
2018-02-02,61.1 ( 0.16 %),2659,6701500,2520.31,1862,7090650,3808,-389150
2018-02-01,61 ( -2.09 %),2528,4348500,1720.13,1680,5230050,3113,-881550
2018-01-31,62.3 ( 1.63 %),2430,8795480,3619.54,3010,9034490,3001,-239010
2018-01-30,61.3 ( -0.33 %),5917,14961590,2528.58,3340,15023280,4498,-61690
2018-01-29,61.5 ( -3.76 %),4238,7231470,1706.34,1949,8617010,4421,-1385540
2018-01-26,63.9 ( 3.9 %),3592,10163850,2829.58,2988,8585080,2873,1578770
2018-01-25,61.5 ( -3.3 %),9465,19504180,2060.66,3778,20273680,5366,-769500
2018-01-22,63.6 ( 6.53 %),4369,11136930,2549.08,3022,11217020,3712,-80090
2018-01-19,59.7 ( 6.61 %),3200,11793750,3685.55,3118,10900390,3496,893360
2018-01-18,56 ( 4.48 %),3151,10584720,3359.16,2487,7665570,3082,2919150
2018-01-17,53.6 ( -4.29 %),3267,7050560,2158.11,1796,9403730,5236,-2353170
2018-01-16,56 ( 2.56 %),3198,7502550,2346.01,2735,7030140,2570,472410
2018-01-15,54.6 ( 4.8 %),1918,6009960,3133.45,1737,5369280,3091,640680
2018-01-12,52.1 ( 0.77 %),2092,8448540,4038.5,1819,9184820,5049,-736280
2018-01-11,51.7 ( 0 %),3920,9192500,2345.03,1912,7575250,3962,1617250
2018-01-10,51.7 ( -2.27 %),4307,9118780,2117.2,2366,10400290,4396,-1281510
2018-01-09,52.9 ( 6.87 %),3152,9297970,2949.86,1898,7509290,3956,1788680
2018-01-08,49.5 ( 3.12 %),2374,6788570,2859.55,1465,5491850,3749,1296720
2018-01-05,48 ( -0.41 %),1928,6649070,3448.69,1628,7903460,4855,-1254390
2018-01-04,48.2 ( 1.26 %),1670,7177170,4297.71,1595,7943510,4980,-766340
2018-01-03,47.6 ( -0.21 %),2339,6888460,2945.04,1842,8820060,4788,-1931600
2018-01-02,47.7 ( 1.81 %),2563,6755040,2635.6,1541,6189250,4016,565790
2017-12-29,46.85 ( 2.29 %),1959,7364350,3759.24,2012,7831270,3892,-466920
2017-12-28,45.8 ( 0.88 %),1631,5694540,3491.44,1559,5447510,3494,247030
2017-12-27,45.4 ( 3.42 %),3018,11526030,3819.1,2492,11474950,4605,51080
2017-12-26,43.9 ( 0.11 %),2314,7341010,3172.43,1662,9441580,5681,-2100570
2017-12-25,43.85 ( -1.13 %),1644,3809520,2317.23,1444,5492010,3803,-1682490
2017-12-22,44.35 ( 0.57 %),2114,8332590,3941.62,2292,10316550,4501,-1983960
2017-12-21,44.1 ( 0.23 %),2531,9312450,3679.36,2975,10689450,3593,-1377000
2017-12-20,44 ( 0.92 %),2114,7045170,3332.63,2411,8950680,3712,-1905510
2017-12-19,43.6 ( 1.4 %),2842,10335350,3636.65,3416,12798750,3747,-2463400
2017-12-18,43 ( 3.12 %),2359,9074560,3846.78,2398,7994020,3334,1080540
2017-12-15,41.7 ( 2.58 %),2448,9766850,3989.73,1935,8322890,4301,1443960
2017-12-14,40.65 ( 0.87 %),1597,4202700,2631.62,1210,3140020,2595,1062680
2017-12-13,40.3 ( 1.51 %),1629,7919630,4861.65,1572,6932430,4410,987200
2017-12-12,39.7 ( -1.24 %),3263,10922440,3347.36,2134,9984800,4679,937640
2017-12-11,40.2 ( -2.43 %),1861,5434660,2920.29,1548,5868310,3791,-433650
2017-12-08,41.2 ( -1.79 %),2087,5307660,2543.2,1577,6875460,4360,-1567800
2017-12-07,41.95 ( -0.71 %),2005,6057680,3021.29,2006,6248420,3115,-190740
2017-12-06,42.25 ( 1.56 %),3616,11251760,3111.66,2515,9862270,3921,1389490
2017-12-05,41.6 ( -0.95 %),3208,8437140,2630.03,2246,9119860,4060,-682720
2017-12-04,42 ( 1.2 %),2320,6974090,3006.07,1900,6150880,3237,823210
2017-12-01,41.5 ( 0.73 %),2270,7331430,3229.7,1963,8219280,4187,-887850
2017-11-30,41.2 ( 4.83 %),4517,17900850,3963,4021,18834010,4684,-933160
2017-11-29,39.3 ( -0.25 %),1889,5791070,3065.68,1467,6458570,4403,-667500
2017-11-28,39.4 ( 0.38 %),1573,6295610,4002.29,1929,8612400,4465,-2316790
2017-11-27,39.25 ( 0.38 %),1858,7755920,4174.34,1927,9849790,5111,-2093870
2017-11-24,39.1 ( 2.36 %),2141,9628050,4496.99,3224,11663130,3618,-2035080
2017-11-23,38.2 ( -0.26 %),1687,6506840,3857.05,2641,11307270,4281,-4800430
2017-11-22,38.3 ( 2 %),1571,7127120,4536.68,2055,10441680,5081,-3314560
2017-11-21,37.55 ( 0.4 %),2005,7137980,3560.09,1684,6339670,3765,798310
2017-11-20,37.4 ( -2.09 %),2942,7927390,2694.56,1390,7198530,5179,728860
2017-11-17,38.2 ( -1.16 %),2079,4541940,2184.68,1634,5994100,3668,-1452160
2017-11-16,38.65 ( -0.26 %),1905,5084510,2669.03,2283,9109410,3990,-4024900
2017-11-15,38.75 ( 3.61 %),2636,9321900,3536.38,2839,10284960,3623,-963060
2017-11-14,37.4 ( 2.05 %),1678,5855910,3489.82,1617,5248560,3246,607350
2017-11-13,36.65 ( -1.61 %),1627,4077280,2506.01,1167,4028490,3452,48790
2017-11-10,37.25 ( 0.54 %),1139,4440470,3898.57,1199,4127540,3442,312930
2017-11-09,37.05 ( 0 %),1131,4441300,3926.88,1350,4694260,3477,-252960
2017-11-08,37.05 ( 0.41 %),1630,9805610,6015.71,1907,7205140,3778,2600470
2017-11-07,36.9 ( 0 %),1063,5002820,4706.32,1475,6110540,4143,-1107720
2017-11-06,36.9 ( 1.93 %),1715,5071940,2957.4,1536,4320380,2813,751560
2017-11-03,36.2 ( 4.02 %),1818,9656390,5311.55,1554,5958750,3834,3697640
2017-11-02,34.8 ( -2.52 %),2232,6431830,2881.64,1762,7200020,4086,-768190
2017-11-01,35.7 ( -3.51 %),2539,9711860,3825.07,1596,8599990,5388,1111870
2017-10-31,37 ( 0.54 %),1691,6156920,3640.99,1441,5351300,3714,805620
2017-10-30,36.8 ( -2.39 %),1615,4878550,3020.77,1395,4956410,3553,-77860
2017-10-27,37.7 ( 1.89 %),1273,4024960,3161.79,1298,3707650,2856,317310
2017-10-26,37 ( -0.94 %),1864,4421070,2371.82,1126,4707950,4181,-286880
2017-10-25,37.35 ( -0.4 %),1205,3008740,2496.88,1007,3521450,3497,-512710
2017-10-24,37.5 ( 1.08 %),1697,4244930,2501.43,1061,4031200,3799,213730
2017-10-23,37.1 ( -0.93 %),2075,5636620,2716.44,1429,5689000,3981,-52380
2017-10-20,37.45 ( -0.93 %),3726,9169130,2460.85,1619,7654890,4728,1514240
2017-10-19,37.8 ( -1.56 %),3210,8981650,2798.02,1224,6173580,5044,2808070
2017-10-18,38.4 ( -1.54 %),2758,5064710,1836.37,1489,6951300,4668,-1886590
2017-10-17,39 ( 2.63 %),2588,7055940,2726.41,1489,5994900,4026,1061040
2017-10-16,38 ( -2.44 %),4003,7744120,1934.58,1643,8010730,4876,-266610
2017-10-13,38.95 ( -1.39 %),2189,5578750,2548.54,1358,6356890,4681,-778140
2017-10-12,39.5 ( -0.13 %),2037,9788700,4805.45,1974,9578610,4852,210090
2017-10-11,39.55 ( -0.38 %),1330,4279140,3217.4,1249,4780750,3828,-501610
2017-10-10,39.7 ( 0.63 %),887,3115020,3511.86,1045,3541350,3389,-426330
2017-10-09,39.45 ( 1.54 %),961,3901810,4060.16,1039,3330570,3206,571240
2017-10-06,38.85 ( 0.13 %),1995,5373530,2693.5,1185,4716070,3980,657460
2017-10-05,38.8 ( -2.14 %),2151,8207780,3815.8,1394,8406810,6031,-199030
2017-10-04,39.65 ( 2.19 %),1281,5538920,4323.9,1368,4289590,3136,1249330
2017-10-03,38.8 ( -0.64 %),1711,6850440,4003.76,1496,7039230,4705,-188790
2017-10-02,39.05 ( 0.39 %),1783,8702380,4880.75,1653,7705160,4661,997220
2017-09-29,38.9 ( 3.05 %),1624,9754130,6006.24,2517,10669470,4239,-915340
2017-09-28,37.75 ( 0.13 %),1116,4047820,3627.08,1506,9324020,6191,-5276200
2017-09-27,37.7 ( 0.8 %),1242,3679770,2962.78,889,3511410,3950,168360
2017-09-26,37.4 ( -0.27 %),2109,6624450,3141.04,1057,7541680,7135,-917230
2017-09-25,37.5 ( -0.53 %),1422,3324380,2337.82,837,3892050,4650,-567670
2017-09-22,37.7 ( 0.53 %),1896,6356340,3352.5,1174,5271990,4491,1084350
2017-09-21,37.5 ( -1.06 %),2418,6834400,2826.47,1391,6724420,4834,109980
2017-09-20,37.9 ( -0.26 %),2034,6094300,2996.21,1251,4783340,3824,1310960
2017-09-19,38 ( 0.93 %),2624,8246020,3142.54,1534,8935420,5825,-689400
2017-09-18,37.65 ( 1.76 %),2381,7537800,3165.81,1447,8702470,6014,-1164670
2017-09-15,37 ( 0.82 %),1821,10147380,5572.42,1256,6922930,5512,3224450
2017-09-14,36.7 ( -0.54 %),1788,5660560,3165.86,1562,8445210,5407,-2784650
2017-09-13,36.9 ( 4.09 %),2134,12664920,5934.83,1908,10781100,5650,1883820
2017-09-12,35.45 ( 0.42 %),1530,5735270,3748.54,1075,5726100,5327,9170
2017-09-11,35.3 ( -1.81 %),1201,4003320,3333.32,1392,5057810,3633,-1054490
2017-09-08,35.95 ( 1.27 %),1464,7310820,4993.73,1668,7141500,4281,169320
2017-09-07,35.5 ( -1.39 %),2014,7193080,3571.54,2319,9746240,4203,-2553160
2017-09-06,36 ( 1.69 %),1791,9896760,5525.83,2025,9760560,4820,136200
2017-09-05,35.4 ( 0.85 %),1185,5588070,4715.67,1709,5001640,2927,586430
2017-09-01,35.1 ( 0.14 %),1064,4631760,4353.16,1732,4788980,2765,-157220
2017-08-31,35.05 ( 0.57 %),1354,6647570,4909.58,2174,9416170,4331,-2768600
2017-08-30,34.85 ( 1.16 %),1197,5904770,4932.97,2152,6953450,3231,-1048680
2017-08-29,34.45 ( 0.15 %),1536,7444920,4846.95,2316,12226850,5279,-4781930
2017-08-28,34.4 ( 1.47 %),1506,8135430,5402.01,2625,9999640,3809,-1864210
2017-08-25,33.9 ( 0.59 %),1338,10652580,7961.57,2842,11750610,4135,-1098030
2017-08-24,33.7 ( 0.6 %),866,5732610,6619.64,1257,8683180,6908,-2950570
2017-08-23,33.5 ( 0.75 %),799,4829410,6044.32,709,5674690,8004,-845280
2017-08-22,33.25 ( 0.45 %),1113,5282890,4746.53,1207,5442850,4509,-159960
2017-08-21,33.1 ( -1.93 %),1261,4453450,3531.68,1286,6834470,5315,-2381020
2017-08-18,33.75 ( 0.3 %),1071,5599760,5228.53,1511,5978240,3956,-378480
2017-08-17,33.65 ( -1.75 %),1115,4525580,4058.82,1353,5924550,4379,-1398970
2017-08-16,34.25 ( 2.24 %),1960,10788540,5504.36,2075,11171000,5384,-382460
2017-08-15,33.5 ( -1.47 %),2157,7222160,3348.24,2330,10500320,4507,-3278160
2017-08-14,34 ( 3.98 %),2257,10381690,4599.77,2669,9294260,3482,1087430
2017-08-11,32.7 ( 2.19 %),1101,4958470,4503.61,1642,6067530,3695,-1109060
2017-08-10,32 ( 0.47 %),1070,3328330,3110.59,534,5723670,10718,-2395340
2017-08-09,31.85 ( -1.39 %),1595,3668270,2299.86,810,7567490,9343,-3899220
2017-08-08,32.3 ( 0.16 %),923,2019330,2187.79,910,3873670,4257,-1854340
2017-08-07,32.25 ( 0.78 %),1061,2556260,2409.29,781,3497250,4478,-940990
2017-08-04,32 ( -0.93 %),930,2438880,2622.45,804,2807730,3492,-368850
2017-08-03,32.3 ( 0 %),846,2079650,2458.22,712,2835720,3983,-756070
2017-08-02,32.3 ( -1.22 %),956,3154140,3299.31,919,4130510,4495,-976370
2017-08-01,32.7 ( 1.24 %),1029,6176540,6002.47,1578,6050660,3834,125880
2017-07-31,32.3 ( -0.46 %),1564,4616000,2951.41,1122,4386140,3909,229860
2017-07-28,32.45 ( 0 %),950,2285460,2405.75,866,3027250,3496,-741790
2017-07-27,32.45 ( -1.07 %),1023,2330640,2278.24,1049,3515990,3352,-1185350
2017-07-26,32.8 ( 2.5 %),0,0,0,0,0,0,0
2017-07-25,32 ( 1.27 %),1062,4153880,3911.37,935,3510670,3755,643210
2017-07-24,31.6 ( 0.64 %),1138,5203580,4572.57,978,4636470,4741,567110
2017-07-21,31.4 ( -0.79 %),1271,6572650,5171.24,1020,6045610,5927,527040
2017-07-20,31.65 ( -0.47 %),2079,11046960,5313.59,1505,7504800,4987,3542160
2017-07-19,31.8 ( -0.78 %),1632,5177370,3172.41,1327,6363810,4796,-1186440
2017-07-18,32.05 ( -2.44 %),3744,11759100,3140.79,1830,10668940,5830,1090160
2017-07-17,32.85 ( -2.52 %),2131,7832210,3675.37,1687,7965390,4722,-133180
2017-07-14,33.7 ( 0.3 %),1841,7096430,3854.66,2506,7937940,3168,-841510
2017-07-13,33.6 ( 1.82 %),1094,5983440,5469.32,1193,4202980,3523,1780460
2017-07-12,33 ( 0.3 %),1170,8867160,7578.77,1653,5863750,3547,3003410
2017-07-11,32.9 ( -0.6 %),1797,8310040,4624.4,1678,9490480,5656,-1180440
2017-07-10,33.1 ( 0.3 %),1868,7950040,4255.91,1843,8639880,4688,-689840
2017-07-07,33 ( -0.9 %),1825,7716440,4228.19,1725,8188420,4747,-471980
2017-07-06,33.3 ( 1.22 %),1899,8781860,4624.47,1675,9560080,5708,-778220
2017-07-05,32.9 ( -0.3 %),1820,5943530,3265.68,1489,6560060,4406,-616530
2017-07-04,33 ( 0 %),2271,8010060,3527.11,1882,9217790,4898,-1207730
2017-07-03,33 ( 3.12 %),3321,13086030,3940.39,3296,13436420,4077,-350390
2017-06-30,32 ( 2.73 %),2083,9634560,4625.33,2808,10701810,3811,-1067250
2017-06-29,31.15 ( 1.47 %),1748,7462820,4269.35,2163,7322750,3385,140070
2017-06-28,30.7 ( 0.16 %),1293,3600010,2784.23,878,3926760,4472,-326750
2017-06-27,30.65 ( -0.65 %),939,4050260,4313.38,1202,4559010,3793,-508750
2017-06-26,30.85 ( 0.16 %),1220,3770040,3090.2,1231,4922010,3998,-1151970
2017-06-23,30.8 ( 0.16 %),1281,5624480,4390.69,1064,4627250,4349,997230
2017-06-22,30.75 ( 0.49 %),1117,3732820,3341.83,1237,4225200,3416,-492380
2017-06-21,30.6 ( -0.97 %),1577,6016510,3815.16,1237,6259880,5061,-243370
2017-06-20,30.9 ( 1.31 %),1509,6255380,4145.38,1232,5092200,4133,1163180
2017-06-19,30.5 ( -1.13 %),2407,6947800,2886.5,1260,7313960,5805,-366160
2017-06-16,30.85 ( 1.7 %),3901,19661280,5040.06,1909,14245980,7463,5415300
2017-06-15,32.4 ( 2.37 %),1853,18737000,10111.71,5040,20293560,4026,-1556560
2017-06-14,31.65 ( 0.8 %),1290,8283140,6421.04,2405,9222620,3835,-939480
2017-06-13,31.4 ( 1.62 %),1464,7490000,5116.12,1582,5904740,3732,1585260
2017-06-12,30.9 ( -1.75 %),1828,6425160,3514.86,1887,7808790,4138,-1383630
2017-06-09,31.45 ( -0.16 %),1421,6600040,4644.64,2137,8186970,3831,-1586930
2017-06-08,31.5 ( 0.32 %),2137,9282030,4343.49,2990,10179780,3405,-897750
2017-06-07,31.4 ( 2.95 %),2489,13253320,5324.76,4023,13722970,3411,-469650
2017-06-06,30.5 ( 1.84 %),1942,11034670,5682.12,2300,10326310,4490,708360
2017-06-05,29.95 ( -0.17 %),1844,6867590,3724.29,1845,8689430,4710,-1821840
2017-06-02,30 ( -0.99 %),1634,4762930,2914.89,1578,6506610,4123,-1743680
2017-06-01,30.3 ( -0.33 %),2003,5514250,2753,2446,8939560,3655,-3425310
2017-05-31,30.4 ( 3.58 %),2740,13205350,4819.47,3250,13103980,4032,101370
2017-05-30,29.35 ( -1.51 %),1431,5074650,3546.23,1527,7024000,4600,-1949350
2017-05-29,29.8 ( 2.05 %),1768,7609150,4303.82,2413,8076200,3347,-467050
2017-05-26,29.2 ( -0.51 %),971,3075680,3167.54,1142,3805440,3332,-729760
2017-05-25,29.35 ( 0 %),1125,3384130,3008.12,1555,4750130,3055,-1366000
2017-05-24,29.35 ( 1.03 %),1293,6889640,5328.41,1845,5367530,2909,1522110
2017-05-23,29.05 ( 0.52 %),1175,5352640,4555.44,1541,5761360,3739,-408720
2017-05-22,28.9 ( 0.7 %),1378,3774570,2739.17,1365,5107780,3742,-1333210
2017-05-19,28.7 ( 0.7 %),2120,4960220,2339.73,1268,4526830,3570,433390
2017-05-18,28.5 ( -1.89 %),2465,5512580,2236.34,1416,6486550,4581,-973970
2017-05-17,29.05 ( 0.17 %),1749,4303360,2460.47,1185,4430060,3738,-126700
2017-05-16,29 ( -1.69 %),2680,7799640,2910.31,1618,8933550,5521,-1133910
2017-05-15,29.5 ( -0.67 %),1625,5076020,3123.7,1246,6538930,5248,-1462910
2017-05-12,29.7 ( -1.49 %),2088,4865000,2329.98,1568,6402470,4083,-1537470
2017-05-11,30.15 ( 0.5 %),1398,5596840,4003.46,1865,7143160,3830,-1546320
2017-05-10,30 ( 1.01 %),1415,5666180,4004.37,2174,7065200,3250,-1399020
2017-05-09,29.7 ( 1.89 %),1984,7219730,3638.98,2006,7456890,3717,-237160
2017-05-08,29.15 ( -0.17 %),1130,4987090,4413.35,1256,5478610,4362,-491520
2017-05-05,29.2 ( 0 %),1190,4153210,3490.09,1174,4300000,3663,-146790
2017-05-04,29.2 ( 0.34 %),1363,5092270,3736.07,1303,4533120,3479,559150
2017-05-03,29.1 ( -1.02 %),1444,4383420,3035.61,1273,4542470,3568,-159050
2017-04-28,29.4 ( -0.34 %),2162,10833410,5010.83,1251,10797580,8631,35830
2017-04-27,29.5 ( 1.03 %),3083,12259810,3976.58,2233,10761430,4819,1498380
2017-04-26,29.2 ( -2.01 %),3541,8055100,2274.81,1712,6834510,3992,1220590
2017-04-25,29.8 ( -0.83 %),1769,5089370,2876.98,1064,4993240,4693,96130
2017-04-24,30.05 ( -1.31 %),1493,3921100,2626.32,1344,4731030,3520,-809930
2017-04-21,30.45 ( 0 %),1578,3859190,2445.62,1110,3666370,3303,192820
2017-04-20,30.45 ( -1.62 %),1299,3344340,2574.55,1183,4630510,3914,-1286170
2017-04-19,30.95 ( 2.31 %),2112,6736720,3189.73,1295,6695390,5170,41330
2017-04-18,30.25 ( -0.82 %),2511,7999360,3185.73,1086,8381030,7717,-381670
2017-04-17,30.5 ( -1.29 %),2171,6266440,2886.43,1373,8376910,6101,-2110470
2017-04-14,30.9 ( -1.9 %),2919,6831330,2340.3,1426,7952000,5576,-1120670
2017-04-13,31.5 ( -0.32 %),1739,4530010,2604.95,1195,5580830,4670,-1050820
2017-04-12,31.6 ( -0.94 %),2157,5511360,2555.1,1613,8143450,5049,-2632090
2017-04-11,31.9 ( -0.16 %),1345,4443490,3303.71,1525,5921960,3883,-1478470
2017-04-10,31.95 ( 0.31 %),1735,5940420,3423.87,1741,7389130,4244,-1448710
2017-04-07,31.85 ( 1.27 %),2102,7360170,3501.51,2072,7113350,3433,246820
2017-04-05,31.45 ( -2.63 %),3098,6931160,2237.3,2423,8346820,3445,-1415660
2017-04-04,32.3 ( 1.1 %),4496,11555560,2570.19,2919,12216920,4185,-661360
2017-04-03,31.95 ( 4.58 %),3752,8157230,2174.1,1726,5906530,3422,2250700
2017-03-31,30.55 ( 2 %),3230,5870850,1817.6,1503,5168140,3439,702710
2017-03-30,29.95 ( 3.51 %),5891,12644240,2146.37,2030,12114800,5968,529440
2017-03-29,43.4 ( 1.05 %),1835,9354670,5097.91,2619,8795320,3358,559350
2017-03-28,42.95 ( -0.23 %),1640,5373870,3276.75,1635,5339400,3266,34470
2017-03-27,43.05 ( 0 %),1535,5160360,3361.8,1718,5744830,3344,-584470
2017-03-24,43.05 ( 0.7 %),1611,5296850,3287.93,1619,4777260,2951,519590
2017-03-23,42.75 ( 0.83 %),1393,4241020,3044.52,1515,4618500,3049,-377480
2017-03-22,42.4 ( -1.05 %),1912,4236480,2215.73,1916,5176590,2702,-940110
2017-03-21,42.85 ( 2.39 %),2595,6382740,2459.63,2201,6950290,3158,-567550
2017-03-20,41.85 ( 1.33 %),938,1996160,2128.1,946,1950320,2062,45840
2017-03-17,41.3 ( -1.2 %),1820,12272700,6743.24,1148,5699010,4964,6573690
2017-03-16,41.8 ( 0.6 %),1035,1720270,1662.1,921,1930160,2096,-209890
2017-03-15,41.55 ( -1.19 %),1475,3512570,2381.4,1181,3858410,3267,-345840
2017-03-14,42.05 ( -0.12 %),916,2764260,3017.75,1146,3465260,3024,-701000
2017-03-13,42.1 ( 0 %),1174,3282170,2795.72,1299,3771700,2904,-489530
2017-03-10,42.1 ( 0.24 %),2103,7669390,3646.88,2926,10711680,3661,-3042290
2017-03-09,42 ( 1.82 %),1571,6208880,3952.18,2814,7801150,2772,-1592270
2017-03-08,41.25 ( 0.12 %),987,2934810,2973.47,1127,3989110,3540,-1054300
2017-03-07,41.2 ( 0 %),1097,2982950,2719.19,1392,3362390,2416,-379440
2017-03-06,41.2 ( 0.49 %),1477,4084160,2765.17,1584,3953500,2496,130660
2017-03-03,41 ( -2.38 %),1460,3022030,2069.88,1442,3857430,2675,-835400
2017-03-02,42 ( 2.69 %),3054,11504670,3767.08,3078,11738790,3814,-234120
2017-03-01,40.9 ( 2.25 %),2771,5931790,2140.67,1616,4951390,3064,980400
2017-02-28,40 ( -0.62 %),1958,3709880,1894.73,1165,3824710,3283,-114830
2017-02-27,40.25 ( -0.49 %),2777,6112700,2201.19,1618,5660530,3498,452170
2017-02-24,40.45 ( -0.37 %),2095,4808970,2295.45,1362,4301060,3158,507910
2017-02-23,40.6 ( 1 %),3337,8426510,2525.18,2048,7111630,3472,1314880
2017-02-22,40.2 ( -4.85 %),5451,11147510,2045.04,2680,12290570,4586,-1143060
2017-02-21,42.25 ( 0.6 %),3006,7547050,2510.66,1716,6479060,3776,1067990
2017-02-20,42 ( -5.19 %),7132,19581940,2745.64,3563,19354570,5432,227370
2017-02-17,44.3 ( -0.89 %),2621,8028120,3063,1674,7806530,4663,221590
2017-02-16,44.7 ( -1 %),1768,8202870,4639.63,1675,7531070,4496,671800
2017-02-15,45.15 ( 0.11 %),1965,6729730,3424.8,1701,6198500,3644,531230
2017-02-14,45.1 ( 0.78 %),1893,7520210,3972.64,1992,7160060,3594,360150
2017-02-13,44.75 ( 0.9 %),1248,4544770,3641.64,1335,4136110,3098,408660
2017-02-10,44.35 ( -0.45 %),1732,5715430,3299.9,1589,8563780,5389,-2848350
2017-02-09,44.55 ( -0.22 %),2306,7618200,3303.64,2046,9307780,4549,-1689580
2017-02-08,44.65 ( 0.11 %),1909,5527680,2895.59,1842,7240620,3931,-1712940
2017-02-07,44.6 ( 1.13 %),3037,11849590,3901.74,2981,12392490,4157,-542900
2017-02-06,44.1 ( 2.08 %),1684,7407880,4398.98,2331,6819790,2926,588090
2017-02-03,43.2 ( 1.17 %),2440,7536660,3088.8,2751,10571000,3843,-3034340
2017-02-02,42.7 ( 0.95 %),965,3733400,3868.81,850,2353500,2769,1379900
2017-01-25,42.3 ( 0.71 %),643,1917990,2982.88,576,1724400,2994,193590
2017-01-24,42 ( 0 %),758,3166600,4177.57,536,1891080,3528,1275520
2017-01-23,42 ( -0.47 %),533,2563950,4810.41,771,2279780,2957,284170
2017-01-20,42.2 ( 1.81 %),853,2715820,3183.85,883,1954330,2213,761490
2017-01-19,41.45 ( -0.36 %),1013,4400780,4344.3,1084,3068470,2831,1332310
2017-01-18,41.6 ( -0.95 %),914,3703430,4051.89,1148,4031560,3512,-328130
2017-01-17,42 ( 0 %),1399,4355690,3113.43,1079,3685610,3416,670080
2017-01-16,42 ( -2.78 %),2572,5103850,1984.39,1353,7418320,5483,-2314470
2017-01-13,43.2 ( -1.03 %),1502,6664710,4437.22,930,3920960,4216,2743750
2017-01-12,43.65 ( -0.8 %),844,2458880,2913.36,1149,3738790,3254,-1279910
2017-01-11,44 ( 0.34 %),1173,2614030,2228.5,1107,3259430,2944,-645400
2017-01-10,43.85 ( 1.62 %),1150,5086430,4422.98,1557,5133210,3297,-46780
2017-01-09,43.15 ( -0.58 %),1417,3792310,2676.29,1263,4261980,3374,-469670
2017-01-06,43.4 ( -1.59 %),2089,5962150,2854.07,2104,8162070,3879,-2199920
2017-01-05,44.1 ( 0.23 %),1455,5419940,3725.04,1431,5383160,3762,36780
2017-01-04,44 ( 0 %),1399,4668310,3336.89,1804,5810000,3221,-1141690
2017-01-03,44 ( 1.97 %),1459,5405160,3704.7,1579,4705330,2980,699830
2016-12-30,43.15 ( -0.12 %),1116,3275220,2934.78,1070,4695760,4389,-1420540
2016-12-29,43.2 ( -0.92 %),1328,3826490,2881.39,1144,4532150,3962,-705660
2016-12-28,43.6 ( 1.04 %),1691,8232630,4868.5,1487,5788420,3893,2444210
2016-12-27,43.15 ( -1.48 %),2509,9294610,3704.51,2036,9153550,4496,141060
2016-12-26,43.8 ( 1.98 %),2321,7419990,3196.89,1940,6523380,3363,896610
2016-12-23,42.95 ( 1.06 %),2162,10556890,4882.93,2223,7949030,3576,2607860
2016-12-22,42.5 ( 1.43 %),2797,11147150,3985.4,3324,10917980,3285,229170
2016-12-21,41.9 ( 1.45 %),1341,5090410,3795.98,1827,4699310,2572,391100
2016-12-20,41.3 ( -0.48 %),935,2374510,2539.58,1108,3652050,3296,-1277540
2016-12-19,41.5 ( -0.72 %),1315,3596770,2735.19,1294,5330870,4120,-1734100
2016-12-16,41.8 ( 1.21 %),1169,6638400,5678.7,2036,10105520,4963,-3467120
2016-12-15,41.3 ( -0.84 %),1142,3505290,3069.43,1227,4281670,3490,-776380
2016-12-14,41.65 ( 2.71 %),1231,4646620,3774.67,1541,4422180,2870,224440
2016-12-13,40.55 ( -0.37 %),870,4073440,4682.11,1062,3828260,3605,245180
2016-12-12,40.7 ( -0.49 %),900,3813830,4237.59,1031,3470650,3366,343180
2016-12-09,40.9 ( 0 %),1051,6205200,5904.09,965,4624930,4793,1580270
2016-12-08,40.9 ( 0.12 %),1129,3720000,3294.95,1015,4152500,4091,-432500
2016-12-07,40.85 ( -0.12 %),1820,5021480,2759.05,1089,5227220,4800,-205740
2016-12-06,40.9 ( -3.54 %),2857,7797920,2729.41,1787,8730460,4886,-932540
2016-12-05,42.4 ( 0.47 %),2988,8972070,3002.7,2632,10409680,3955,-1437610
2016-12-02,42.2 ( 1.08 %),1597,10861240,6801.03,2336,8224990,3521,2636250
2016-12-01,41.75 ( -0.83 %),1875,6321410,3371.42,2269,8641640,3809,-2320230
2016-11-30,42.1 ( 4.34 %),2173,8759780,4031.19,2394,8720250,3643,39530
2016-11-29,40.35 ( -0.86 %),2042,4726440,2314.61,1150,5211280,4532,-484840
2016-11-28,40.7 ( -2.51 %),1792,4372190,2439.84,1198,5183350,4327,-811160
2016-11-25,41.75 ( 0.12 %),1413,5901830,4176.81,1685,5783890,3433,117940
2016-11-24,41.7 ( 0.12 %),1387,5474080,3946.71,1692,6308000,3728,-833920
2016-11-23,41.65 ( -0.6 %),1263,3818110,3023.05,1388,5909130,4257,-2091020
2016-11-22,41.9 ( -0.24 %),1311,4770320,3638.69,1688,5903370,3497,-1133050
2016-11-21,42 ( 1.69 %),1660,6810170,4102.51,1531,4727680,3088,2082490
2016-11-18,41.3 ( -1.2 %),1650,7404550,4487.61,1487,6147660,4134,1256890
2016-11-17,41.8 ( -0.71 %),1477,9183260,6217.51,1832,7662600,4183,1520660
2016-11-16,42.1 ( 0.24 %),1704,8190660,4806.73,2415,7317330,3030,873330
2016-11-15,42 ( 1.94 %),2017,11429050,5666.36,3036,8064750,2656,3364300
2016-11-14,41.2 ( 0.61 %),1530,7042560,4602.98,2145,6383960,2976,658600
2016-11-11,40.95 ( -1.33 %),1714,5917250,3452.3,1698,5742590,3382,174660
2016-11-10,41.5 ( 1.34 %),1657,6010660,3627.44,2155,7562420,3509,-1551760
2016-11-09,40.95 ( -1.33 %),4846,16286280,3360.77,2921,13549040,4638,2737240
2016-11-08,41.5 ( 0.97 %),1706,8689060,5093.24,2798,8301860,2967,387200
2016-11-07,41.1 ( 3.79 %),1951,6694880,3431.51,2644,6466750,2446,228130
2016-11-04,39.6 ( 0.76 %),1227,3010120,2453.24,1146,3216670,2807,-206550
2016-11-03,39.3 ( -0.51 %),2701,6968440,2579.95,1386,4884030,3524,2084410
2016-11-02,39.5 ( -2.23 %),1868,3787480,2027.56,1078,4883800,4530,-1096320
2016-11-01,40.4 ( -0.86 %),970,2861780,2950.29,1437,3754140,2612,-892360
2016-10-31,40.75 ( -0.12 %),1140,3114190,2731.75,1573,5121840,3256,-2007650
2016-10-28,40.8 ( 3.16 %),1663,5188970,3120.25,1951,4952150,2538,236820
2016-10-27,39.55 ( 0 %),1279,2876620,2249.12,1082,3102710,2868,-226090
2016-10-26,39.55 ( -0.13 %),2107,4624220,2194.69,1363,4318410,3168,305810
2016-10-25,39.6 ( -1.49 %),2587,5513320,2131.16,1559,5933990,3806,-420670
2016-10-24,40.2 ( -1.95 %),1077,3638760,3378.61,1388,4288440,3090,-649680
2016-10-21,41 ( -0.36 %),1154,4899200,4245.41,1453,4146770,2854,752430
2016-10-20,41.15 ( -0.24 %),1245,2790940,2241.72,1588,3944120,2484,-1153180
2016-10-19,41.25 ( 1.35 %),1984,6296430,3173.6,2806,6861180,2445,-564750
2016-10-18,40.7 ( 2.26 %),2277,7447070,3270.56,2032,6103630,3004,1343440
2016-10-17,39.8 ( -1.49 %),2468,4292610,1739.31,1582,4839990,3059,-547380
2016-10-14,40.4 ( -2.18 %),2814,6610760,2349.24,2140,7925830,3704,-1315070
2016-10-13,41.3 ( 1.23 %),3094,10653370,3443.24,2182,7634360,3499,3019010
2016-10-12,40.8 ( -2.63 %),4511,8402750,1862.72,2421,11357440,4691,-2954690
2016-10-11,41.9 ( 6.89 %),4455,16114800,3617.24,2963,10891240,3676,5223560
2016-10-10,39.2 ( -4.62 %),4045,8686080,2147.36,2050,9531470,4649,-845390
2016-10-07,41.1 ( -4.2 %),6873,18560250,2700.46,2707,18137720,6700,422530
2016-10-06,42.9 ( -1.61 %),3730,9022190,2418.82,1808,9416410,5208,-394220
2016-10-05,43.6 ( -0.8 %),2629,7427040,2825.04,1056,7700680,7292,-273640
2016-10-04,43.95 ( -1.24 %),6465,16916200,2616.58,2225,18141870,8154,-1225670
2016-10-03,44.5 ( -2.63 %),3047,9052680,2971.01,1812,11914960,6576,-2862280
2016-09-30,45.7 ( -1.51 %),2839,9171500,3230.54,1474,10688100,7251,-1516600
2016-09-29,46.4 ( -0.64 %),1520,4784370,3147.61,1784,5414740,3035,-630370
2016-09-28,46.7 ( 0.97 %),1559,5594530,3588.54,2130,5728060,2689,-133530
2016-09-27,46.25 ( 0.65 %),1451,6493850,4475.43,1361,5049840,3710,1444010
2016-09-26,45.95 ( 0.11 %),1632,6099190,3737.25,1251,4346440,3474,1752750
2016-09-23,45.9 ( -0.65 %),1497,4522050,3020.74,1272,4880180,3837,-358130
2016-09-22,46.2 ( 1.32 %),1893,7307260,3860.15,1774,6714640,3785,592620
2016-09-21,45.6 ( 0.33 %),1746,5207280,2982.41,1280,4787690,3740,419590
2016-09-20,45.45 ( -0.33 %),1674,4660140,2783.84,1475,4481160,3038,178980
2016-09-19,45.6 ( 2.47 %),1936,6070550,3135.61,1793,6169990,3441,-99440
2016-09-16,44.5 ( 0.68 %),3473,20760660,5977.73,1775,11168940,6292,9591720
2016-09-15,44.2 ( 1.38 %),1186,5955920,5021.85,1780,5265590,2958,690330
2016-09-14,43.6 ( -0.23 %),1089,2790740,2562.66,896,2750390,3070,40350
2016-09-13,43.7 ( 1.63 %),1443,5780210,4005.69,1274,4601970,3612,1178240
2016-09-12,43 ( -2.93 %),1864,4782880,2565.92,1267,4735620,3738,47260
2016-09-09,44.3 ( -1.34 %),1652,4407230,2667.81,1705,5842830,3427,-1435600
2016-09-08,44.9 ( 2.05 %),2377,8348860,3512.35,2818,8081350,2868,267510
2016-09-07,44 ( 4.02 %),2168,7484550,3452.28,1844,5901000,3200,1583550
2016-09-06,42.3 ( 0.71 %),1808,6124040,3387.19,1434,5212740,3635,911300
2016-09-05,42 ( -0.94 %),2341,5368590,2293.29,1405,5582960,3974,-214370
2016-09-01,42.4 ( -0.93 %),1702,3908870,2296.63,1138,3917160,3442,-8290
2016-08-31,42.8 ( 2.15 %),1818,4950220,2722.89,1374,4383630,3190,566590
2016-08-30,41.9 ( 0.96 %),2804,5943790,2119.75,1362,5183400,3806,760390
2016-08-29,41.5 ( -2.58 %),2729,6184200,2266.1,1691,8141660,4815,-1957460
2016-08-26,42.6 ( -0.93 %),1803,3986960,2211.29,984,4245000,4314,-258040
2016-08-25,43 ( 4.11 %),3639,9603790,2639.13,1776,8205930,4620,1397860
2016-08-24,49 ( -0.61 %),2366,8287590,3502.79,2840,11433600,4026,-3146010
2016-08-23,49.3 ( 1.65 %),1370,5664480,4134.66,1540,5373430,3489,291050
2016-08-22,48.5 ( 0.62 %),1504,4663720,3100.88,1338,5128010,3833,-464290
2016-08-19,48.2 ( -1.23 %),2020,5450240,2698.14,1888,6633940,3514,-1183700
2016-08-18,48.8 ( 0.41 %),2816,6275500,2228.52,1856,7052770,3800,-777270
2016-08-17,48.6 ( 3.4 %),2642,8077520,3057.35,1893,7133400,3768,944120
2016-08-16,47 ( 1.51 %),2176,5762170,2648.06,1391,5289100,3802,473070
2016-08-15,46.3 ( 1.09 %),2389,9593640,4015.76,1213,6384450,5263,3209190
2016-08-12,45.8 ( -0.43 %),2620,7043320,2688.29,1971,8459350,4292,-1416030
2016-08-11,46 ( 1.55 %),1964,6164750,3138.87,1706,6238830,3657,-74080
2016-08-10,45.3 ( 4.62 %),2449,9897590,4041.48,2501,8101140,3239,1796450
2016-08-09,43.3 ( 1.17 %),1108,4229320,3817.08,922,3599880,3904,629440
2016-08-08,42.8 ( -0.7 %),1138,3338920,2934.02,988,3781550,3827,-442630
2016-08-05,43.1 ( 1.17 %),1807,8410970,4654.66,1338,6114010,4570,2296960
2016-08-04,42.6 ( -1.39 %),1272,4165970,3275.13,1280,5305040,4145,-1139070
2016-08-03,43.2 ( 1.17 %),1673,5094910,3045.37,1014,4352450,4292,742460
2016-08-02,42.7 ( -3.17 %),2357,8110610,3441.07,1753,9141150,5215,-1030540
2016-08-01,44.1 ( -0.9 %),1963,7772340,3959.42,1638,6722090,4104,1050250
2016-07-29,44.5 ( -0.22 %),2046,7991150,3905.74,1735,8875280,5115,-884130
2016-07-28,44.6 ( 3.24 %),2895,9411650,3251,2281,8278450,3629,1133200
2016-07-27,43.2 ( 2.13 %),2865,9874110,3446.46,2900,11054560,3812,-1180450
2016-07-26,42.3 ( 3.42 %),1603,7846450,4894.85,1901,7855780,4132,-9330
2016-07-25,40.9 ( 1.74 %),1424,6956190,4884.96,1287,5550740,4313,1405450
2016-07-22,40.2 ( -2.43 %),2298,8196100,3566.62,1598,8234360,5153,-38260
2016-07-21,41.2 ( 0.24 %),1278,5119560,4005.92,1340,4859210,3626,260350
2016-07-20,41.1 ( -2.14 %),1403,4387970,3127.56,1180,4522980,3833,-135010
2016-07-19,42 ( -0.71 %),1818,6204160,3412.63,1898,8274600,4360,-2070440
2016-07-18,42.3 ( 4.19 %),2099,8714020,4151.51,2025,10053220,4965,-1339200
2016-07-15,40.6 ( 1 %),1738,7528160,4331.51,1371,5694680,4154,1833480
2016-07-14,40.2 ( -3.37 %),1990,6944430,3489.66,1494,7983110,5343,-1038680
2016-07-13,41.6 ( 1.22 %),1384,5843720,4222.34,1127,5246570,4655,597150
2016-07-12,41.1 ( 1.48 %),2369,9402280,3968.88,1343,7852470,5847,1549810
2016-07-11,40.5 ( -5.15 %),2061,6708930,3255.18,1395,7692750,5515,-983820
2016-07-08,42.7 ( -0.23 %),2476,8633180,3486.74,1565,8927860,5705,-294680
2016-07-07,42.8 ( 4.39 %),1938,6713470,3464.12,1359,5228720,3847,1484750
2016-07-06,41 ( 1.99 %),1646,8449050,5133.08,1454,6569550,4518,1879500
2016-07-05,40.2 ( 0.75 %),1516,7805660,5148.85,1507,7453680,4946,351980
2016-07-04,39.9 ( 0.25 %),1507,6054210,4017.39,1232,7932570,6439,-1878360
2016-07-01,39.8 ( 0.51 %),1626,9000570,5535.41,1440,8654010,6010,346560
2016-06-30,39.6 ( 0.76 %),1298,7002880,5395.13,1556,6152830,3954,850050
2016-06-29,39.3 ( 1.55 %),1287,6786930,5273.45,1475,6983420,4735,-196490
2016-06-28,38.7 ( -0.77 %),903,4006320,4436.68,724,3730210,5152,276110
2016-06-27,39 ( 0.52 %),1398,6863550,4909.55,1053,5163020,4903,1700530
2016-06-24,38.8 ( -3.24 %),4034,18817940,4664.83,2547,18971470,7449,-153530
2016-06-23,40.1 ( 1.26 %),1260,6937730,5506.13,1197,5887780,4919,1049950
2016-06-22,39.6 ( 1.02 %),1036,5234760,5052.86,1279,4393630,3435,841130
2016-06-21,39.2 ( 2.08 %),1093,5224420,4779.89,1605,6127760,3818,-903340
2016-06-20,38.4 ( 2.67 %),738,3251440,4405.75,895,2773450,3099,477990
2016-06-17,37.4 ( -1.84 %),1639,9400200,5735.33,1380,7883190,5712,1517010
2016-06-16,38.1 ( 0.26 %),963,5285950,5489.04,1562,5299840,3393,-13890
2016-06-15,38 ( 0.26 %),1056,3802570,3600.92,1164,4029330,3462,-226760
2016-06-14,37.9 ( 3.84 %),1518,7123290,4692.55,1440,5017260,3484,2106030
2016-06-13,36.5 ( -1.35 %),1229,4379020,3563.08,1031,4392400,4260,-13380
2016-06-10,37 ( 0.82 %),1062,3875040,3648.81,1104,4114360,3727,-239320
2016-06-09,36.7 ( -0.54 %),1266,4070580,3215.31,1174,5424230,4620,-1353650
2016-06-08,36.9 ( 1.65 %),1528,5711200,3737.7,1358,6098030,4490,-386830
2016-06-07,36.3 ( 2.54 %),1048,5066920,4834.85,1332,4487010,3369,579910
2016-06-06,35.4 ( -0.56 %),2092,9847360,4707.15,2290,11135810,4863,-1288450
2016-06-03,35.6 ( 1.14 %),1409,9892090,7020.65,1820,8925650,4904,966440
2016-06-02,35.2 ( 2.33 %),1730,9391710,5428.73,1905,7869370,4131,1522340
2016-06-01,34.4 ( 1.78 %),1529,9359370,6121.24,1790,8028680,4485,1330690
2016-05-31,33.8 ( 0 %),848,4517840,5327.64,1248,6355590,5093,-1837750
2016-05-30,33.8 ( 1.5 %),812,4908100,6044.46,1133,5102770,4504,-194670
2016-05-27,33.3 ( 0.3 %),788,2887290,3664.07,722,2738440,3793,148850
2016-05-26,33.2 ( -1.48 %),736,2637840,3584.02,737,3305520,4485,-667680
2016-05-25,33.7 ( 0 %),644,2733310,4244.27,955,3789410,3968,-1056100
2016-05-24,33.7 ( 0 %),592,2149650,3631.17,994,3994740,4019,-1845090
2016-05-23,33.7 ( 1.51 %),438,2021620,4615.57,659,2201340,3340,-179720
2016-05-20,33.2 ( 0 %),697,3271040,4693.03,602,2590770,4304,680270
2016-05-19,33.2 ( 0.3 %),769,2919340,3796.28,719,3389450,4714,-470110
2016-05-18,33.1 ( -1.49 %),753,2567870,3410.19,844,3587430,4251,-1019560
2016-05-17,33.6 ( 1.2 %),784,2480590,3164.02,739,2545280,3444,-64690
2016-05-16,33.2 ( -0.3 %),920,3966950,4311.9,770,3457300,4490,509650
2016-05-13,33.3 ( -2.06 %),1531,5791020,3782.51,1217,5802150,4768,-11130
2016-05-12,34 ( -1.45 %),807,3054250,3784.7,956,3835010,4012,-780760
2016-05-11,34.5 ( 2.99 %),1104,4192320,3797.39,1140,4071250,3571,121070
2016-05-10,33.5 ( -1.18 %),1591,7671230,4821.64,1353,6885390,5089,785840
2016-05-09,33.9 ( -0.29 %),1163,6036360,5190.34,1263,5894920,4667,141440
2016-05-06,34 ( -2.86 %),1877,5999240,3196.19,1430,7073470,4946,-1074230
2016-05-05,35 ( 0 %),3241,13591870,4193.73,2506,11577570,4620,2014300
2016-05-04,35 ( 4.48 %),2876,12356340,4296.36,1945,8961610,4608,3394730
2016-04-29,33.5 ( 3.08 %),1196,7368750,6161.16,1179,5304550,4499,2064200
2016-04-28,32.5 ( -0.61 %),793,3831300,4831.4,739,3355340,4540,475960
2016-04-27,32.7 ( -0.91 %),971,4088530,4210.64,967,4125240,4266,-36710
2016-04-26,33 ( 0 %),1142,5963050,5221.58,1038,5164020,4975,799030
2016-04-25,33 ( 0.92 %),1094,5780130,5283.48,1434,5818870,4058,-38740
2016-04-22,32.7 ( 3.81 %),1572,8391860,5338.33,1502,6341620,4222,2050240
2016-04-21,31.5 ( 0.96 %),1069,6033900,5644.43,1232,5830450,4733,203450
2016-04-20,31.2 ( 0.97 %),973,4575200,4702.16,946,5466700,5779,-891500
2016-04-19,30.9 ( -1.28 %),714,4078000,5711.48,861,5236050,6081,-1158050
2016-04-15,31.3 ( -0.32 %),776,4112040,5299.02,918,4787260,5215,-675220
2016-04-14,31.4 ( 0.96 %),799,3474260,4348.26,1192,5177940,4344,-1703680
2016-04-13,31.1 ( -1.89 %),1121,4258930,3799.22,1240,5631830,4542,-1372900
2016-04-12,31.7 ( 0.63 %),971,4212940,4338.76,1054,4752710,4509,-539770
2016-04-11,31.5 ( 2.27 %),1627,6977070,4288.3,1249,7867710,6299,-890640
2016-04-08,30.8 ( 2.33 %),1973,10527950,5336.01,1599,9755820,6101,772130
2016-04-07,30.1 ( -0.33 %),808,3146740,3894.48,1079,4577070,4242,-1430330
2016-04-06,30.2 ( 3.07 %),568,3068380,5402.08,749,2588680,3456,479700
2016-04-05,29.3 ( 0.34 %),260,939360,3612.92,408,1396630,3423,-457270
2016-04-04,29.2 ( 0.69 %),342,1572260,4597.25,477,1924740,4035,-352480
2016-04-01,29 ( -1.69 %),746,2142200,2871.58,499,2502940,5016,-360740
2016-03-31,29.5 ( 0 %),729,3493100,4791.63,956,4980870,5210,-1487770
2016-03-30,29.5 ( -1.01 %),449,2380480,5301.74,655,3146650,4804,-766170
2016-03-29,29.8 ( -0.33 %),605,3025510,5000.84,1072,4088730,3814,-1063220
2016-03-28,29.9 ( 3.1 %),589,2952590,5012.89,748,2280540,3049,672050
2016-03-25,29 ( 0.69 %),716,3559750,4971.72,657,2801110,4263,758640
2016-03-24,28.8 ( -1.71 %),755,2384350,3158.08,626,3221550,5146,-837200
2016-03-23,29.3 ( -0.68 %),903,2638410,2921.83,630,2831090,4494,-192680
2016-03-22,29.5 ( -1.01 %),647,2810730,4344.25,689,3182250,4619,-371520
2016-03-21,29.8 ( 0.34 %),515,2168720,4211.11,836,3407720,4076,-1239000
2016-03-18,29.7 ( -1 %),1052,5383860,5117.74,937,4873060,5201,510800
2016-03-17,30 ( 0.33 %),714,2833360,3968.29,932,4458190,4783,-1624830
2016-03-16,29.9 ( -0.33 %),622,2393070,3847.38,694,3284960,4733,-891890
2016-03-15,30 ( 0 %),1187,4175630,3517.8,1172,4602880,3927,-427250
2016-03-14,30 ( 4.17 %),1350,6251000,4630.37,1484,5668610,3820,582390
2016-03-11,28.8 ( 0.7 %),791,3898610,4928.71,991,4463400,4504,-564790
2016-03-10,28.6 ( 0.35 %),584,1887230,3231.56,544,2346380,4313,-459150
2016-03-09,28.5 ( -1.38 %),769,3394590,4414.29,1184,5479820,4628,-2085230
2016-03-08,28.9 ( 3.96 %),1900,11648470,6130.77,2026,9682410,4779,1966060
2016-03-07,27.8 ( 1.09 %),786,3204930,4077.52,934,4265010,4566,-1060080
2016-03-04,27.5 ( 1.85 %),480,1637800,3412.08,508,1604190,3158,33610
2016-03-03,27 ( -0.74 %),457,1103540,2414.75,326,1452130,4454,-348590
2016-03-02,27.2 ( -0.73 %),1012,2693210,2661.27,535,2845700,5319,-152490
2016-03-01,27.4 ( -1.79 %),559,1277180,2284.76,454,1693640,3730,-416460
2016-02-29,27.9 ( -1.76 %),490,1403090,2863.45,714,2961530,4148,-1558440
2016-02-26,28.4 ( 4.03 %),587,2951740,5028.52,791,2580960,3263,370780
2016-02-25,27.3 ( 0.37 %),431,1494040,3466.45,606,2027640,3346,-533600
2016-02-24,27.2 ( 0 %),385,1115930,2898.52,305,1120240,3673,-4310
2016-02-23,27.2 ( 0 %),501,1209790,2414.75,428,1754590,4100,-544800
2016-02-22,27.2 ( 0.74 %),414,1565320,3780.97,422,1691490,4008,-126170
2016-02-19,27 ( 0.75 %),239,1058250,4427.82,278,954000,3432,104250
2016-02-18,26.8 ( 0.37 %),197,818180,4153.2,370,1550430,4190,-732250
2016-02-17,26.7 ( 0 %),298,986670,3310.97,360,1439430,3998,-452760
2016-02-16,26.7 ( 1.14 %),249,921480,3700.72,211,1350010,6398,-428530
2016-02-15,26.4 ( -2.22 %),447,1570890,3514.3,253,1739280,6875,-168390
2016-02-05,27 ( 0 %),123,448420,3645.69,153,355190,2322,93230
2016-02-04,27 ( 0.75 %),123,295030,2398.62,204,470970,2309,-175940
2016-02-03,26.8 ( 0 %),354,1972970,5573.36,275,1651390,6005,321580
2016-02-02,26.8 ( 0.37 %),259,930000,3590.73,227,582000,2564,348000
2016-02-01,26.7 ( -2.91 %),326,1104130,3386.9,406,1890260,4656,-786130
2016-01-29,27.5 ( 3.77 %),285,1483060,5203.72,440,1342680,3052,140380
2016-01-28,26.5 ( -1.12 %),309,1365890,4420.36,333,1318590,3960,47300
2016-01-27,26.8 ( 1.52 %),425,2193990,5162.33,339,1754240,5175,439750
2016-01-26,26.4 ( -2.94 %),551,2464130,4472.11,418,2396660,5734,67470
2016-01-25,27.2 ( 6.25 %),544,2969380,5458.42,443,1620780,3659,1348600
2016-01-22,25.6 ( 0.39 %),566,4012800,7089.75,691,3501790,5068,511010
2016-01-21,25.5 ( 1.19 %),492,3605610,7328.48,697,2399510,3443,1206100
2016-01-20,25.2 ( 0 %),506,2822480,5578.02,582,2512800,4318,309680
2016-01-19,25.2 ( 1.61 %),689,3737690,5424.8,654,2960570,4527,777120
2016-01-18,24.8 ( -2.75 %),907,4252890,4688.96,824,3600550,4370,652340
2016-01-15,25.5 ( -3.77 %),927,3102480,3346.8,639,3426920,5363,-324440
2016-01-14,26.5 ( -3.64 %),724,2146610,2964.93,493,2527600,5127,-380990
2016-01-13,27.5 ( -1.79 %),328,969950,2957.16,392,1319670,3367,-349720
2016-01-12,28 ( 1.08 %),325,1134990,3492.28,229,632040,2760,502950
2016-01-11,27.7 ( 0 %),268,982970,3667.8,263,825340,3138,157630
2016-01-08,27.7 ( -1.77 %),581,1942740,3343.79,449,1546660,3445,396080
2016-01-07,28.2 ( -2.76 %),607,1509970,2487.59,455,1712730,3764,-202760
2016-01-06,29 ( 1.75 %),432,1545580,3577.73,318,948620,2983,596960
2016-01-05,28.5 ( -1.04 %),356,990670,2782.78,337,1037170,3078,-46500
2016-01-04,28.8 ( -1.37 %),289,779300,2696.54,310,715710,2309,63590
2015-12-31,29.2 ( -0.34 %),348,824850,2370.26,309,933630,3021,-108780
2015-12-30,29.3 ( 1.38 %),382,1261440,3302.2,346,1154080,3335,107360
2015-12-29,28.9 ( 0 %),473,1354460,2863.55,263,669480,2546,684980
2015-12-28,28.9 ( -2.03 %),547,2120570,3876.73,386,1823530,4724,297040
2015-12-25,29.5 ( 0 %),282,959630,3402.94,237,737730,3113,221900
2015-12-24,29.5 ( 0 %),237,933390,3938.35,203,516420,2544,416970
2015-12-23,29.5 ( -0.67 %),492,1451900,2951.02,310,1272090,4104,179810
2015-12-22,29.7 ( -1 %),446,1143600,2564.13,310,1022620,3299,120980
2015-12-21,30 ( -1.32 %),506,1220910,2412.87,433,1841300,4252,-620390
2015-12-18,30.4 ( 0 %),968,10200780,10538,2225,22137680,9950,-11936900
2015-12-17,30.4 ( -0.33 %),370,1229010,3321.65,445,2272340,5106,-1043330
2015-12-16,30.5 ( -0.33 %),287,1002760,3493.94,478,2514390,5260,-1511630
2015-12-15,30.6 ( 0 %),555,2749630,4954.29,587,2842560,4843,-92930
2015-12-14,30.6 ( 2.68 %),786,3132560,3985.45,867,3699870,4267,-567310
2015-12-11,29.8 ( 1.36 %),408,1586730,3889.04,415,1367010,3294,219720
2015-12-10,29.4 ( -1.34 %),683,1537770,2251.49,301,1550280,5150,-12510
2015-12-09,29.8 ( -1.65 %),399,859710,2154.66,329,1348110,4098,-488400
2015-12-08,30.3 ( 1.34 %),611,1600340,2619.21,276,1235900,4478,364440
2015-12-07,29.9 ( -1.32 %),492,1047130,2128.31,323,1135770,3516,-88640
2015-12-04,30.3 ( -0.98 %),500,1409060,2818.12,288,1424300,4945,-15240
2015-12-03,30.6 ( 0 %),329,1284360,3903.83,302,1320630,4373,-36270
2015-12-02,30.6 ( 0.99 %),440,2001810,4549.57,331,1876540,5669,125270
2015-12-01,30.3 ( -0.66 %),488,1733880,3553.03,392,1748520,4461,-14640
2015-11-30,30.5 ( -2.56 %),703,1786980,2541.93,541,2476560,4578,-689580
2015-11-27,31.3 ( -1.26 %),729,4538970,6226.3,1539,6139060,3989,-1600090
2015-11-26,31.7 ( 1.93 %),750,4204000,5605.33,1586,4919940,3102,-715940
2015-11-25,31.1 ( 3.32 %),1087,4037460,3714.31,998,3139230,3146,898230
2015-11-24,30.1 ( -0.33 %),381,1380400,3623.1,627,2111230,3367,-730830
2015-11-23,30.2 ( 1 %),491,1588650,3235.54,586,1892500,3230,-303850
2015-11-20,29.9 ( 0.34 %),520,1499980,2884.58,463,1727640,3731,-227660
2015-11-19,29.8 ( -1 %),461,910860,1975.84,378,1294660,3425,-383800
2015-11-18,30.1 ( -0.33 %),435,926070,2128.9,454,1752620,3860,-826550
2015-11-17,30.2 ( 2.03 %),1099,3504300,3188.63,738,3244490,4396,259810
2015-11-16,29.6 ( -1.66 %),745,1726790,2317.84,468,2221200,4746,-494410
2015-11-13,30.1 ( 0 %),833,2046710,2457.03,434,1991890,4590,54820
2015-11-12,30.1 ( -0.66 %),890,2436910,2738.1,542,2181470,4025,255440
2015-11-11,30.3 ( -0.66 %),533,1255820,2356.14,325,1314670,4045,-58850
2015-11-10,30.5 ( -0.65 %),616,1277780,2074.32,411,1272530,3096,5250
2015-11-09,30.7 ( -0.97 %),476,759590,1595.78,350,1096750,3134,-337160
2015-11-06,31 ( 0 %),551,1352380,2454.41,512,1718290,3356,-365910
2015-11-05,31 ( -0.32 %),507,1080130,2130.43,428,1328080,3103,-247950
2015-11-04,31.1 ( -1.27 %),746,1887370,2529.99,516,2181820,4228,-294450
2015-11-03,31.5 ( 0.96 %),667,1622030,2431.83,396,1430710,3613,191320
2015-11-02,31.2 ( -0.95 %),874,1752320,2004.94,461,2144490,4652,-392170
2015-10-30,31.5 ( 0 %),412,1444070,3505.02,465,2227060,4789,-782990
2015-10-29,31.5 ( 0.32 %),612,2216660,3621.99,617,2714200,4399,-497540
2015-10-28,31.4 ( -0.95 %),609,1365280,2241.84,608,2186740,3597,-821460
2015-10-27,31.7 ( -0.63 %),446,1181300,2648.65,637,2175960,3416,-994660
2015-10-26,31.9 ( 0.31 %),602,2132960,3543.12,1008,3392770,3366,-1259810
2015-10-23,31.8 ( 1.27 %),558,1753360,3142.22,686,2017610,2941,-264250
2015-10-22,31.4 ( 0.64 %),580,1786920,3080.9,382,1493360,3909,293560
2015-10-21,31.2 ( -0.64 %),813,1683500,2070.73,504,2196050,4357,-512550
2015-10-20,31.4 ( -1.88 %),1025,2388920,2330.65,564,2795740,4957,-406820
2015-10-19,32 ( 0 %),835,2447530,2931.17,665,3485960,5242,-1038430
2015-10-16,32 ( -0.93 %),1072,3347310,3122.49,931,4627200,4970,-1279890
2015-10-15,32.3 ( 0 %),928,3395590,3659.04,1270,5359740,4220,-1964150
2015-10-14,32.3 ( -0.31 %),549,1782350,3246.54,534,2018650,3780,-236300
2015-10-13,32.4 ( -1.22 %),535,1398960,2614.88,558,1812610,3248,-413650
2015-10-12,32.8 ( 1.23 %),770,3354380,4356.34,914,3293230,3603,61150
2015-10-09,32.4 ( 0.62 %),626,2313810,3696.18,976,2973420,3047,-659610
2015-10-08,32.2 ( 2.22 %),697,3101830,4450.26,949,2895390,3051,206440
2015-10-07,31.5 ( -1.56 %),693,2178230,3143.19,935,2871190,3071,-692960
2015-10-06,32 ( 1.91 %),927,4759550,5134.36,1310,5193420,3964,-433870
2015-10-05,31.4 ( 1.62 %),549,2198570,4004.68,741,2938530,3966,-739960
2015-10-02,30.9 ( 0.65 %),381,1588640,4169.66,868,2901030,3342,-1312390
2015-10-01,30.7 ( 0.99 %),249,723440,2905.38,366,1313540,3589,-590100
2015-09-30,30.4 ( 1 %),452,1088440,2408.05,529,1750400,3309,-661960
2015-09-29,30.1 ( -0.33 %),994,2314290,2328.26,461,2033170,4410,281120
2015-09-28,30.2 ( -2.89 %),887,2348460,2647.64,536,2445640,4563,-97180
2015-09-25,31.1 ( -0.96 %),458,1125630,2457.71,385,1189380,3089,-63750
2015-09-24,31.4 ( -0.63 %),432,1625840,3763.52,657,2845380,4331,-1219540
2015-09-23,31.6 ( -0.63 %),612,1756660,2870.36,709,3313820,4674,-1557160
2015-09-22,31.8 ( 0.32 %),522,1398030,2678.22,974,3488700,3582,-2090670
2015-09-21,31.7 ( 2.92 %),1106,4441450,4015.78,1392,4918260,3533,-476810
2015-09-18,30.8 ( 2.67 %),514,2623070,5103.25,1156,4126120,3569,-1503050
2015-09-17,30 ( 1.01 %),341,1455450,4268.18,779,1889540,2426,-434090
2015-09-16,29.7 ( 1.71 %),377,1323980,3511.88,319,934580,2930,389400
2015-09-15,29.2 ( -0.34 %),634,1345210,2121.78,281,1246650,4436,98560
2015-09-14,29.3 ( -1.35 %),787,1104840,1403.86,446,1920380,4306,-815540
2015-09-11,29.7 ( -2.3 %),909,1494830,1644.48,505,2471070,4893,-976240
2015-09-10,30.4 ( -0.98 %),622,1440670,2316.19,563,2049350,3640,-608680
2015-09-09,30.7 ( 1.66 %),773,2783830,3601.33,801,2857540,3567,-73710
2015-09-08,30.2 ( 3.42 %),674,1826560,2710.03,534,1756810,3290,69750
2015-09-07,29.2 ( -1.68 %),876,1499070,1711.27,508,2374830,4675,-875760
2015-09-04,29.7 ( -1.33 %),953,1617280,1697.04,409,2047990,5007,-430710
2015-09-03,30.1 ( -3.22 %),1171,2369390,2023.39,602,3414710,5672,-1045320
2015-09-01,31.1 ( 0 %),833,2372300,2847.9,615,3074390,4999,-702090
2015-08-31,31.1 ( -1.58 %),524,1492190,2847.69,671,2888540,4305,-1396350
2015-08-28,31.6 ( 0.96 %),968,3597450,3716.37,907,4363970,4811,-766520
2015-08-27,31.3 ( -0.63 %),988,3284140,3324.03,1030,4784380,4645,-1500240
2015-08-26,31.5 ( 5 %),1254,3830880,3054.93,935,3224320,3448,606560
2015-08-25,30 ( 6.76 %),1552,5952360,3835.28,1224,3773220,3083,2179140
2015-08-24,28.1 ( -6.95 %),1432,5230310,3652.45,1226,6093600,4970,-863290
2015-08-21,30.2 ( -2.89 %),1335,4227330,3166.54,850,3724030,4381,503300
2015-08-20,31.1 ( -2.2 %),721,1918590,2661.01,600,2121780,3536,-203190
2015-08-19,31.8 ( -0.93 %),938,2473820,2637.33,622,3752640,6033,-1278820
2015-08-18,32.1 ( 1.26 %),969,2469040,2548.03,637,3047580,4784,-578540
2015-08-17,31.7 ( -2.76 %),723,2029120,2806.53,604,2872070,4755,-842950
2015-08-14,32.6 ( -0.31 %),1235,3322100,2689.96,702,3527570,5025,-205470
2015-08-13,32.7 ( -1.8 %),1681,4143240,2464.75,789,3797380,4813,345860
2015-08-12,33.3 ( -3.48 %),1641,4491780,2737.22,918,5120770,5578,-628990
2015-08-11,34.5 ( -0.86 %),850,3197450,3761.71,1080,4057010,3756,-859560
2015-08-10,34.8 ( 2.05 %),894,3429050,3835.63,1132,5662490,5002,-2233440
2015-08-07,34.1 ( 2.71 %),1054,4998530,4742.44,1272,4101210,3224,897320
2015-08-06,33.2 ( -1.19 %),626,1759140,2810.13,747,2631510,3523,-872370
2015-08-05,33.6 ( 3.07 %),694,1969260,2837.55,728,2824680,3880,-855420
2015-08-04,32.6 ( 0.31 %),684,1723920,2520.35,638,1761190,2760,-37270
2015-08-03,32.5 ( 0 %),1481,4668250,3152.09,963,3606520,3745,1061730
2015-07-31,32.5 ( -3.27 %),1270,2996520,2359.46,784,4010300,5115,-1013780
2015-07-30,33.6 ( 0.6 %),1041,2786930,2677.17,712,2379630,3342,407300
2015-07-29,33.4 ( -2.62 %),1876,5019650,2675.72,1183,4915200,4155,104450
2015-07-28,34.3 ( -3.65 %),1478,2740710,1854.34,1218,4787670,3931,-2046960
2015-07-27,35.6 ( 2.89 %),1362,3552090,2608,1004,4222620,4206,-670530
2015-07-24,34.6 ( 4.53 %),1372,4927680,3591.6,1405,4740860,3374,186820
2015-07-23,33.1 ( -1.19 %),1006,2353610,2339.57,1285,3856970,3002,-1503360
2015-07-22,33.5 ( 6.69 %),1842,8206540,4455.23,1779,6482140,3644,1724400
2015-07-21,31.4 ( 2.95 %),1008,4216470,4183.01,1477,4338670,2937,-122200
2015-07-20,30.5 ( 0.99 %),616,2379420,3862.69,948,2723940,2873,-344520
2015-07-17,30.2 ( 2.03 %),1134,4104660,3619.63,1777,5175640,2913,-1070980
2015-07-16,29.6 ( 3.5 %),612,2424930,3962.3,658,2424680,3685,250
2015-07-15,28.6 ( -2.05 %),483,1317080,2726.87,582,2035670,3498,-718590
2015-07-14,29.2 ( 1.74 %),1093,4101010,3752.07,909,3776360,4154,324650
2015-07-13,28.7 ( -0.69 %),663,1708240,2576.53,560,2465050,4402,-756810
2015-07-10,28.9 ( -1.03 %),674,1844380,2736.47,525,2360370,4496,-515990
2015-07-09,29.2 ( -2.01 %),849,2523830,2972.71,555,2757090,4968,-233260
2015-07-08,29.8 ( -1 %),805,2415990,3001.23,1008,3698630,3669,-1282640
2015-07-07,30.1 ( 2.38 %),1075,4808350,4472.88,1317,4505340,3421,303010
2015-07-06,29.4 ( 2.44 %),664,2855940,4301.11,1004,3446600,3433,-590660
2015-07-03,28.7 ( 0.35 %),438,1614750,3686.64,795,2277450,2865,-662700
2015-07-02,28.6 ( 1.42 %),433,1463870,3380.76,581,1811230,3117,-347360
2015-07-01,28.2 ( -2.42 %),568,1413600,2488.73,732,2379850,3251,-966250
2015-06-30,28.9 ( 3.21 %),693,4432100,6395.53,1508,5146700,3413,-714600
2015-06-29,28 ( 2.56 %),373,1890050,5067.16,575,1707270,2969,182780
2015-06-26,27.3 ( -0.36 %),421,1033170,2454.09,455,1432100,3147,-398930
2015-06-25,27.4 ( -1.79 %),571,1162580,2036.04,468,1980680,4232,-818100
2015-06-24,27.9 ( -1.06 %),509,1533370,3012.51,700,2240280,3200,-706910
2015-06-23,28.2 ( 1.44 %),357,1420230,3978.24,547,1711480,3129,-291250
2015-06-22,27.8 ( 1.09 %),331,1123670,3394.77,316,1179630,3733,-55960
2015-06-19,27.5 ( -2.83 %),923,3773470,4088.27,658,3765180,5722,8290
2015-06-18,28.3 ( -0.35 %),412,1266780,3074.71,499,2042520,4093,-775740
2015-06-17,28.4 ( -1.73 %),631,2175280,3447.35,636,2745010,4316,-569730
2015-06-16,28.9 ( 0.7 %),651,2910170,4470.31,910,3164480,3477,-254310
2015-06-15,28.7 ( 0.35 %),566,2496540,4410.85,662,2690860,4065,-194320
2015-06-12,28.6 ( -0.69 %),683,2056430,3010.88,916,3362870,3671,-1306440
2015-06-11,28.8 ( 1.77 %),669,2147120,3209.45,874,2818390,3225,-671270
2015-06-10,28.3 ( 4.81 %),1310,5218800,3983.82,1233,4415810,3581,802990
2015-06-09,27 ( 3.85 %),1125,4819350,4283.87,1222,3870340,3167,949010
2015-06-08,26 ( 2.77 %),452,1808590,4001.31,492,1226280,2492,582310
2015-06-05,25.3 ( -1.56 %),893,2695070,3018,464,2393560,5159,301510
2015-06-04,25.7 ( 0.39 %),523,1631450,3119.41,368,1322640,3594,308810
2015-06-03,25.6 ( -2.66 %),717,1855570,2587.96,439,2142610,4881,-287040
2015-06-02,26.3 ( -0.38 %),375,1148770,3063.39,365,1266640,3470,-117870
2015-06-01,26.4 ( -0.75 %),247,706900,2861.94,226,819260,3625,-112360
2015-05-29,26.6 ( -0.75 %),347,766900,2210.09,265,921980,3479,-155080
2015-05-28,26.8 ( 0 %),370,763510,2063.54,276,1019000,3692,-255490
2015-05-27,26.8 ( -1.47 %),345,729440,2114.32,274,895270,3267,-165830
2015-05-26,27.2 ( 1.87 %),325,1205810,3710.18,416,1064860,2560,140950
2015-05-25,26.7 ( -0.74 %),240,440670,1836.12,275,611060,2222,-170390
2015-05-22,26.9 ( 0.75 %),284,815140,2870.21,289,1087100,3762,-271960
2015-05-21,26.7 ( 0 %),304,1027600,3380.26,415,1158020,2790,-130420
2015-05-20,26.7 ( 6.8 %),469,1710550,3647.23,450,1056630,2348,653920
2015-05-19,25 ( 0.81 %),389,1402460,3605.3,270,1065810,3947,336650
2015-05-18,24.8 ( -4.98 %),585,2030130,3470.31,467,2494500,5342,-464370
2015-05-15,26.1 ( -2.61 %),331,969430,2928.79,284,1074320,3783,-104890
2015-05-14,26.8 ( 1.9 %),682,2056730,3015.73,494,1811300,3667,245430
2015-05-13,26.3 ( -2.23 %),663,1869730,2820.11,489,1885890,3857,-16160
2015-05-12,26.9 ( -2.89 %),532,1150990,2163.52,317,1430760,4513,-279770
2015-05-11,27.7 ( -1.77 %),347,772450,2226.08,227,715570,3152,56880
2015-05-08,28.2 ( -1.05 %),734,1002490,1365.79,384,1371660,3572,-369170
2015-05-07,43.8 ( 0.69 %),451,1279390,2836.78,359,961720,2679,317670
2015-05-06,43.5 ( -1.58 %),488,1840740,3772.01,434,1665000,3836,175740
2015-05-05,44.2 ( 2.08 %),587,1692260,2882.9,403,1147210,2847,545050
2015-05-04,43.3 ( -1.59 %),543,1604140,2954.22,496,1884360,3799,-280220
2015-04-27,44 ( -1.12 %),314,976790,3110.8,317,1125790,3551,-149000
2015-04-24,44.5 ( 0 %),285,754320,2646.74,190,688250,3622,66070
2015-04-23,44.5 ( -1.33 %),515,2090150,4058.54,419,1383950,3303,706200
2015-04-22,45.1 ( 0 %),393,1937870,4930.97,653,2018550,3091,-80680
2015-04-21,45.1 ( 0 %),193,830520,4303.21,249,837950,3365,-7430
2015-04-20,45.1 ( -1.1 %),230,792840,3447.13,305,878320,2880,-85480
2015-04-17,45.6 ( 1.56 %),472,1634070,3462.01,566,1683210,2974,-49140
2015-04-16,44.9 ( -0.22 %),378,933880,2470.58,450,1419490,3154,-485610
2015-04-15,45 ( 1.58 %),654,1881360,2876.7,655,2026030,3093,-144670
2015-04-14,44.3 ( 0.23 %),185,634400,3429.19,261,771840,2957,-137440
2015-04-13,44.2 ( 0 %),190,433550,2281.84,332,574200,1730,-140650
2015-04-10,44.2 ( 0 %),329,669840,2035.99,329,816720,2482,-146880
2015-04-09,44.2 ( 0 %),290,746650,2574.66,340,969740,2852,-223090
2015-04-08,44.2 ( -0.45 %),223,534020,2394.71,268,790350,2949,-256330
2015-04-07,44.4 ( 0 %),265,764200,2883.77,219,846250,3864,-82050
2015-04-06,44.4 ( -1.11 %),264,581120,2201.21,310,705350,2275,-124230
2015-04-03,44.9 ( 1.81 %),487,1830340,3758.4,540,1752420,3245,77920
2015-04-02,44.1 ( 0.23 %),352,1148410,3262.53,251,731930,2916,416480
2015-04-01,44 ( -0.23 %),294,906630,3083.78,545,1100900,2020,-194270
2015-03-31,44.1 ( 0.23 %),336,1127050,3354.32,234,858530,3669,268520
2015-03-30,44 ( 0.23 %),282,910140,3227.45,324,1065320,3288,-155180
2015-03-27,43.9 ( 0 %),250,535240,2140.96,206,522530,2537,12710
2015-03-26,43.9 ( -0.23 %),454,1028740,2265.95,271,850370,3138,178370
2015-03-25,44 ( -0.68 %),630,1184140,1879.59,357,1458090,4084,-273950
2015-03-24,44.3 ( -1.56 %),723,1425650,1971.85,353,1397580,3959,28070
2015-03-23,45 ( -2.81 %),578,1610470,2786.28,637,2165660,3400,-555190
2015-03-20,46.3 ( 5.23 %),839,3731380,4447.41,602,2636330,4379,1095050
2015-03-19,44 ( -1.35 %),1062,2445530,2302.76,421,1951650,4636,493880
2015-03-18,44.6 ( -0.89 %),971,2010550,2070.6,440,1534520,3488,476030
2015-03-17,45 ( -0.22 %),624,1105920,1772.31,385,1222790,3176,-116870
2015-03-16,45.1 ( -3.01 %),1095,1633400,1491.69,383,1706180,4455,-72780
2015-03-13,46.5 ( -0.64 %),516,824820,1598.49,301,976020,3243,-151200
2015-03-12,46.8 ( -1.47 %),713,1181780,1657.48,317,1533970,4839,-352190
2015-03-11,47.5 ( -1.04 %),448,695890,1553.33,307,981340,3197,-285450
2015-03-10,48 ( -1.23 %),533,1156490,2169.77,543,1557530,2868,-401040
2015-03-09,48.6 ( 2.97 %),620,1846850,2978.79,900,1845880,2051,970
2015-03-06,47.2 ( -0.21 %),186,563680,3030.54,266,544300,2046,19380
2015-03-05,47.3 ( 0.42 %),288,990900,3440.62,539,1077250,1999,-86350
2015-03-04,47.1 ( 0 %),250,543330,2173.32,310,755500,2437,-212170
2015-03-03,47.1 ( 1.95 %),554,1281710,2313.56,358,1015390,2836,266320
2015-03-02,46.2 ( -1.91 %),425,961040,2261.27,329,1039570,3160,-78530
2015-02-27,47.1 ( -1.67 %),933,2359080,2528.49,455,1518920,3338,840160
2015-02-26,47.9 ( -1.03 %),479,1244990,2599.14,377,938290,2489,306700
2015-02-25,48.4 ( -1.83 %),283,645940,2282.47,290,787700,2716,-141760
2015-02-24,49.3 ( 0.2 %),232,634880,2736.55,304,642500,2113,-7620
2015-02-13,49.2 ( 0.82 %),316,494640,1565.32,403,865470,2148,-370830
2015-02-12,48.8 ( 0.83 %),325,574280,1767.02,448,736630,1644,-162350
2015-02-11,48.4 ( 4.54 %),353,780990,2212.44,424,666060,1571,114930
2015-02-10,46.3 ( 3.35 %),617,1649320,2673.13,534,1167000,2185,482320
2015-02-09,44.8 ( -2.61 %),412,608290,1476.43,279,681570,2443,-73280
2015-02-06,46 ( 2.45 %),341,553100,1621.99,309,389830,1262,163270
2015-02-05,44.9 ( -0.66 %),814,2023790,2486.23,316,1383280,4377,640510
2015-02-04,45.2 ( -3.21 %),621,1134940,1827.6,357,850730,2383,284210
2015-02-03,46.7 ( -1.68 %),483,837480,1733.91,292,628720,2153,208760
2015-02-02,47.5 ( -0.63 %),240,328840,1370.17,211,401770,1904,-72930
2015-01-30,47.8 ( -3.24 %),746,1162320,1558.07,325,1383400,4257,-221080
2015-01-29,49.4 ( -2.18 %),415,577780,1392.24,300,919510,3065,-341730
2015-01-28,50.5 ( 0 %),213,281100,1319.72,208,503730,2422,-222630
2015-01-27,50.5 ( 1.41 %),509,1483030,2913.61,285,1500070,5263,-17040
2015-01-26,49.8 ( -3.3 %),877,1573160,1793.8,336,1879190,5593,-306030
2015-01-23,51.5 ( -2.83 %),641,1548230,2415.34,341,2071620,6075,-523390
2015-01-22,53 ( -0.93 %),160,448050,2800.31,228,647990,2842,-199940
2015-01-21,53.5 ( 0.94 %),245,853890,3485.27,332,979060,2949,-125170
2015-01-20,53 ( 0.95 %),183,312800,1709.29,171,392100,2293,-79300
2015-01-19,52.5 ( -0.94 %),173,510730,2952.2,218,730950,3353,-220220
2015-01-16,53 ( -1.85 %),172,331000,1924.42,183,587010,3208,-256010
2015-01-15,54 ( 0 %),146,386000,2643.84,253,483290,1910,-97290
2015-01-14,54 ( 0 %),231,487700,2111.26,240,613940,2558,-126240
2015-01-13,54 ( 0 %),144,211460,1468.47,204,344550,1689,-133090
2015-01-12,54 ( 0 %),281,1159760,4127.26,422,1384080,3280,-224320
2015-01-09,54 ( 1.89 %),253,695770,2750.08,289,830780,2875,-135010
2015-01-08,53 ( 0 %),187,273790,1464.12,212,565190,2666,-291400
2015-01-07,53 ( -0.93 %),159,509940,3207.17,263,838650,3189,-328710
2015-01-06,53.5 ( 0.94 %),207,579750,2800.72,217,557070,2567,22680
2015-01-05,53 ( 0 %),177,438440,2477.06,299,659860,2207,-221420
2014-12-31,53 ( 0.95 %),382,1166310,3053.17,348,1339960,3850,-173650
2014-12-30,52.5 ( 1.94 %),277,959350,3463.36,258,797220,3090,162130
2014-12-29,51.5 ( 3 %),244,1012110,4147.99,366,1013810,2770,-1700
2014-12-26,50 ( -1.96 %),249,472960,1899.44,215,613180,2852,-140220
2014-12-25,51 ( -0.97 %),147,399390,2716.94,163,429110,2633,-29720
2014-12-24,51.5 ( 0 %),138,444140,3218.41,182,610990,3357,-166850
2014-12-23,51.5 ( 0 %),278,754860,2715.32,359,927260,2583,-172400
2014-12-22,51.5 ( 6.63 %),324,796350,2457.87,313,561350,1793,235000
2014-12-19,48.3 ( 0 %),281,800080,2847.26,318,1000690,3147,-200610
2014-12-18,48.3 ( 1.05 %),485,923840,1904.82,282,858830,3045,65010
2014-12-17,47.8 ( -4.02 %),646,2023190,3131.87,689,2900900,4210,-877710
2014-12-16,49.8 ( -4.23 %),397,938850,2364.86,309,1256720,4067,-317870
2014-12-15,52 ( -1.89 %),131,271160,2069.92,164,331350,2020,-60190
2014-12-12,53 ( 0.95 %),164,372320,2270.24,145,310680,2143,61640
2014-12-11,52.5 ( -0.94 %),187,412840,2207.7,184,416180,2262,-3340
2014-12-10,53 ( 1.92 %),423,1104940,2612.15,269,839560,3121,265380
2014-12-09,52 ( -4.59 %),519,1386110,2670.73,345,1494530,4332,-108420
2014-12-08,54.5 ( -1.8 %),249,695860,2794.62,316,1001470,3169,-305610
2014-12-05,55.5 ( 0.91 %),320,1036340,3238.56,380,1276530,3359,-240190
2014-12-04,55 ( 0 %),154,736280,4781.04,281,791690,2817,-55410
2014-12-03,55 ( 1.85 %),224,1044970,4665.04,230,810070,3522,234900
2014-12-02,54 ( 0 %),158,340300,2153.8,157,511890,3260,-171590
2014-12-01,54 ( 0.93 %),292,1050890,3598.94,359,1107110,3084,-56220
2014-11-28,53.5 ( -1.83 %),284,694610,2445.81,224,1057170,4720,-362560
2014-11-27,54.5 ( 1.87 %),383,1307690,3414.33,278,1318720,4744,-11030
2014-11-26,53.5 ( -2.73 %),404,1071560,2652.38,254,1358120,5347,-286560
2014-11-25,55 ( 0 %),322,782480,2430.06,206,1039320,5045,-256840
2014-11-24,55 ( -0.9 %),264,585700,2218.56,172,889100,5169,-303400
2014-11-21,55.5 ( -1.77 %),173,530880,3068.67,220,1106850,5031,-575970
2014-11-20,56.5 ( 1.8 %),308,1202240,3903.38,191,1095250,5734,106990
2014-11-19,55.5 ( -2.63 %),294,1046130,3558.27,276,1825490,6614,-779360
2014-11-18,57 ( 0 %),144,506610,3518.12,217,643070,2963,-136460
2014-11-17,57 ( 0 %),170,483840,2846.12,197,555390,2819,-71550
2014-11-14,57 ( -0.87 %),264,624700,2366.29,276,1029830,3731,-405130
2014-11-13,57.5 ( 0 %),157,561070,3573.69,282,788780,2797,-227710
2014-11-12,57.5 ( 0 %),164,385220,2348.9,309,715780,2316,-330560
2014-11-11,57.5 ( 1.77 %),325,1385290,4262.43,671,1411870,2104,-26580
2014-11-10,56.5 ( 0 %),314,826920,2633.5,333,945040,2838,-118120
2014-11-07,56.5 ( 2.73 %),217,895170,4125.21,365,704120,1929,191050
2014-11-06,55 ( -0.9 %),188,287470,1529.1,250,576330,2305,-288860
2014-11-05,55.5 ( -0.89 %),235,628750,2675.53,357,909190,2547,-280440
2014-11-04,56 ( -0.88 %),173,525890,3039.83,366,756990,2068,-231100
2014-11-03,56.5 ( 2.73 %),323,1205110,3730.99,470,1236760,2631,-31650
2014-10-31,55 ( 0.92 %),416,1171850,2816.95,233,972810,4175,199040
2014-10-30,54.5 ( 0 %),234,708150,3026.28,272,934440,3435,-226290
2014-10-29,54.5 ( 0.93 %),237,797690,3365.78,291,790870,2718,6820
2014-10-28,54 ( 1.89 %),310,1199610,3869.71,273,890270,3261,309340
2014-10-27,53 ( -2.75 %),254,722230,2843.43,229,980800,4283,-258570
2014-10-24,54.5 ( 0 %),359,985920,2746.3,215,826360,3844,159560
2014-10-23,54.5 ( -2.68 %),285,824720,2893.75,391,1298750,3322,-474030
2014-10-22,56 ( 1.82 %),329,1460320,4438.66,339,1298660,3831,161660
2014-10-21,55 ( 0 %),264,743780,2817.35,261,871160,3338,-127380
2014-10-20,55 ( 2.8 %),497,1724730,3470.28,380,1621030,4266,103700
2014-10-17,53.5 ( 0.94 %),820,2632650,3210.55,460,2332390,5070,300260
2014-10-16,53 ( -4.5 %),791,2388150,3019.15,700,2545820,3637,-157670
2014-10-15,55.5 ( -1.77 %),620,1179510,1902.44,410,1531220,3735,-351710
2014-10-14,56.5 ( -3.42 %),525,1355820,2582.51,382,1997680,5230,-641860
2014-10-13,58.5 ( 0 %),298,1234720,4143.36,375,2124980,5667,-890260
2014-10-10,58.5 ( 0 %),264,954300,3614.77,413,1194370,2892,-240070
2014-10-09,58.5 ( -0.85 %),333,1352830,4062.55,517,2058170,3981,-705340
2014-10-08,59 ( 2.61 %),378,1476130,3905.11,394,1957150,4967,-481020
2014-10-07,57.5 ( 0 %),351,973590,2773.76,296,1324380,4474,-350790
2014-10-06,57.5 ( -2.54 %),501,1261430,2517.82,425,2392500,5629,-1131070
2014-10-03,59 ( 0 %),264,764390,2895.42,411,1322220,3217,-557830
2014-10-02,59 ( 1.72 %),250,850640,3402.56,345,785560,2277,65080
2014-10-01,58 ( 0.87 %),258,977500,3788.76,356,1292090,3629,-314590
2014-09-30,57.5 ( -0.86 %),348,967590,2780.43,384,1807510,4707,-839920
2014-09-29,58 ( 0 %),238,596620,2506.81,335,1449980,4328,-853360
2014-09-26,58 ( -0.85 %),171,491220,2872.63,337,1554430,4613,-1063210
2014-09-25,58.5 ( 0 %),361,1193380,3305.76,419,1695860,4047,-502480
2014-09-24,58.5 ( 1.74 %),292,1364010,4671.27,470,1605230,3415,-241220
2014-09-23,57.5 ( 1.77 %),347,1391210,4009.25,406,1417830,3492,-26620
2014-09-22,56.5 ( 0.89 %),409,1464490,3580.66,370,1777980,4805,-313490
2014-09-19,56 ( -3.45 %),654,2713610,4149.25,414,3598060,8691,-884450
2014-09-18,58 ( -0.85 %),313,1332220,4256.29,521,2280770,4378,-948550
2014-09-17,58.5 ( 1.74 %),539,1659550,3078.94,503,2153530,4281,-493980
2014-09-16,57.5 ( -0.86 %),0,0,0,0,0,0,0
2014-09-15,58 ( 0 %),332,980130,2952.2,424,1732040,4085,-751910
2014-09-12,58 ( 0.87 %),508,1094260,2154.06,420,1744540,4154,-650280
2014-09-11,57.5 ( -2.54 %),558,1093570,1959.8,385,1811500,4705,-717930
2014-09-10,59 ( 0 %),429,1026940,2393.8,393,1923430,4894,-896490
2014-09-09,59 ( -3.28 %),688,2244380,3262.18,743,3968820,5342,-1724440
2014-09-08,61 ( 0 %),363,1508380,4155.32,572,2416020,4224,-907640
2014-09-05,61 ( 0 %),330,821270,2488.7,527,2014220,3822,-1192950
2014-09-04,61 ( 2.52 %),699,3264520,4670.27,878,3496470,3982,-231950
2014-09-03,59.5 ( 2.59 %),584,1794370,3072.55,414,2017540,4873,-223170
2014-08-29,58 ( -0.85 %),621,1645910,2650.42,428,2680920,6264,-1035010
2014-08-28,58.5 ( -2.5 %),924,1912030,2069.3,491,3104910,6324,-1192880
2014-08-27,60 ( -1.64 %),367,1395170,3801.55,579,3009470,5198,-1614300
2014-08-26,61 ( 1.67 %),465,2319540,4988.26,522,2411090,4619,-91550
2014-08-25,60 ( 0.84 %),564,2374180,4209.54,639,3195350,5001,-821170
2014-08-22,59.5 ( 1.71 %),716,3053490,4264.65,739,3475630,4703,-422140
2014-08-21,58.5 ( 1.74 %),527,1968000,3734.35,623,2406710,3863,-438710
2014-08-20,57.5 ( 0 %),302,991240,3282.25,439,2000760,4558,-1009520
2014-08-19,57.5 ( 1.77 %),589,2711580,4603.7,737,3038420,4123,-326840
2014-08-18,56.5 ( -0.88 %),427,1045950,2449.53,455,1979480,4351,-933530
2014-08-15,57 ( 0 %),240,815550,3398.12,389,1702040,4375,-886490
2014-08-14,57 ( 0 %),347,1003790,2892.77,561,2093010,3731,-1089220
2014-08-13,57 ( 2.7 %),694,2019310,2909.67,506,2175760,4300,-156450
2014-08-12,55.5 ( -0.89 %),298,803920,2697.72,348,1555410,4470,-751490
2014-08-11,56 ( 0 %),0,0,0,0,0,0,0
2014-08-08,56 ( -0.88 %),504,1125110,2232.36,372,1687230,4536,-562120
2014-08-07,56.5 ( -0.88 %),531,1107090,2084.92,400,1967190,4918,-860100
2014-08-06,57 ( 0 %),274,548790,2002.88,351,1195910,3407,-647120
2014-08-05,57 ( 1.79 %),549,2277720,4148.85,580,2621720,4520,-344000
2014-08-04,56 ( -0.88 %),459,774400,1687.15,314,1460630,4652,-686230
2014-08-01,56.5 ( -1.74 %),341,810850,2377.86,470,1998450,4252,-1187600
2014-07-31,57.5 ( 4.55 %),648,2092680,3229.44,728,2757980,3788,-665300
2014-07-30,55 ( 0 %),255,628210,2463.57,286,1095280,3830,-467070
2014-07-29,55 ( 0 %),0,0,0,0,0,0,0
2014-07-28,55 ( -2.65 %),562,1428300,2541.46,520,2242860,4313,-814560
2014-07-25,56.5 ( -1.74 %),366,1233140,3369.23,455,2154200,4735,-921060
2014-07-24,57.5 ( 1.77 %),467,1363170,2918.99,340,1321710,3887,41460
2014-07-23,56.5 ( -0.88 %),549,1587380,2891.4,369,1950290,5285,-362910
2014-07-22,57 ( -0.87 %),439,1114210,2538.06,376,1842050,4899,-727840
2014-07-21,57.5 ( -0.86 %),540,1743240,3228.22,463,2200790,4753,-457550
2014-07-18,58 ( 0 %),558,1554990,2786.72,430,2073480,4822,-518490
2014-07-17,58 ( 0.87 %),424,1306130,3080.5,457,2123140,4646,-817010
2014-07-16,57.5 ( 0.88 %),951,4395140,4621.6,899,4876870,5425,-481730
2014-07-15,57 ( 1.79 %),387,1718340,4440.16,412,1625100,3944,93240
2014-07-14,56 ( 1.82 %),569,2928000,5145.87,542,2523570,4656,404430
2014-07-11,55 ( 0 %),470,1463860,3114.6,317,1537360,4850,-73500
2014-07-10,55 ( -0.9 %),440,1408240,3200.55,421,2117210,5029,-708970
2014-07-09,55.5 ( 0.91 %),452,1808400,4000.88,404,2003430,4959,-195030
2014-07-08,55 ( 0 %),455,1343720,2953.23,361,2103320,5826,-759600
2014-07-07,55 ( -0.9 %),423,1526750,3609.34,591,5850260,9899,-4323510
2014-07-04,55.5 ( 0.91 %),663,3461100,5220.36,680,5397900,7938,-1936800
2014-07-03,55 ( 2.8 %),868,3634770,4187.52,818,5745550,7024,-2110780
2014-07-02,53.5 ( -0.93 %),419,834740,1992.22,412,3013200,7314,-2178460
2014-07-01,54 ( 0 %),399,1086950,2724.19,513,4208090,8203,-3121140
2014-06-30,54 ( 0.93 %),369,1333280,3613.22,304,1445480,4755,-112200
2014-06-27,53.5 ( 0 %),261,820530,3143.79,387,1555360,4019,-734830
2014-06-25,0 ( 0 %),417,1126850,2702.28,454,1682300,3706,-555450
2014-06-24,53.5 ( 0 %),303,767900,2534.32,377,1221630,3240,-453730
2014-06-23,53.5 ( 3.88 %),396,1069500,2700.76,415,1346470,3245,-276970
2014-06-20,51.5 ( -1.9 %),1103,4682580,4245.31,793,4469150,5636,213430
2014-06-19,52.5 ( 0 %),318,817250,2569.97,396,1016570,2567,-199320
2014-06-18,52.5 ( 0 %),253,720700,2848.62,332,1083710,3264,-363010
2014-06-17,52.5 ( 1.94 %),428,1172860,2740.33,512,1403400,2741,-230540
2014-06-16,51.5 ( -0.96 %),272,679850,2499.45,422,1632090,3868,-952240
2014-06-13,52 ( 4.21 %),880,2720750,3091.76,941,3029050,3219,-308300
2014-06-12,49.9 ( -0.2 %),309,635110,2055.37,321,776410,2419,-141300
2014-06-11,50 ( 0 %),373,523990,1404.8,365,733710,2010,-209720
2014-06-10,50 ( -1.96 %),161,281480,1748.32,284,611750,2154,-330270
2014-06-09,51 ( 2 %),223,384360,1723.59,347,738890,2129,-354530
2014-06-06,50 ( 2.88 %),180,273000,1516.67,166,266270,1604,6730
2014-06-05,48.6 ( -0.82 %),278,336510,1210.47,188,393220,2092,-56710
2014-06-04,49 ( -3.92 %),260,382160,1469.85,283,794230,2806,-412070
2014-06-03,51 ( 0 %),165,232670,1410.12,261,503210,1928,-270540
2014-06-02,51 ( 0 %),190,445660,2345.58,273,727480,2665,-281820
2014-05-30,51 ( 0 %),281,989990,3523.1,479,1731090,3614,-741100
2014-05-29,51 ( -1.92 %),482,856010,1775.95,450,1580590,3512,-724580
2014-05-28,52 ( 1.96 %),476,1379890,2898.93,554,1848560,3337,-468670
2014-05-27,51 ( 0 %),486,978640,2013.66,394,1000380,2539,-21740
2014-05-26,51 ( 0 %),303,464450,1532.84,409,905540,2214,-441090
2014-05-23,51 ( 4.08 %),554,1244800,2246.93,641,1730100,2699,-485300
2014-05-22,49 ( 1.03 %),620,1244920,2007.94,540,1362850,2524,-117930
2014-05-21,48.5 ( -0.41 %),552,1339810,2427.19,355,1015530,2861,324280
2014-05-20,48.7 ( -0.81 %),301,609290,2024.22,335,782270,2335,-172980
2014-05-19,49.1 ( 4.25 %),346,1127270,3258.01,622,1220740,1963,-93470
2014-05-16,47.1 ( 0.64 %),325,802550,2469.38,333,569630,1711,232920
2014-05-15,46.8 ( -0.43 %),566,1279440,2260.49,647,1836670,2839,-557230
2014-05-14,47 ( 6.09 %),519,1628870,3138.48,517,1305660,2525,323210
2014-05-13,44.3 ( 0.68 %),451,761500,1688.47,402,714780,1778,46720
2014-05-12,44 ( -4.76 %),485,1337530,2757.79,422,987330,2340,350200
2014-05-09,46.2 ( 5 %),951,3273880,3442.57,624,2061000,3303,1212880
2014-05-08,44 ( -6.98 %),810,2477840,3059.06,720,4521540,6280,-2043700
2014-05-07,47.3 ( -1.25 %),384,628760,1637.4,323,629500,1949,-740
2014-05-06,47.9 ( -0.83 %),486,882770,1816.4,301,747240,2483,135530
2014-05-05,48.3 ( -2.82 %),362,601480,1661.55,293,1000210,3414,-398730
2014-04-29,49.7 ( 0.81 %),285,404920,1420.77,287,647500,2256,-242580
2014-04-28,49.3 ( -0.6 %),361,580000,1606.65,271,774890,2859,-194890
2014-04-25,49.6 ( 4.42 %),547,1233860,2255.69,387,1140010,2946,93850
2014-04-24,47.5 ( 1.28 %),538,612730,1138.9,345,886060,2568,-273330
2014-04-23,55.5 ( 0 %),470,1244290,2647.43,674,2043770,3032,-799480
2014-04-22,55.5 ( 6.73 %),549,1458280,2656.25,385,1216910,3161,241370
2014-04-21,52 ( 0 %),318,754050,2371.23,293,778440,2657,-24390
2014-04-18,52 ( -3.7 %),491,1300620,2648.92,391,1682110,4302,-381490
2014-04-17,54 ( 0 %),339,934940,2757.94,262,1026710,3919,-91770
2014-04-16,54 ( -0.92 %),588,2392910,4069.57,469,2201030,4693,191880
2014-04-15,54.5 ( -4.39 %),604,1677810,2777.83,437,2023800,4631,-345990
2014-04-14,57 ( 1.79 %),327,1432330,4380.21,387,1562180,4037,-129850
2014-04-11,56 ( -1.75 %),366,946150,2585.11,472,1831830,3881,-885680
2014-04-10,57 ( 0.88 %),369,926400,2510.57,398,1469010,3691,-542610
2014-04-08,56.5 ( -0.88 %),426,829100,1946.24,471,1764310,3746,-935210
2014-04-07,57 ( 2.7 %),929,2932610,3156.74,743,3201080,4308,-268470
2014-04-04,55.5 ( 5.71 %),885,3719880,4203.25,693,2973590,4291,746290
2014-04-03,52.5 ( 0.96 %),323,827440,2561.73,380,1464800,3855,-637360
2014-04-02,52 ( 0 %),454,1605850,3537.11,546,2506130,4590,-900280
2014-04-01,52 ( -1.89 %),414,1082530,2614.81,468,2145270,4584,-1062740
2014-03-31,53 ( 0 %),388,1303150,3358.63,530,3136840,5919,-1833690
2014-03-28,53 ( 0.95 %),763,2954490,3872.2,727,4004190,5508,-1049700
2014-03-27,52.5 ( 1.94 %),453,1628530,3594.99,400,1672520,4181,-43990
2014-03-26,51.5 ( 0 %),589,2034230,3453.7,505,2267000,4489,-232770
2014-03-25,51.5 ( -2.83 %),543,1826560,3363.83,471,2915150,6189,-1088590
2014-03-24,53 ( 1.92 %),600,2605410,4342.35,498,2918520,5860,-313110
2014-03-21,52 ( 0 %),1292,9213800,7131.42,588,4970760,8454,4243040
2014-03-20,52 ( -0.95 %),509,2417900,4750.29,693,2776570,4007,-358670
2014-03-19,52.5 ( 5.21 %),663,3276960,4942.62,590,2587240,4385,689720
2014-03-18,49.9 ( 1.84 %),568,2450450,4314.17,374,2057650,5502,392800
2014-03-17,49 ( -2 %),951,3196470,3361.17,395,1213180,3071,1983290
2014-03-14,50 ( -1.96 %),319,894860,2805.2,387,1162900,3005,-268040
2014-03-13,51 ( -0.97 %),230,623640,2711.48,469,1482870,3162,-859230
2014-03-12,51.5 ( 3.21 %),447,1642610,3674.74,836,2181270,2609,-538660
2014-03-11,49.9 ( 2.46 %),346,1173750,3392.34,564,1118410,1983,55340
2014-03-10,48.8 ( 0.41 %),257,483390,1880.89,280,600670,2145,-117280
2014-03-07,48.6 ( -0.82 %),286,371870,1300.24,297,591560,1992,-219690
2014-03-06,49 ( 1.24 %),165,232670,1410.12,261,503210,1928,-270540
2014-03-05,48.4 ( 1.26 %),289,665600,2303.11,349,702560,2013,-36960
2014-03-04,47.8 ( -1.44 %),488,978350,2004.82,281,675800,2405,302550
2014-03-03,48.5 ( 0.21 %),340,993480,2922,405,859440,2122,134040
2014-02-28,48.4 ( -2.22 %),779,1843490,2366.48,456,1682980,3691,160510
2014-02-27,49.5 ( -2.94 %),348,646330,1857.27,426,1217180,2857,-570850
2014-02-26,51 ( -1.92 %),285,657620,2307.44,516,1210680,2346,-553060
2014-02-25,52 ( 7 %),686,2116720,3085.6,906,2038670,2250,78050
2014-02-24,48.6 ( 2.32 %),308,806700,2619.16,382,731610,1915,75090
2014-02-21,47.5 ( 1.28 %),393,671700,1709.16,296,523350,1768,148350
2014-02-20,46.9 ( -2.9 %),435,779180,1791.22,336,894760,2663,-115580
2014-02-19,48.3 ( -0.41 %),288,538340,1869.24,274,638290,2330,-99950
2014-02-18,48.5 ( 1.04 %),367,728870,1986.02,276,547300,1983,181570
2014-02-17,48 ( -1.23 %),487,753780,1547.8,275,669860,2436,83920
2014-02-14,48.6 ( -1.22 %),341,478430,1403.02,309,569690,1844,-91260
2014-02-13,49.2 ( 0.61 %),279,648470,2324.27,398,769050,1932,-120580
2014-02-12,48.9 ( 2.73 %),339,945620,2789.44,454,919500,2025,26120
2014-02-11,47.6 ( -0.42 %),517,1162750,2249.03,646,1355240,2098,-192490
2014-02-10,47.8 ( 0.21 %),404,621640,1538.71,348,725280,2084,-103640
2014-02-07,47.7 ( -1.45 %),513,1126780,2196.45,468,1406710,3006,-279930
2014-02-06,48.4 ( 6.14 %),705,1258510,1785.12,361,769870,2133,488640
2014-01-27,45.6 ( -1.72 %),794,1241810,1563.99,267,1147880,4299,93930
2014-01-24,46.4 ( -1.69 %),927,1776160,1916.03,424,1553730,3664,222430
2014-01-23,47.2 ( -6.53 %),735,1540680,2096.16,517,1396900,2702,143780
2014-01-22,50.5 ( -6.48 %),553,966130,1747.07,595,2840840,4775,-1874710
2014-01-21,54 ( 3.85 %),395,1011880,2561.72,469,1200840,2560,-188960
2014-01-20,52 ( 2.97 %),576,1662890,2886.96,473,1945220,4113,-282330
2014-01-17,50.5 ( 6.32 %),492,2030710,4127.46,502,1602250,3192,428460
2014-01-16,47.5 ( 3.26 %),330,1251520,3792.48,337,971650,2883,279870
2014-01-15,46 ( 2.22 %),360,1087020,3019.5,226,626890,2774,460130
2014-01-14,45 ( 3.93 %),400,1639350,4098.38,328,1154440,3520,484910
2014-01-13,43.3 ( 0.46 %),134,343990,2567.09,151,373790,2475,-29800
2014-01-10,43.1 ( -0.23 %),180,460970,2560.94,239,577500,2416,-116530
2014-01-09,43.2 ( 1.65 %),224,1070290,4778.08,260,924650,3556,145640
2014-01-08,42.5 ( 0.71 %),185,732760,3960.86,170,564150,3319,168610
2014-01-07,42.2 ( -0.24 %),183,455940,2491.48,200,573440,2867,-117500
2014-01-06,42.3 ( 1.68 %),329,1018500,3095.74,219,619700,2830,398800
2014-01-03,41.6 ( 1.22 %),232,1152170,4966.25,187,688460,3682,463710
2014-01-02,41.1 ( 0 %),113,481830,4263.98,192,524500,2732,-42670
2013-12-31,41.1 ( 0.24 %),199,927310,4659.85,276,853800,3093,73510
2013-12-30,41 ( 0 %),213,762840,3581.41,259,718770,2775,44070
2013-12-27,41 ( 1.23 %),387,1588390,4104.37,446,1330370,2983,258020
2013-12-26,40.5 ( 1.76 %),363,2402020,6617.13,589,1982150,3365,419870
2013-12-25,39.8 ( 0 %),156,523960,3358.72,184,537370,2920,-13410
2013-12-24,39.8 ( 0 %),105,212370,2022.57,207,427590,2066,-215220
2013-12-23,39.8 ( 2.31 %),200,775750,3878.75,238,625960,2630,149790
2013-12-20,38.9 ( -1.27 %),669,4074060,6089.78,293,2591310,8844,1482750
2013-12-19,39.4 ( 1.29 %),132,423060,3205,232,378310,1631,44750
2013-12-18,38.9 ( 0 %),116,350150,3018.53,182,346480,1904,3670
2013-12-17,38.9 ( 1.57 %),103,185640,1802.33,136,218230,1605,-32590
2013-12-16,38.3 ( 0.52 %),292,1185500,4059.93,290,912330,3146,273170
2013-12-13,38.1 ( -1.55 %),272,496090,1823.86,141,615220,4363,-119130
2013-12-12,38.7 ( -0.51 %),210,442690,2108.05,152,406810,2676,35880
2013-12-11,38.9 ( -0.77 %),113,299960,2654.51,143,568700,3977,-268740
2013-12-10,39.2 ( 0 %),216,568170,2630.42,139,544640,3918,23530
2013-12-09,39.2 ( -1.51 %),334,722030,2161.77,202,798850,3955,-76820
2013-12-06,39.8 ( -0.25 %),128,250350,1955.86,130,342590,2635,-92240
2013-12-05,39.9 ( -0.75 %),152,325000,2138.16,132,393360,2980,-68360
2013-12-04,40.2 ( -0.5 %),147,314050,2136.39,146,343540,2353,-29490
2013-12-03,40.4 ( 0.25 %),126,297550,2361.51,141,282120,2001,15430
2013-12-02,40.3 ( 0 %),76,156490,2059.08,117,229300,1960,-72810
2013-11-29,40.3 ( 0 %),152,327480,2154.47,138,572560,4149,-245080
2013-11-28,40.3 ( 0.25 %),172,311810,1812.85,141,269560,1912,42250
2013-11-27,40.2 ( -0.74 %),184,237570,1291.14,173,414140,2394,-176570
2013-11-26,40.5 ( 2.02 %),224,881310,3934.42,222,705170,3176,176140
2013-11-25,39.7 ( 0.51 %),207,706440,3412.75,244,850550,3486,-144110
2013-11-22,39.5 ( 0 %),176,361450,2053.69,166,508050,3061,-146600
2013-11-21,39.5 ( -1.25 %),277,597730,2157.87,212,785600,3706,-187870
2013-11-20,40 ( 1.52 %),247,900830,3647.09,250,972410,3890,-71580
2013-11-19,39.4 ( -0.76 %),149,415370,2787.72,175,440190,2515,-24820
2013-11-18,39.7 ( 0.51 %),156,569070,3647.88,216,499710,2313,69360
2013-11-15,39.5 ( -1 %),269,571020,2122.75,234,614500,2626,-43480
2013-11-14,39.9 ( 5.56 %),131,529190,4039.62,133,431820,3247,97370
2013-11-13,37.8 ( -1.31 %),244,513990,2106.52,163,514190,3155,-200
2013-11-12,38.3 ( -0.52 %),199,705770,3546.58,170,781100,4595,-75330
2013-11-11,38.5 ( 1.32 %),92,378090,4109.67,107,226540,2117,151550
2013-11-08,38 ( 0 %),107,406460,3798.69,124,281660,2271,124800
2013-11-07,38 ( 0.53 %),170,777390,4572.88,225,632530,2811,144860
2013-11-06,37.8 ( 1.07 %),163,706080,4331.78,173,478710,2767,227370
2013-11-05,37.4 ( 0 %),107,378480,3537.2,165,347110,2104,31370
2013-11-04,37.4 ( 0.54 %),116,388870,3352.33,171,380240,2224,8630
2013-11-01,37.2 ( 0 %),112,352700,3149.11,183,485370,2652,-132670
2013-10-31,37.2 ( 1.64 %),237,1019400,4301.27,318,1087060,3418,-67660
2013-10-30,36.6 ( 0.27 %),118,481690,4082.12,181,687960,3801,-206270
2013-10-29,36.5 ( 0 %),269,750250,2789.03,204,658730,3229,91520
2013-10-28,36.5 ( -0.54 %),138,500950,3630.07,230,725850,3156,-224900
2013-10-25,36.7 ( 0 %),180,495470,2752.61,217,596180,2747,-100710
2013-10-24,36.7 ( 0 %),295,861730,2921.12,352,1228780,3491,-367050
2013-10-23,36.7 ( 1.66 %),319,1037030,3250.88,329,1096410,3333,-59380
2013-10-22,36.1 ( 0.28 %),312,773190,2478.17,282,1091390,3870,-318200
2013-10-21,36 ( -0.28 %),168,537940,3202.02,250,793880,3176,-255940
2013-10-18,36.1 ( 0 %),221,414830,1877.06,161,513490,3189,-98660
2013-10-17,36.1 ( 0 %),129,420140,3256.9,174,645240,3708,-225100
2013-10-16,36.1 ( -0.28 %),200,570140,2850.7,219,780170,3562,-210030
2013-10-15,36.2 ( 0.56 %),169,553680,3276.21,229,853050,3725,-299370
2013-10-14,36 ( 0.28 %),129,376090,2915.43,167,593900,3556,-217810
2013-10-11,35.9 ( 0.84 %),261,1092130,4184.41,330,1151390,3489,-59260
2013-10-10,35.6 ( -1.39 %),286,938670,3282.06,357,1192160,3339,-253490
2013-10-09,36.1 ( -0.82 %),355,982540,2767.72,279,1163200,4169,-180660
2013-10-08,36.4 ( 0.28 %),263,986560,3751.18,393,1271390,3235,-284830
2013-10-07,36.3 ( 3.12 %),407,1617550,3974.32,430,1494480,3476,123070
2013-10-04,35.2 ( 2.03 %),298,1185880,3979.46,353,1056900,2994,128980
2013-10-03,34.5 ( -0.86 %),207,612540,2959.13,215,766690,3566,-154150
2013-10-02,34.8 ( 0.58 %),229,851700,3719.21,252,830610,3296,21090
2013-10-01,34.6 ( -1.42 %),461,1769810,3839.07,536,2034290,3795,-264480
2013-09-30,35.1 ( 0.29 %),231,671800,2908.23,351,906840,2584,-235040
2013-09-27,35 ( 0.57 %),412,1086740,2637.72,397,1366920,3443,-280180
2013-09-26,34.8 ( 2.05 %),642,1805140,2811.74,494,1740930,3524,64210
2013-09-25,34.1 ( -1.16 %),390,556420,1426.72,254,837510,3297,-281090
2013-09-24,34.5 ( -1.43 %),365,655940,1797.1,357,1098460,3077,-442520
2013-09-23,35 ( 6.06 %),548,1581250,2885.49,430,1286300,2991,294950
2013-09-20,33 ( 0.61 %),173,885070,5116.01,282,1097980,3894,-212910
2013-09-19,32.8 ( 0.31 %),133,357590,2688.65,241,597720,2480,-240130
2013-09-18,32.7 ( -0.91 %),200,524720,2623.6,295,789370,2676,-264650
2013-09-17,33 ( 0 %),204,528620,2591.27,271,617890,2280,-89270
2013-09-16,33 ( 0.92 %),237,497460,2098.99,227,544780,2400,-47320
2013-09-13,32.7 ( -1.21 %),290,527320,1818.34,307,768200,2502,-240880
2013-09-12,33.1 ( 1.22 %),376,691110,1838.06,480,914580,1905,-223470
2013-09-11,32.7 ( 3.15 %),322,893190,2773.88,461,1016380,2205,-123190
2013-09-10,31.7 ( 2.59 %),301,894770,2972.66,337,720200,2137,174570
2013-09-09,30.9 ( -1.59 %),189,496840,2628.78,301,707250,2350,-210410
2013-09-06,31.4 ( 3.29 %),213,575360,2701.22,294,633130,2154,-57770
2013-09-05,30.4 ( 2.01 %),176,333400,1894.32,97,270170,2785,63230
2013-09-04,29.8 ( -2.61 %),202,422810,2093.12,170,543700,3198,-120890
2013-09-03,30.6 ( 1.32 %),163,420450,2579.45,180,432590,2403,-12140
2013-08-30,31.2 ( 2.63 %),155,538210,3472.32,126,426040,3381,112170
2013-08-29,30.4 ( -1.3 %),407,1062950,2611.67,237,910130,3840,152820
2013-08-28,30.8 ( -3.75 %),409,1147980,2806.8,381,1089330,2859,58650
2013-08-27,32 ( 0 %),122,386720,3169.84,171,394530,2307,-7810
2013-08-26,32 ( 0.31 %),264,753930,2855.8,226,497840,2203,256090
2013-08-23,31.9 ( -0.93 %),398,1244350,3126.51,367,1426880,3888,-182530
2013-08-22,32.2 ( -2.42 %),339,989990,2920.32,374,1311800,3507,-321810
2013-08-21,33 ( 1.23 %),351,1029510,2933.08,341,949190,2784,80320
2013-08-20,32.6 ( 0.31 %),265,1050100,3962.64,409,1082890,2648,-32790
2013-08-19,32.5 ( 0 %),345,1307580,3790.09,464,1044610,2251,262970
2013-08-16,32.5 ( 1.25 %),334,1354610,4055.72,396,1019480,2574,335130
2013-08-15,32.1 ( 1.58 %),304,1108540,3646.51,451,1114090,2470,-5550
2013-08-14,31.6 ( 0.64 %),151,407970,2701.79,159,454100,2856,-46130
2013-08-13,31.4 ( 0.32 %),140,330840,2363.14,228,551610,2419,-220770
2013-08-12,31.3 ( 0 %),101,292900,2900,167,374110,2240,-81210
2013-08-09,31.3 ( -0.32 %),224,501530,2238.97,305,786160,2578,-284630
2013-08-08,31.4 ( -0.32 %),220,556860,2531.18,450,1099270,2443,-542410
2013-08-07,31.5 ( 2.94 %),347,1135400,3272.05,488,1157210,2371,-21810
2013-08-06,30.6 ( 0 %),168,479350,2853.27,204,595240,2918,-115890
2013-08-05,30.6 ( 0.33 %),84,279140,3323.1,163,369120,2265,-89980
2013-08-02,30.5 ( 0.66 %),162,420750,2597.22,190,451770,2378,-31020
2013-08-01,30.3 ( 0 %),159,468760,2948.18,154,482720,3135,-13960
2013-07-31,30.3 ( -0.66 %),199,450610,2264.37,193,580850,3010,-130240
2013-07-30,30.5 ( 3.04 %),205,638040,3112.39,185,417230,2255,220810
2013-07-29,29.6 ( -1.99 %),154,445090,2890.19,217,565300,2605,-120210
2013-07-26,30.2 ( -0.33 %),240,742160,3092.33,281,931570,3315,-189410
2013-07-25,30.3 ( -1.62 %),269,833610,3098.92,318,991320,3117,-157710
2013-07-24,30.8 ( -1.91 %),454,1444910,3182.62,540,1552830,2876,-107920
2013-07-23,31.4 ( 2.28 %),355,1507940,4247.72,500,1318130,2636,189810
2013-07-22,30.7 ( 0.33 %),352,1203780,3419.83,448,1207920,2696,-4140
2013-07-19,30.6 ( 1.32 %),304,1114330,3665.56,392,977380,2493,136950
2013-07-18,30.2 ( 2.72 %),457,1440640,3152.39,499,1339320,2684,101320
2013-07-17,29.4 ( 0 %),197,570870,2897.82,234,560940,2397,9930
2013-07-16,29.4 ( -0.68 %),223,696280,3122.33,396,1018430,2572,-322150
2013-07-15,29.6 ( 2.78 %),412,1249720,3033.3,590,1448470,2455,-198750
2013-07-12,28.8 ( 5.11 %),326,1159460,3556.63,401,791750,1974,367710
2013-07-11,27.4 ( -0.72 %),195,502700,2577.95,170,510490,3003,-7790
2013-07-10,27.6 ( -0.36 %),122,392790,3219.59,152,444470,2924,-51680
2013-07-09,27.7 ( 0.36 %),197,497020,2522.94,142,267700,1885,229320
2013-07-08,27.6 ( -1.43 %),351,1115080,3176.87,192,933940,4864,181140
2013-07-05,28 ( 1.08 %),287,991790,3455.71,319,1025390,3214,-33600
2013-07-04,27.7 ( -1.77 %),291,756500,2599.66,260,749050,2881,7450
2013-07-03,28.2 ( -0.7 %),234,662540,2831.37,244,856450,3510,-193910
2013-07-02,28.4 ( 2.53 %),223,488380,2190.04,243,543030,2235,-54650
2013-07-01,27.7 ( -1.77 %),253,626170,2474.98,155,414750,2676,211420
2013-06-28,28.2 ( -1.05 %),268,803130,2996.75,365,1124280,3080,-321150
2013-06-27,28.5 ( 5.17 %),392,1236510,3154.36,293,874100,2983,362410
2013-06-26,27.1 ( 0 %),535,1965650,3674.11,429,1862720,4342,102930
2013-06-25,27.1 ( -4.24 %),395,1266960,3207.49,479,1203810,2513,63150
2013-06-24,28.3 ( 0.35 %),355,1065720,3002.03,296,1085640,3668,-19920
2013-06-21,28.2 ( -3.75 %),1196,5560560,4649.3,495,4008580,8098,1551980
2013-06-20,29.3 ( -1.35 %),436,1563760,3586.61,234,1234930,5277,328830
2013-06-19,29.7 ( -0.67 %),409,1279210,3127.65,262,1420010,5420,-140800
2013-06-18,29.9 ( 0 %),388,1305170,3363.84,264,1326830,5026,-21660
2013-06-17,29.9 ( -2.92 %),513,1954510,3809.96,395,1852370,4690,102140
2013-06-14,30.8 ( -0.96 %),413,1475810,3573.39,338,1170610,3463,305200
2013-06-13,31.1 ( 1.97 %),488,1539920,3155.57,374,1278290,3418,261630
2013-06-12,30.5 ( -2.87 %),654,1999920,3057.98,257,1591210,6191,408710
2013-06-11,31.4 ( -1.26 %),353,1028070,2912.38,257,1171160,4557,-143090
2013-06-10,31.8 ( -0.31 %),269,945340,3514.28,352,1032950,2935,-87610
2013-06-07,31.9 ( -0.31 %),173,457170,2642.6,308,655690,2129,-198520
2013-06-06,32 ( 0.63 %),250,714610,2858.44,221,635150,2874,79460
2013-06-05,31.8 ( 0.95 %),281,1048070,3729.79,206,895810,4349,152260
2013-06-04,31.5 ( -2.17 %),570,1853840,3252.35,417,1820270,4365,33570
2013-06-03,32.2 ( -1.83 %),414,925500,2235.51,289,964050,3336,-38550
2013-05-31,32.8 ( 0 %),369,1215910,3295.15,353,1440950,4082,-225040
2013-05-30,32.8 ( 0 %),294,1021900,3475.85,340,1375990,4047,-354090
2013-05-29,32.8 ( 0.61 %),431,1418940,3292.2,404,1523440,3771,-104500
2013-05-28,32.6 ( 0.93 %),512,1688830,3298.5,411,1980310,4818,-291480
2013-05-27,32.3 ( 2.87 %),450,1338500,2974.44,322,1260520,3915,77980
2013-05-24,31.4 ( 1.29 %),512,1838920,3591.64,331,1515830,4580,323090
2013-05-23,31 ( -1.27 %),373,996010,2670.27,308,1185990,3851,-189980
2013-05-22,31.4 ( 0 %),208,464040,2230.96,279,768010,2753,-303970
2013-05-21,31.4 ( 0.32 %),354,1059080,2991.75,331,1589480,4802,-530400
2013-05-20,31.3 ( 4.33 %),331,1156860,3495.05,350,931130,2660,225730
2013-05-17,30 ( -1.64 %),184,424100,2304.89,265,737410,2783,-313310
2013-05-16,30.5 ( 0.33 %),213,721050,3385.21,294,873140,2970,-152090
2013-05-15,30.4 ( 4.11 %),205,525660,2564.2,284,500790,1763,24870
2013-05-14,29.2 ( -3.31 %),352,952150,2704.97,303,931360,3074,20790
2013-05-13,30.2 ( -1.31 %),140,266280,1902,272,444630,1635,-178350
2013-05-10,30.6 ( 2 %),311,689410,2216.75,431,980730,2275,-291320
2013-05-09,30 ( 3.45 %),377,1239780,3288.54,452,993300,2198,246480
2013-05-08,29 ( 1.75 %),125,426610,3412.88,270,527360,1953,-100750
2013-05-07,28.5 ( -1.38 %),183,444810,2430.66,336,800740,2383,-355930
2013-05-06,28.9 ( 1.4 %),102,452200,4433.33,363,687320,1893,-235120
2013-05-03,28.5 ( 1.42 %),192,607130,3162.14,396,819330,2069,-212200
2013-05-02,28.1 ( 2.18 %),239,1025530,4290.92,382,840960,2201,184570
2013-04-26,27.5 ( 1.1 %),133,538320,4047.52,308,701220,2277,-162900
2013-04-25,27.2 ( 1.87 %),149,446740,2998.26,259,454970,1757,-8230
2013-04-24,26.7 ( 0.75 %),280,1102000,3935.71,325,833560,2565,268440
2013-04-23,26.5 ( 1.92 %),189,668560,3537.35,150,474770,3165,193790
2013-04-22,26 ( -0.38 %),127,467590,3681.81,148,393530,2659,74060
2013-04-18,26.1 ( -2.61 %),262,912720,3483.66,207,852130,4117,60590
2013-04-17,26.8 ( 0 %),171,639010,3736.9,213,640830,3009,-1820
2013-04-16,26.8 ( 0.37 %),423,1274800,3013.71,275,820620,2984,454180
2013-04-15,26.7 ( -1.84 %),287,935480,3259.51,386,1412430,3659,-476950
2013-04-12,27.2 ( -0.37 %),413,1430360,3463.34,373,1193410,3199,236950
2013-04-11,27.3 ( 1.11 %),571,1671770,2927.79,377,1474790,3912,196980
2013-04-10,27 ( -5.59 %),468,1495610,3195.75,389,1390430,3574,105180
2013-04-09,28.6 ( 0 %),343,878180,2560.29,440,926970,2107,-48790
2013-04-08,28.6 ( -0.35 %),353,661820,1874.84,427,984840,2306,-323020
2013-04-05,28.7 ( 2.5 %),355,842660,2373.69,397,895750,2256,-53090
2013-04-04,28 ( -0.36 %),529,1713490,3239.11,475,1997720,4206,-284230
2013-04-03,28.1 ( -1.4 %),499,1460360,2926.57,590,1775920,3010,-315560
2013-04-02,28.5 ( 2.52 %),750,1732500,2310,614,2182030,3554,-449530
2013-04-01,27.8 ( 6.92 %),613,2479020,4044.08,624,1750520,2805,728500
2013-03-29,26 ( 1.17 %),294,1083810,3686.43,329,948670,2883,135140
2013-03-28,25.7 ( 0.78 %),162,655960,4049.14,255,632120,2479,23840
2013-03-27,25.5 ( -0.78 %),281,873790,3109.57,274,864270,3154,9520
2013-03-26,25.7 ( 0.78 %),343,1407230,4102.71,518,1509480,2914,-102250
2013-03-25,25.5 ( 2.41 %),217,993630,4578.94,289,828590,2867,165040
2013-03-22,24.9 ( -1.97 %),290,1041370,3590.93,426,1494600,3508,-453230
2013-03-21,25.4 ( 0.79 %),382,1551310,4061.02,569,2021260,3552,-469950
2013-03-20,25.2 ( 0.8 %),204,835820,4097.16,381,1161310,3048,-325490
2013-03-19,25 ( 0.4 %),200,667720,3338.6,262,970740,3705,-303020
2013-03-18,24.9 ( -1.19 %),198,748660,3781.11,292,1101260,3771,-352600
2013-03-15,25.2 ( 0.4 %),281,1504280,5353.31,517,2244370,4341,-740090
2013-03-14,25.1 ( 2.03 %),296,1148680,3880.68,428,1458740,3408,-310060
2013-03-13,24.6 ( -3.15 %),656,1464370,2232.27,637,2041240,3204,-576870
2013-03-12,25.4 ( 2.83 %),623,2998690,4813.31,1081,3510860,3248,-512170
2013-03-11,24.7 ( 3.78 %),441,1519000,3444.44,403,1257680,3121,261320
2013-03-08,23.8 ( 0.85 %),218,586860,2692.02,378,1087660,2877,-500800
2013-03-07,23.6 ( 3.51 %),814,2428480,2983.39,741,2505280,3381,-76800
2013-03-06,22.8 ( 4.59 %),287,860420,2997.98,294,669380,2277,191040
2013-03-05,21.8 ( -2.68 %),530,2200430,4151.75,451,1715310,3803,485120
2013-03-04,22.4 ( -6.67 %),556,1541020,2771.62,437,1875960,4293,-334940
2013-03-01,24 ( -0.83 %),377,1271140,3371.72,412,1670610,4055,-399470
2013-02-28,24.2 ( 2.11 %),365,1057750,2897.95,420,1190730,2835,-132980
2013-02-27,23.7 ( -0.84 %),820,1930990,2354.87,456,1936170,4246,-5180
2013-02-26,23.9 ( -5.91 %),563,1674680,2974.56,474,2034240,4292,-359560
2013-02-25,25.4 ( 2.42 %),405,1376640,3399.11,325,1345020,4139,31620
2013-02-22,24.8 ( 1.22 %),839,2802130,3339.85,534,2542590,4761,259540
2013-02-21,24.5 ( -6.84 %),730,3098530,4244.56,755,3642030,4824,-543500
2013-02-20,26.3 ( 0.38 %),493,1540270,3124.28,397,1804190,4545,-263920
2013-02-19,26.2 ( -0.38 %),401,1704810,4251.4,464,2117750,4564,-412940
2013-02-18,26.3 ( 0.77 %),375,1956600,5217.6,432,1990920,4609,-34320
2013-02-08,26.1 ( 0 %),317,1074150,3388.49,317,1485180,4685,-411030
2013-02-07,26.1 ( 1.16 %),642,2901640,4519.69,621,3412550,5495,-510910
2013-02-06,25.8 ( 4.45 %),514,2081780,4050.16,524,2037700,3889,44080
2013-02-05,24.7 ( 1.65 %),495,1499950,3030.2,504,1613370,3201,-113420
2013-02-04,24.3 ( -1.62 %),442,1505400,3405.88,343,1784270,5202,-278870
2013-02-01,24.7 ( -0.8 %),507,1455770,2871.34,363,1867950,5146,-412180
2013-01-31,24.9 ( -1.58 %),460,1770310,3848.5,553,2026370,3664,-256060
2013-01-30,25.3 ( 3.69 %),800,3172540,3965.68,809,3775540,4667,-603000
2013-01-29,24.4 ( 2.52 %),518,2407840,4648.34,831,2979130,3585,-571290
2013-01-28,23.8 ( 0.42 %),771,3379510,4383.28,798,3724770,4668,-345260
2013-01-25,23.7 ( 2.16 %),349,1281530,3672.01,688,2277810,3311,-996280
2013-01-24,23.2 ( 6.91 %),395,1403620,3553.47,386,1157080,2998,246540
2013-01-23,21.7 ( -0.46 %),221,665820,3012.76,233,746710,3205,-80890
2013-01-22,21.8 ( -1.8 %),489,1305440,2669.61,330,1231800,3733,73640
2013-01-21,22.2 ( -3.06 %),395,1114580,2821.72,342,1317150,3851,-202570
2013-01-18,22.9 ( 0 %),320,658450,2057.66,224,640930,2861,17520
2013-01-17,22.9 ( -2.97 %),503,1265110,2515.13,250,1484330,5937,-219220
2013-01-16,23.6 ( 1.29 %),963,3433160,3565.07,487,3031840,6226,401320
2013-01-15,23.3 ( -0.43 %),528,1301880,2465.68,276,1524710,5524,-222830
2013-01-14,23.4 ( -1.68 %),226,623080,2756.99,292,1240450,4248,-617370
2013-01-11,23.8 ( -0.83 %),317,1275900,4024.92,318,1542370,4850,-266470
2013-01-10,24 ( 0.42 %),337,1361390,4039.73,356,1499100,4211,-137710
2013-01-09,23.9 ( -0.83 %),663,2743560,4138.1,431,3103270,7200,-359710
2013-01-08,24.1 ( 4.33 %),414,1848340,4464.59,407,1941130,4769,-92790
2013-01-07,23.1 ( 5 %),410,2101330,5125.2,294,1058080,3599,1043250
2013-01-04,22 ( 3.29 %),197,876960,4451.57,308,746040,2422,130920
2013-01-03,21.3 ( 0.95 %),173,1031010,5959.6,241,997560,4139,33450
2013-01-02,21.1 ( 0.48 %),265,773110,2917.4,222,690710,3111,82400
2012-12-28,21 ( 0.48 %),122,379190,3108.11,215,567090,2638,-187900
2012-12-27,20.9 ( 1.46 %),143,613410,4289.58,176,542470,3082,70940
2012-12-26,20.6 ( -1.9 %),288,710790,2468.02,150,777220,5181,-66430
2012-12-25,21 ( 2.44 %),188,676450,3598.14,256,941800,3679,-265350
2012-12-24,20.5 ( -0.97 %),183,516850,2824.32,116,578270,4985,-61420
2012-12-21,20.7 ( 3.5 %),220,1128240,5128.36,282,1284170,4554,-155930
2012-12-20,20 ( -0.5 %),160,593660,3710.38,233,972380,4173,-378720
2012-12-19,20.1 ( 2.55 %),128,817940,6390.16,240,896210,3734,-78270
2012-12-18,19.6 ( -1.51 %),173,586350,3389.31,267,813000,3045,-226650
2012-12-17,19.9 ( 3.65 %),213,672340,3156.53,210,598410,2850,73930
2012-12-14,19.2 ( -1.54 %),208,268540,1291.06,95,273420,2878,-4880
2012-12-13,19.5 ( -1.52 %),174,323320,1858.16,96,317460,3307,5860
2012-12-12,19.8 ( 0.51 %),191,453240,2372.98,134,493790,3685,-40550
2012-12-11,19.7 ( 2.6 %),102,334810,3282.45,175,618710,3535,-283900
2012-12-10,19.2 ( 1.05 %),70,162110,2315.86,86,137720,1601,24390
2012-12-07,19 ( -1.04 %),94,295230,3140.74,114,328810,2884,-33580
2012-12-06,19.2 ( 1.05 %),118,380940,3228.31,168,463190,2757,-82250
2012-12-05,19 ( 0 %),92,275060,2989.78,221,350300,1585,-75240
2012-12-04,19 ( 1.06 %),149,426240,2860.67,245,517690,2113,-91450
2012-12-03,18.8 ( 3.3 %),96,442940,4613.96,143,427720,2991,15220
2012-11-30,18.2 ( -2.15 %),185,332900,1799.46,243,501250,2063,-168350
2012-11-29,18.6 ( 1.64 %),76,186570,2454.87,174,332260,1910,-145690
2012-11-28,18.3 ( 0 %),79,130320,1649.62,48,60090,1252,70230
2012-11-27,18.3 ( 1.67 %),97,229270,2363.61,125,211610,1693,17660
2012-11-26,18 ( -0.55 %),66,105260,1594.85,43,46210,1075,59050
2012-11-23,18.1 ( -3.21 %),89,101640,1142.02,63,93910,1491,7730
2012-11-22,18.7 ( 3.89 %),53,160750,3033.02,57,48550,852,112200
2012-11-21,18 ( -3.23 %),134,183930,1372.61,101,195330,1934,-11400
2012-11-20,18.6 ( 0 %),61,223010,3655.9,108,239070,2214,-16060
2012-11-19,18.6 ( 0 %),38,54270,1428.16,56,58800,1050,-4530
2012-11-16,18.6 ( -1.06 %),84,198460,2362.62,76,198310,2609,150
2012-11-15,18.8 ( 1.62 %),85,214270,2520.82,183,192520,1052,21750
2012-11-14,18.5 ( 3.93 %),78,240380,3081.79,124,200650,1618,39730
2012-11-13,17.8 ( -2.2 %),66,87120,1320,63,82860,1315,4260
2012-11-12,18.2 ( -1.09 %),57,44740,784.91,58,82510,1423,-37770
2012-11-09,18.4 ( -1.08 %),61,82000,1344.26,91,186990,2055,-104990
2012-11-08,18.6 ( 3.33 %),61,227580,3730.82,105,250460,2385,-22880
2012-11-07,18 ( 4.65 %),73,201220,2756.44,73,81520,1117,119700
2012-11-06,17.2 ( 0.58 %),91,150810,1657.25,50,65180,1304,85630
2012-11-05,17.1 ( -1.72 %),89,139000,1561.8,56,104340,1863,34660
2012-11-02,17.4 ( -4.4 %),107,220390,2059.72,95,136480,1437,83910
2012-11-01,18.2 ( -2.15 %),120,333190,2776.58,86,222630,2589,110560
2012-10-31,18.6 ( -1.06 %),62,180940,2918.39,85,206230,2426,-25290
2012-10-30,18.8 ( -0.53 %),63,152940,2427.62,108,210810,1952,-57870
2012-10-29,18.9 ( -2.58 %),135,194320,1439.41,98,194470,1984,-150
2012-10-26,19.4 ( 2.11 %),127,267250,2104.33,112,256230,2288,11020
2012-10-25,19 ( 2.15 %),194,466500,2404.64,143,453250,3170,13250
2012-10-24,23.3 ( -0.85 %),156,244890,1569.81,142,531250,3741,-286360
2012-10-23,23.5 ( 1.73 %),120,457970,3816.42,181,343890,1900,114080
2012-10-22,23.1 ( 0 %),126,212700,1688.1,97,215030,2217,-2330
2012-10-19,23.1 ( -1.7 %),139,239300,1721.58,180,281070,1562,-41770
2012-10-18,23.5 ( 2.62 %),183,398110,2175.46,211,506740,2402,-108630
2012-10-17,22.9 ( 4.57 %),228,824620,3616.75,130,336170,2586,488450
2012-10-16,21.9 ( 3.79 %),153,223070,1457.97,103,129860,1261,93210
2012-10-15,21.1 ( -2.31 %),79,92410,1169.75,87,119690,1376,-27280
2012-10-12,21.6 ( 0 %),95,148240,1560.42,66,226900,3438,-78660
2012-10-11,21.6 ( 0.93 %),106,178470,1683.68,144,212160,1473,-33690
2012-10-10,21.4 ( 0 %),84,123030,1464.64,58,82250,1418,40780
2012-10-09,21.4 ( -1.83 %),120,339350,2827.92,92,159750,1736,179600
2012-10-08,21.8 ( 0.93 %),85,255040,3000.47,85,144610,1701,110430
2012-10-05,21.6 ( 1.41 %),123,309690,2517.8,152,364090,2395,-54400
2012-10-04,21.3 ( 2.4 %),105,551340,5250.86,180,392080,2178,159260
2012-10-03,20.8 ( 4 %),71,263970,3717.89,128,213890,1671,50080
2012-10-02,20 ( -0.99 %),63,206410,3276.35,52,69910,1344,136500
2012-10-01,20.2 ( 4.66 %),175,1083750,6192.86,127,657870,5180,425880
2012-09-28,19.3 ( -2.03 %),112,375620,3353.75,80,312900,3911,62720
2012-09-27,19.7 ( -1.5 %),77,275830,3582.21,69,165390,2397,110440
2012-09-26,20 ( -0.5 %),166,630720,3799.52,115,411410,3577,219310
2012-09-25,20.1 ( -3.37 %),225,884080,3929.24,195,850410,4361,33670
2012-09-24,20.8 ( -4.59 %),122,276270,2264.51,154,546090,3546,-269820
2012-09-21,21.8 ( 4.81 %),202,1466890,7261.83,160,1044370,6527,422520
2012-09-20,20.8 ( -4.59 %),151,493960,3271.26,126,825570,6552,-331610
2012-09-19,21.8 ( 2.35 %),174,564050,3241.67,142,562970,3965,1080
2012-09-18,21.3 ( -4.91 %),290,901180,3107.52,390,1289680,3307,-388500
2012-09-17,22.4 ( 4.67 %),165,775160,4697.94,124,241340,1946,533820
2012-09-14,21.4 ( 4.9 %),102,330610,3241.27,99,97580,986,233030
2012-09-13,20.4 ( 4.62 %),130,537840,4137.23,102,213620,2094,324220
2012-09-12,19.5 ( -0.51 %),128,322900,2522.66,72,258430,3589,64470
2012-09-11,19.6 ( -3.92 %),117,198020,1692.48,52,183540,3530,14480
2012-09-10,20.4 ( -4.67 %),87,377350,4337.36,95,604670,6365,-227320
2012-09-07,21.4 ( -0.47 %),64,162910,2545.47,79,208270,2636,-45360
2012-09-06,21.5 ( -0.92 %),45,80910,1798,67,82020,1224,-1110
2012-09-05,21.7 ( -1.36 %),91,139740,1535.6,75,137590,1835,2150
2012-09-04,22 ( 1.85 %),74,132670,1792.84,73,145200,1989,-12530
2012-08-31,21.6 ( 0 %),91,195810,2151.76,79,201880,2555,-6070
2012-08-30,21.6 ( 3.85 %),80,224850,2810.62,105,229850,2189,-5000
2012-08-29,20.8 ( 4.52 %),64,108190,1690.47,74,84290,1139,23900
2012-08-28,19.9 ( 2.58 %),81,289790,3577.65,117,172630,1475,117160
2012-08-27,19.4 ( -4.9 %),88,365330,4151.48,86,449320,5225,-83990
2012-08-24,20.4 ( 2.51 %),206,514420,2497.18,147,338280,2301,176140
2012-08-23,19.9 ( -4.78 %),93,417590,4490.22,129,605020,4690,-187430
2012-08-22,20.9 ( -4.13 %),105,297010,2828.67,109,355820,3264,-58810
2012-08-21,21.8 ( -4.8 %),136,569460,4187.21,183,758820,4147,-189360
2012-08-20,22.9 ( 0.44 %),61,167330,2743.11,100,167220,1672,110
2012-08-17,22.8 ( 0.44 %),73,311180,4262.74,85,236560,2783,74620
2012-08-16,22.7 ( -0.44 %),39,95220,2441.54,56,92060,1644,3160
2012-08-15,22.8 ( -0.44 %),35,119310,3408.86,83,145270,1750,-25960
2012-08-14,22.9 ( 0.44 %),60,136320,2272,63,171010,2714,-34690
2012-08-13,22.8 ( 0 %),51,89740,1759.61,48,85400,1779,4340
2012-08-10,22.8 ( -1.72 %),50,60100,1202,68,109060,1604,-48960
2012-08-09,23.2 ( 1.31 %),76,118740,1562.37,97,128560,1325,-9820
2012-08-08,22.9 ( 0 %),73,259360,3552.88,57,372690,6538,-113330
2012-08-07,22.9 ( 0 %),38,89680,2360,77,280430,3642,-190750
2012-08-06,22.9 ( 0 %),95,214490,2257.79,98,227700,2323,-13210
2012-08-03,22.9 ( 0.88 %),58,117760,2030.34,40,48690,1217,69070
2012-08-02,22.7 ( -0.44 %),53,113470,2140.94,54,232670,4309,-119200
2012-08-01,22.8 ( -0.87 %),67,139540,2082.69,79,139250,1763,290
2012-07-31,23 ( 0 %),53,215950,4074.53,121,352990,2917,-137040
2012-07-30,23 ( 0 %),126,428270,3398.97,76,217640,2864,210630
2012-07-27,23 ( 0 %),81,181880,2245.43,135,300680,2227,-118800
2012-07-26,23 ( 0 %),97,361570,3727.53,99,425050,4293,-63480
2012-07-25,23 ( 0 %),112,467780,4176.61,145,450510,3107,17270
2012-07-24,23 ( -0.86 %),122,440840,3613.44,85,401250,4721,39590
2012-07-23,23.2 ( 0.87 %),155,439210,2833.61,135,355920,2636,83290
2012-07-20,23 ( -1.71 %),126,496190,3938.02,167,689000,4126,-192810
2012-07-19,23.4 ( 1.3 %),160,737460,4609.12,132,497180,3767,240280
2012-07-18,23.1 ( 0 %),74,167170,2259.05,95,236300,2487,-69130
2012-07-17,23.1 ( 0.43 %),217,986280,4545.07,178,771700,4335,214580
2012-07-16,23 ( -1.29 %),80,243670,3045.88,97,362490,3737,-118820
2012-07-13,23.3 ( 1.75 %),132,463270,3509.62,105,454960,4333,8310
2012-07-12,22.9 ( 1.33 %),66,242720,3677.58,52,146360,2815,96360
2012-07-10,22.6 ( -1.74 %),121,562170,4646.03,104,457850,4402,104320
2012-07-09,23 ( -0.86 %),85,407860,4798.35,143,418860,2929,-11000
2012-07-06,23.2 ( -0.85 %),84,183130,2180.12,61,183590,3010,-460
2012-07-05,23.4 ( -0.43 %),62,112360,1812.26,71,150460,2119,-38100
2012-07-04,23.5 ( 0 %),68,303430,4462.21,61,161410,2646,142020
2012-07-03,23.5 ( -1.67 %),97,789380,8137.94,169,638610,3779,150770
2012-07-02,23.9 ( -0.42 %),45,226830,5040.67,102,208250,2042,18580
2012-06-29,24 ( 0 %),51,218940,4292.94,122,244380,2003,-25440
2012-06-28,24 ( -1.64 %),62,240980,3886.77,111,274310,2471,-33330
2012-06-27,24.4 ( 1.67 %),74,506590,6845.81,107,187360,1751,319230
2012-06-26,24 ( -1.23 %),66,281760,4269.09,141,247980,1759,33780
2012-06-25,24.3 ( 0 %),74,396270,5355,117,204380,1747,191890
2012-06-22,24.3 ( 0 %),86,396420,4609.53,89,169400,1903,227020
2012-06-21,24.3 ( 0 %),100,392770,3927.7,75,139910,1865,252860
2012-06-20,24.3 ( 0 %),108,410020,3796.48,92,189200,2057,220820
2012-06-19,0 ( 0 %),141,481370,3413.97,143,348000,2434,133370
2012-06-18,25 ( 1.21 %),127,408010,3212.68,183,297180,1624,110830
2012-06-15,24.7 ( 4.66 %),195,1479180,7585.54,273,924590,3387,554590
2012-06-14,23.6 ( -0.42 %),122,509520,4176.39,140,438130,3130,71390
2012-06-13,23.7 ( -0.84 %),97,514160,5300.62,135,421490,3122,92670
2012-06-12,23.9 ( -0.42 %),102,342630,3359.12,191,340290,1782,2340
2012-06-11,24 ( 0 %),114,565860,4963.68,148,286990,1939,278870
2012-06-08,24 ( -0.41 %),82,411250,5015.24,154,370090,2403,41160
2012-06-07,24.1 ( 2.12 %),237,1231070,5194.39,128,515960,4031,715110
2012-06-06,23.6 ( 2.61 %),171,1234190,7217.49,140,434440,3103,799750
2012-06-05,23 ( 0 %),210,1092970,5204.62,138,899040,6515,193930
2012-06-04,23 ( -4.17 %),161,921410,5723.04,233,870160,3735,51250
2012-06-01,24 ( 0 %),112,582130,5197.59,124,459030,3702,123100
2012-05-31,24 ( -0.41 %),192,858330,4470.47,133,520210,3911,338120
2012-05-30,24.1 ( -1.23 %),153,392660,2566.41,120,282640,2355,110020
2012-05-29,24.4 ( -1.21 %),139,426650,3069.42,159,506470,3185,-79820
2012-05-28,24.7 ( -1.2 %),105,194940,1856.57,157,291640,1858,-96700
2012-05-25,25 ( 3.73 %),242,1118280,4620.99,183,838670,4583,279610
2012-05-24,24.1 ( -2.03 %),198,1147780,5796.87,186,848100,4560,299680
2012-05-23,24.6 ( -0.4 %),133,892410,6709.85,237,777610,3281,114800
2012-05-22,24.7 ( 0 %),131,785250,5994.27,185,417760,2258,367490
2012-05-21,24.7 ( 2.92 %),272,1713990,6301.43,191,666840,3491,1047150
2012-05-18,24 ( -1.64 %),287,2037100,7097.91,340,1365870,4017,671230
2012-05-17,24.4 ( -0.81 %),261,938990,3597.66,221,837080,3788,101910
2012-05-16,24.6 ( -1.2 %),321,1373460,4278.69,346,1357810,3924,15650
2012-05-15,24.9 ( -3.49 %),356,1490950,4188.06,397,1752480,4414,-261530
2012-05-14,25.8 ( -4.8 %),315,1078010,3422.25,457,1403830,3072,-325820
2012-05-11,27.1 ( 0.37 %),327,1549180,4737.55,666,1723360,2588,-174180
2012-05-10,27 ( 0.37 %),288,918450,3189.06,506,1366670,2701,-448220
2012-05-09,26.9 ( -0.37 %),360,1058990,2941.64,393,1163690,2961,-104700
2012-05-08,27 ( 3.05 %),585,2390630,4086.55,796,2050370,2576,340260
2012-05-07,26.2 ( 1.16 %),378,1153520,3051.64,453,1514990,3344,-361470
2012-05-04,25.9 ( 3.19 %),247,762710,3087.89,382,845750,2214,-83040
2012-05-03,25.1 ( -0.4 %),309,965260,3123.82,254,784040,3087,181220
2012-05-02,25.2 ( -3.08 %),380,1015200,2671.58,429,1255960,2928,-240760
2012-04-27,26 ( 1.17 %),288,825320,2865.69,332,939670,2830,-114350
2012-04-26,25.7 ( -2.28 %),294,1079470,3671.67,520,1592110,3062,-512640
2012-04-25,26.3 ( 3.54 %),330,1079780,3272.06,477,1071280,2246,8500
2012-04-24,25.4 ( 2.01 %),406,1185700,2920.44,249,903350,3628,282350
2012-04-23,24.9 ( -0.4 %),404,890700,2204.7,329,1003030,3049,-112330
2012-04-20,25 ( 0 %),558,1277600,2289.61,341,964220,2828,313380
2012-04-19,25 ( -2.72 %),723,2170450,3002.01,586,2346600,4004,-176150
2012-04-18,25.7 ( -3.38 %),1106,3330210,3011.04,707,3910330,5531,-580120
2012-04-17,26.6 ( -1.48 %),870,2508680,2883.54,666,2720840,4085,-212160
2012-04-16,27 ( 4.65 %),480,1666580,3472.04,395,1049060,2656,617520
2012-04-13,25.8 ( -0.39 %),502,1818890,3623.29,680,2535710,3729,-716820
2012-04-12,25.9 ( 4.86 %),855,4173410,4881.18,405,2170140,5358,2003270
2012-04-11,24.7 ( 4.66 %),1086,5158960,4750.42,603,3162100,5244,1996860
2012-04-10,23.6 ( 1.72 %),414,1711530,4134.13,485,1633730,3369,77800
2012-04-09,23.2 ( 0 %),341,932640,2735.01,397,1341980,3380,-409340
2012-04-06,23.2 ( -1.28 %),229,571180,2494.24,346,1254750,3626,-683570
2012-04-05,23.5 ( 2.17 %),219,1134620,5180.91,325,1237470,3808,-102850
2012-04-04,23 ( -1.29 %),141,675550,4791.13,220,849690,3862,-174140
2012-04-03,23.3 ( 0.87 %),203,798430,3933.15,250,736170,2945,62260
2012-03-30,23.1 ( 1.32 %),265,1445110,5453.25,445,1260890,2833,184220
2012-03-29,22.8 ( 0 %),206,998230,4845.78,270,742540,2750,255690
2012-03-28,22.8 ( -0.44 %),205,821670,4008.15,181,499810,2761,321860
2012-03-27,22.9 ( -0.43 %),311,1314830,4227.75,427,1539180,3605,-224350
2012-03-26,23 ( -0.43 %),276,697320,2526.52,365,887130,2430,-189810
2012-03-23,23.1 ( 0 %),339,881380,2599.94,365,1043000,2858,-161620
2012-03-22,23.1 ( -0.86 %),312,893350,2863.3,334,910930,2727,-17580
2012-03-21,23.3 ( 2.19 %),371,1468120,3957.2,503,1676560,3333,-208440
2012-03-20,22.8 ( 1.79 %),284,998270,3515.04,363,1163780,3206,-165510
2012-03-19,22.4 ( 1.36 %),341,1485050,4354.99,425,1486550,3498,-1500
2012-03-16,22.1 ( -4.74 %),435,1775460,4081.52,483,2852070,5905,-1076610
2012-03-15,23.2 ( 4.5 %),358,1807500,5048.88,252,1536560,6097,270940
2012-03-14,22.2 ( 0 %),248,950100,3831.05,280,1663090,5940,-712990
2012-03-13,22.2 ( 0.91 %),348,1093120,3141.15,195,819170,4201,273950
2012-03-12,22 ( -4.35 %),236,834520,3536.1,350,1092830,3122,-258310
2012-03-09,23 ( -0.43 %),466,2049840,4398.8,465,2424310,5214,-374470
2012-03-08,23.1 ( -4.94 %),417,1390230,3333.88,420,2341040,5574,-950810
2012-03-07,24.3 ( 1.25 %),475,1937360,4078.65,448,1749000,3904,188360
2012-03-06,24 ( -3.23 %),525,1812100,3451.62,611,3133690,5129,-1321590
2012-03-05,24.8 ( 4.64 %),498,2439920,4899.44,188,957810,5095,1482110
2012-03-02,23.7 ( 2.6 %),295,1222480,4144,381,1465020,3845,-242540
2012-03-01,23.1 ( 0.43 %),262,975280,3722.44,275,969190,3524,6090
2012-02-29,23 ( 2.68 %),398,1843810,4632.69,350,1238050,3537,605760
2012-02-28,22.4 ( -4.68 %),503,1864380,3706.52,594,2246210,3781,-381830
2012-02-27,23.5 ( 4.91 %),394,1798900,4565.74,372,1339590,3601,459310
2012-02-24,22.4 ( 4.67 %),404,2327920,5762.18,282,1219810,4326,1108110
2012-02-23,21.4 ( 4.9 %),376,1899050,5050.66,335,1137540,3396,761510
2012-02-22,20.4 ( 4.62 %),263,1086210,4130.08,324,955260,2948,130950
2012-02-21,19.5 ( -2.01 %),239,593910,2484.98,294,890450,3029,-296540
2012-02-20,19.9 ( 4.74 %),266,813630,3058.76,205,641110,3127,172520
2012-02-17,19 ( 1.06 %),169,305600,1808.28,154,424630,2757,-119030
2012-02-16,18.8 ( -0.53 %),170,521700,3068.82,171,460730,2694,60970
2012-02-15,18.9 ( -1.56 %),205,584460,2851.02,257,731940,2848,-147480
2012-02-14,19.2 ( 2.13 %),301,1123170,3731.46,186,606310,3260,516860
2012-02-13,18.8 ( -4.57 %),223,526990,2363.18,227,762320,3358,-235330
2012-02-10,19.7 ( -4.83 %),222,529460,2384.95,325,1362570,4193,-833110
2012-02-09,20.7 ( 2.99 %),280,1067150,3811.25,365,1307690,3583,-240540
2012-02-08,20.1 ( 4.69 %),262,1189420,4539.77,277,722550,2608,466870
2012-02-07,19.2 ( -0.52 %),253,1064800,4208.7,367,1022750,2787,42050
2012-02-06,19.3 ( 3.76 %),231,987790,4276.15,304,781150,2570,206640
2012-02-03,18.6 ( 0.54 %),376,1555840,4137.87,377,1765630,4683,-209790
2012-02-02,18.5 ( 4.52 %),313,1115020,3562.36,152,437790,2880,677230
2012-02-01,17.7 ( 4.73 %),331,1266890,3827.46,295,938760,3182,328130
2012-01-31,16.9 ( 0.6 %),263,763390,2902.62,211,738750,3501,24640
2012-01-30,16.8 ( 4.35 %),158,494480,3129.62,102,300170,2943,194310
2012-01-20,17.7 ( 1.14 %),147,636140,4327.48,226,541820,2397,94320
2012-01-19,17.5 ( 3.55 %),173,575810,3328.38,131,321140,2451,254670
2012-01-18,16.9 ( 0.6 %),80,219150,2739.38,119,190640,1602,28510
2012-01-17,16.8 ( 0 %),102,272710,2673.63,152,311630,2050,-38920
2012-01-16,16.8 ( 1.2 %),96,326590,3401.98,163,274920,1687,51670
2012-01-13,16.6 ( 1.84 %),164,267710,1632.38,197,347870,1766,-80160
2012-01-12,16.3 ( 4.49 %),265,798290,3012.42,196,490350,2502,307940
2012-01-11,15.6 ( 0 %),167,274710,1644.97,145,237180,1636,37530
2012-01-10,15.6 ( 0.65 %),215,398440,1853.21,193,294010,1523,104430
2012-01-09,15.5 ( -0.64 %),229,394390,1722.23,109,229250,2103,165140
2012-01-06,15.6 ( -3.11 %),233,649040,2785.58,234,677180,2894,-28140
2012-01-05,16.1 ( -3.01 %),236,593690,2515.64,151,466070,3087,127620
2012-01-04,16.6 ( -2.35 %),76,134920,1775.26,69,83530,1211,51390
2012-01-03,17 ( -2.86 %),98,149960,1530.2,104,163730,1574,-13770
2011-12-30,17.5 ( 2.94 %),192,546640,2847.08,176,555620,3157,-8980
2011-12-29,17 ( 0 %),108,234800,2174.07,123,184330,1499,50470
2011-12-28,17 ( 4.29 %),229,563980,2462.79,121,301130,2489,262850
2011-12-27,16.3 ( -4.68 %),162,423440,2613.83,168,637200,3793,-213760
2011-12-26,17.1 ( -5 %),178,275990,1550.51,102,502260,4924,-226270
2011-12-23,18 ( -0.55 %),128,249900,1952.34,84,108850,1296,141050
2011-12-22,18.1 ( -4.74 %),234,634120,2709.91,184,1038020,5641,-403900
2011-12-21,19 ( -1.55 %),222,584070,2630.95,94,506030,5383,78040
2011-12-20,19.3 ( -1.03 %),122,303910,2491.07,125,246990,1976,56920
2011-12-19,19.5 ( -2.5 %),199,332080,1668.74,175,352600,2015,-20520
2011-12-16,20 ( 3.09 %),206,1117740,5425.92,288,946050,3285,171690
2011-12-15,19.4 ( 1.57 %),171,616070,3602.75,183,436190,2384,179880
2011-12-14,19.1 ( 0.53 %),122,514330,4215.82,177,465530,2630,48800
2011-12-13,19 ( -0.52 %),232,557480,2402.93,122,402260,3297,155220
2011-12-12,19.1 ( -0.52 %),177,595670,3365.37,139,466340,3355,129330
2011-12-09,19.2 ( -3.03 %),262,644570,2460.19,178,743680,4178,-99110
2011-12-08,19.8 ( -3.88 %),281,785710,2796.12,235,763360,3248,22350
2011-12-07,20.6 ( 0 %),198,639870,3231.67,198,413850,2090,226020
2011-12-06,20.6 ( 2.49 %),328,1032500,3147.87,406,891510,2196,140990
2011-12-05,20.1 ( 4.69 %),257,768800,2991.44,158,460440,2914,308360
2011-12-02,19.2 ( 1.59 %),243,670550,2759.47,147,547610,3725,122940
2011-12-01,18.9 ( 0 %),173,259750,1501.45,129,361980,2806,-102230
2011-11-30,18.9 ( -3.57 %),289,629380,2177.79,217,865810,3990,-236430
2011-11-29,19.6 ( -1.51 %),158,271500,1718.35,143,411090,2875,-139590
2011-11-28,19.9 ( 0 %),252,770360,3056.98,179,979970,5475,-209610
2011-11-25,19.9 ( -1.97 %),170,447180,2630.47,237,709270,2993,-262090
2011-11-24,20.3 ( 3.05 %),444,1348300,3036.71,414,1040030,2512,308270
2011-11-23,19.7 ( 4.23 %),314,1171940,3732.29,233,805580,3457,366360
2011-11-22,18.9 ( 1.07 %),213,690280,3240.75,184,535550,2911,154730
2011-11-21,18.7 ( -1.58 %),140,361090,2579.21,125,425240,3402,-64150
2011-11-18,19 ( -2.06 %),217,619650,2855.53,140,386090,2758,233560
2011-11-17,19.4 ( -1.02 %),247,578060,2340.32,273,854340,3129,-276280
2011-11-16,19.6 ( 3.16 %),417,1354040,3247.1,238,1046020,4395,308020
2011-11-15,19 ( -5 %),345,701800,2034.2,222,1028820,4634,-327020
2011-11-14,20 ( -2.91 %),252,790220,3135.79,181,585810,3237,204410
2011-11-11,20.6 ( -2.83 %),225,299260,1330.04,129,233470,1810,65790
2011-11-10,21.2 ( -4.93 %),286,555870,1943.6,163,590000,3620,-34130
2011-11-09,22.3 ( -1.33 %),225,365960,1626.49,155,353570,2281,12390
2011-11-08,22.6 ( -3 %),438,927270,2117.05,229,928900,4056,-1630
2011-11-07,23.3 ( -4.9 %),289,463450,1603.63,165,661720,4010,-198270
2011-11-04,24.5 ( -1.21 %),184,188770,1025.92,128,216050,1688,-27280
2011-11-03,24.8 ( -1.2 %),240,512640,2136,122,523160,4288,-10520
2011-11-02,25.1 ( -4.2 %),365,715460,1960.16,198,748210,3779,-32750
2011-11-01,26.2 ( -1.87 %),192,309580,1612.4,121,480310,3970,-170730
2011-10-31,26.7 ( -2.2 %),89,136190,1530.22,156,326990,2096,-190800
2011-10-28,27.3 ( 3.02 %),175,552540,3157.37,165,518220,3141,34320
2011-10-27,26.5 ( -0.38 %),83,93170,1122.53,92,199750,2171,-106580
2011-10-26,26.6 ( 1.53 %),92,282840,3074.35,111,195260,1759,87580
2011-10-25,26.2 ( -0.38 %),135,307900,2280.74,105,364990,3476,-57090
2011-10-24,26.3 ( -0.75 %),75,137170,1828.93,96,188660,1965,-51490
2011-10-21,26.5 ( 0.38 %),164,357300,2178.66,117,243130,2078,114170
2011-10-20,26.4 ( -0.38 %),118,273310,2316.19,75,266470,3553,6840
2011-10-19,26.5 ( -0.75 %),128,363620,2840.78,91,522190,5738,-158570
2011-10-18,26.7 ( -0.37 %),140,512840,3663.14,132,430820,3264,82020
2011-10-17,26.8 ( -1.11 %),151,467790,3097.95,105,443800,4227,23990
2011-10-14,27.1 ( 0.74 %),128,297480,2324.06,111,311480,2806,-14000
2011-10-13,26.9 ( -0.37 %),230,817490,3554.3,158,813090,5146,4400
2011-10-12,27 ( -1.1 %),171,538960,3151.81,160,582980,3644,-44020
2011-10-11,27.3 ( -0.36 %),106,300530,2835.19,121,327160,2704,-26630
2011-10-10,27.4 ( 0 %),130,600800,4621.54,127,508890,4007,91910
2011-10-07,27.4 ( -0.36 %),131,491500,3751.91,123,427000,3472,64500
2011-10-06,27.5 ( 0 %),241,806680,3347.22,156,790960,5070,15720
2011-10-05,27.5 ( 0 %),115,434050,3774.35,144,377300,2620,56750
2011-10-04,27.5 ( 0.73 %),160,706180,4413.62,290,627260,2163,78920
2011-10-03,27.3 ( -1.09 %),134,471150,3516.04,182,396140,2177,75010
2011-09-30,27.6 ( 0.36 %),181,607620,3357.02,160,446300,2789,161320
2011-09-29,27.5 ( -0.72 %),146,445620,3052.19,152,435810,2867,9810
2011-09-28,27.7 ( 0.73 %),235,640640,2726.13,162,406910,2512,233730
2011-09-27,27.5 ( -0.72 %),307,620720,2021.89,199,688490,3460,-67770
2011-09-26,27.7 ( -1.77 %),402,840720,2091.34,211,760120,3602,80600
2011-09-23,28.2 ( -2.08 %),251,616540,2456.33,181,452000,2497,164540
2011-09-22,28.8 ( 2.86 %),301,565210,1877.77,138,389670,2824,175540
2011-09-21,28 ( -1.75 %),230,554850,2412.39,163,528750,3244,26100
2011-09-20,28.5 ( -1.72 %),242,574390,2373.51,211,625850,2966,-51460
2011-09-19,29 ( 3.94 %),315,808450,2566.51,200,470540,2353,337910
2011-09-16,27.9 ( -2.45 %),411,1217380,2962,246,1264520,5140,-47140
2011-09-15,28.6 ( -1.38 %),388,963770,2483.94,164,736240,4489,227530
2011-09-14,29 ( -3.97 %),422,792320,1877.54,229,873970,3816,-81650
2011-09-13,30.2 ( 0.67 %),286,667990,2335.63,200,699490,3497,-31500
2011-09-12,30 ( -2.28 %),359,855160,2382.06,259,1160960,4482,-305800
2011-09-09,30.7 ( 0.66 %),230,703950,3060.65,307,827330,2695,-123380
2011-09-08,30.5 ( 2.35 %),353,1388740,3934.11,371,1133170,3054,255570
2011-09-07,29.8 ( 1.36 %),185,678850,3669.46,235,661440,2815,17410
2011-09-06,29.4 ( -0.68 %),192,743060,3870.1,334,775650,2322,-32590
2011-09-05,29.6 ( 1.37 %),342,1245740,3642.51,397,1345280,3389,-99540
2011-09-01,29.2 ( 0.34 %),195,608840,3122.26,248,694760,2801,-85920
2011-08-31,29.1 ( 0.34 %),214,742880,3471.4,258,786120,3047,-43240
2011-08-30,29 ( 0 %),245,571450,2332.45,296,885590,2992,-314140
2011-08-29,29 ( 3.94 %),166,634950,3825,249,713180,2864,-78230
2011-08-26,27.9 ( -0.36 %),196,634280,3236.12,215,649200,3020,-14920
2011-08-25,28 ( 0 %),248,454890,1834.23,221,529130,2394,-74240
2011-08-24,28 ( -2.78 %),194,669330,3450.15,206,809980,3932,-140650
2011-08-23,28.8 ( -0.69 %),225,462720,2056.53,199,380870,1914,81850
2011-08-22,29 ( 3.94 %),274,568010,2073.03,204,591090,2898,-23080
2011-08-19,27.9 ( -3.79 %),216,218720,1012.59,209,455060,2177,-236340
2011-08-18,29 ( 3.94 %),138,286600,2076.81,191,365820,1915,-79220
2011-08-17,27.9 ( 3.33 %),141,337810,2395.82,178,240370,1350,97440
2011-08-16,27 ( 0.37 %),116,225900,1947.41,115,163480,1422,62420
2011-08-15,26.9 ( 0.75 %),86,174020,2023.49,93,68270,734,105750
2011-08-12,26.7 ( -0.74 %),172,263980,1534.77,117,320760,2742,-56780
2011-08-11,26.9 ( -1.1 %),121,243810,2014.96,98,216750,2212,27060
2011-08-10,27.2 ( -0.73 %),161,345950,2148.76,110,298540,2714,47410
2011-08-09,27.4 ( -4.2 %),148,361110,2439.93,115,296270,2576,64840
2011-08-08,28.6 ( -3.05 %),140,294340,2102.43,129,342420,2654,-48080
2011-08-05,29.5 ( 0.34 %),103,436830,4241.07,120,334960,2791,101870
2011-08-04,29.4 ( 1.03 %),157,463100,2949.68,115,365620,3179,97480
2011-08-03,29.1 ( -1.36 %),163,518560,3181.35,102,308380,3023,210180
2011-08-02,29.5 ( -0.67 %),93,311470,3349.14,118,219960,1864,91510
2011-08-01,29.7 ( -1.98 %),75,343820,4584.27,98,126330,1289,217490
2011-07-29,30.3 ( 2.02 %),63,333460,5293.02,194,370010,1907,-36550
2011-07-28,29.7 ( 0.34 %),88,348230,3957.16,147,263180,1790,85050
2011-07-27,29.6 ( 1.37 %),104,289690,2785.48,134,176790,1319,112900
2011-07-26,29.2 ( 0.34 %),116,344140,2966.72,144,262710,1824,81430
2011-07-25,29.1 ( 0.69 %),138,379970,2753.41,84,181400,2160,198570
2011-07-22,28.9 ( 0 %),99,246810,2493.03,51,101170,1984,145640
2011-07-21,28.9 ( -4.3 %),210,426100,2029.05,121,430360,3557,-4260
2011-07-20,30.2 ( 4.86 %),127,360920,2841.89,106,185650,1751,175270
2011-07-19,28.8 ( -0.35 %),89,262170,2945.73,62,92580,1493,169590
2011-07-18,28.9 ( 0.35 %),168,320700,1908.93,71,198220,2792,122480
2011-07-15,28.8 ( -1.37 %),143,319640,2235.24,75,161600,2155,158040
2011-07-14,29.2 ( -0.68 %),149,281950,1892.28,92,256100,2784,25850
2011-07-13,29.4 ( 1.73 %),183,357140,1951.58,115,316480,2752,40660
2011-07-12,28.9 ( -2.69 %),191,434480,2274.76,85,328080,3860,106400
2011-07-11,29.7 ( 0 %),87,139340,1601.61,61,130710,2143,8630
2011-07-08,29.7 ( -1.66 %),206,419690,2037.33,91,374080,4111,45610
2011-07-07,30.2 ( -2.58 %),161,281910,1750.99,71,199670,2812,82240
2011-07-06,31 ( -1.27 %),45,90510,2011.33,106,204720,1931,-114210
2011-07-05,31.4 ( 0 %),84,197370,2349.64,106,278270,2625,-80900
2011-07-04,31.4 ( 4.67 %),191,584260,3058.95,124,406220,3276,178040
2011-07-01,30 ( -1.96 %),188,293600,1561.7,81,335910,4147,-42310
2011-06-30,30.6 ( -1.61 %),233,346420,1486.78,106,282110,2661,64310
2011-06-29,31.1 ( -1.27 %),136,220110,1618.46,124,181570,1464,38540
2011-06-28,31.5 ( 0.96 %),193,303040,1570.16,77,149500,1942,153540
2011-06-27,31.2 ( -1.89 %),215,365110,1698.19,121,385850,3189,-20740
2011-06-24,31.8 ( -0.93 %),146,389570,2668.29,121,435170,3596,-45600
2011-06-23,32.1 ( -2.73 %),158,183340,1160.38,121,267420,2210,-84080
2011-06-22,33 ( 1.54 %),80,261790,3272.38,142,290030,2042,-28240
2011-06-21,32.5 ( 3.17 %),118,255610,2166.19,58,68440,1180,187170
2011-06-20,31.5 ( -0.63 %),142,209700,1476.76,95,235780,2482,-26080
2011-06-17,31.7 ( -4.52 %),200,526350,2631.75,125,559790,4478,-33440
2011-06-16,33.2 ( 1.53 %),87,415340,4774.02,144,318640,2213,96700
2011-06-15,32.7 ( -2.1 %),118,280610,2378.05,154,315020,2046,-34410
2011-06-14,33.4 ( -0.89 %),115,216910,1886.17,165,403430,2445,-186520
2011-06-13,33.7 ( -0.88 %),109,187120,1716.7,113,289540,2562,-102420
2011-06-10,34 ( -0.29 %),74,175860,2376.49,181,448760,2479,-272900
2011-06-09,34.1 ( 0.29 %),49,194490,3969.18,90,243950,2711,-49460
2011-06-08,34 ( -2.58 %),131,276500,2110.69,168,441660,2629,-165160
2011-06-07,34.9 ( 4.18 %),114,262450,2302.19,133,338530,2545,-76080
2011-06-06,33.5 ( -2.9 %),91,172810,1899.01,112,160070,1429,12740
2011-06-03,34.5 ( 0 %),192,617610,3216.72,274,901600,3291,-283990
2011-06-02,34.5 ( 2.68 %),211,572210,2711.9,215,736930,3428,-164720
2011-06-01,33.6 ( 5 %),150,486440,3242.93,125,313900,2511,172540
2011-05-31,32 ( 4.92 %),154,404700,2627.92,142,303630,2138,101070
2011-05-30,30.5 ( -3.17 %),105,175030,1666.95,171,466730,2729,-291700
2011-05-27,31.5 ( 5 %),166,305460,1840.12,105,200530,1910,104930
2011-05-26,30 ( 4.9 %),231,666340,2884.59,84,184240,2193,482100
2011-05-25,28.6 ( -4.35 %),149,545180,3658.93,175,511590,2923,33590
2011-05-24,29.9 ( -3.55 %),193,569410,2950.31,136,298720,2196,270690
2011-05-23,31 ( -4.02 %),122,378430,3101.89,149,299710,2011,78720
2011-05-20,32.3 ( -5 %),113,234870,2078.5,147,429520,2922,-194650
2011-05-19,34 ( -0.29 %),89,263330,2958.76,142,245730,1730,17600
2011-05-18,34.1 ( -0.58 %),108,265170,2455.28,131,201690,1540,63480
2011-05-17,34.3 ( -1.72 %),75,282590,3767.87,106,353100,3331,-70510
2011-05-16,34.9 ( -0.29 %),60,252780,4213,113,343400,3039,-90620
2011-05-13,35 ( 0.86 %),108,343880,3184.07,115,288420,2508,55460
2011-05-12,34.7 ( -1.42 %),71,157920,2224.23,92,230980,2511,-73060
2011-05-11,35.2 ( 0 %),77,187960,2441.04,62,181080,2921,6880
2011-05-10,35.2 ( 0.28 %),129,402280,3118.45,110,400230,3638,2050
2011-05-09,35.1 ( -0.28 %),133,448460,3371.88,127,508830,4007,-60370
2011-05-06,35.2 ( -0.28 %),166,402830,2426.69,199,680470,3419,-277640
2011-05-05,35.3 ( 0.28 %),83,306790,3696.27,159,335730,2112,-28940
2011-05-04,35.2 ( 2.92 %),119,385070,3235.88,201,251220,1250,133850
2011-04-29,34.2 ( -0.87 %),90,129680,1440.89,131,213700,1631,-84020
2011-04-28,34.5 ( -0.86 %),134,254150,1896.64,70,135630,1938,118520
2011-04-27,34.8 ( 1.16 %),57,203040,3562.11,132,241450,1829,-38410
2011-04-26,34.4 ( -0.86 %),104,237980,2288.27,108,207070,1917,30910
2011-04-25,34.7 ( 4.2 %),81,173390,2140.62,84,117770,1402,55620
2011-04-22,33.3 ( -2.06 %),89,161380,1813.26,119,196560,1652,-35180
2011-04-21,34 ( -1.16 %),138,190820,1382.75,100,206140,2061,-15320
2011-04-20,34.4 ( -0.29 %),175,369870,2113.54,120,372970,3108,-3100
2011-04-19,34.5 ( -1.71 %),129,237190,1838.68,99,282100,2849,-44910
2011-04-18,35.1 ( -0.28 %),100,402780,4027.8,206,555300,2696,-152520
2011-04-15,35.2 ( 0.28 %),131,468040,3572.82,156,466500,2990,1540
2011-04-14,35.1 ( 0.29 %),92,338450,3678.8,142,433940,3056,-95490
2011-04-13,35 ( -0.57 %),88,204780,2327.05,94,239170,2544,-34390
2011-04-08,35.2 ( 0 %),175,615950,3519.71,281,1123140,3997,-507190
2011-04-07,35.2 ( -1.95 %),137,266530,1945.47,155,395600,2552,-129070
2011-04-06,35.9 ( 2.87 %),151,424110,2808.68,142,535700,3773,-111590
2011-04-05,34.9 ( -0.29 %),83,164720,1984.58,117,453410,3875,-288690
2011-04-04,35 ( 0.29 %),113,422700,3740.71,202,1074690,5320,-651990
2011-04-01,34.9 ( -0.29 %),170,236790,1392.88,120,357000,2975,-120210
2011-03-31,35 ( -0.57 %),119,353360,2969.41,225,814640,3621,-461280
2011-03-30,35.2 ( -2.22 %),205,1033510,5041.51,373,1844420,4945,-810910
2011-03-29,36 ( -0.28 %),125,774350,6194.8,306,1277940,4176,-503590
2011-03-28,36.1 ( 0.28 %),115,695380,6046.78,318,1140150,3585,-444770
2011-03-25,36 ( 0.56 %),108,668750,6192.13,391,1290800,3301,-622050
2011-03-24,35.8 ( 0.85 %),299,1214040,4060.33,307,1283010,4179,-68970
2011-03-23,35.5 ( 1.43 %),270,1478040,5474.22,336,1119930,3333,358110
2011-03-22,35 ( 1.45 %),288,1059660,3679.38,381,1048380,2752,11280
2011-03-21,34.5 ( -1.43 %),221,403870,1827.47,239,700970,2933,-297100
2011-03-18,35 ( 4.79 %),294,896300,3048.64,271,686150,2532,210150
2011-03-17,33.4 ( 1.83 %),231,383590,1660.56,254,642120,2528,-258530
2011-03-16,32.8 ( -1.8 %),349,541000,1550.14,162,628850,3882,-87850
2011-03-15,33.4 ( 2.77 %),263,424250,1613.12,208,457160,2198,-32910
2011-03-14,32.5 ( -4.97 %),261,553410,2120.34,313,703240,2247,-149830
2011-03-11,34.2 ( 4.91 %),213,627340,2945.26,118,294330,2494,333010
2011-03-10,32.6 ( 4.82 %),286,1042340,3644.55,80,263820,3298,778520
2011-03-09,31.1 ( 4.71 %),191,773890,4051.78,213,374700,1759,399190
2011-03-08,29.7 ( 0 %),187,687970,3678.98,147,625720,4257,62250
2011-03-07,29.7 ( 0 %),205,726140,3542.15,150,736550,4910,-10410
2011-03-04,29.7 ( 0 %),150,473390,3155.93,99,500560,5056,-27170
2011-03-03,29.7 ( -0.34 %),143,302620,2116.22,76,271930,3578,30690
2011-03-02,29.8 ( -4.49 %),183,816980,4464.37,218,911030,4179,-94050
2011-03-01,31.2 ( -1.89 %),228,599290,2628.46,93,500700,5384,98590
2011-02-28,31.8 ( -3.93 %),154,421880,2739.48,95,511460,5384,-89580
2011-02-25,33.1 ( 3.44 %),108,251500,2328.7,85,113880,1340,137620
2011-02-24,32 ( -2.74 %),285,841270,2951.82,152,410150,2698,431120
2011-02-23,32.9 ( -0.6 %),190,253790,1335.74,127,395230,3112,-141440
2011-02-22,33.1 ( -4.06 %),244,902070,3697.01,193,725560,3759,176510
2011-02-21,34.5 ( -4.96 %),111,299710,2700.09,183,773680,4228,-473970
2011-02-18,36.3 ( -0.55 %),127,388780,3061.26,124,453030,3653,-64250
2011-02-17,36.5 ( -1.08 %),252,945210,3750.83,127,583210,4592,362000
2011-02-16,36.9 ( -1.07 %),118,256150,2170.76,118,481990,4085,-225840
2011-02-15,37.3 ( -1.84 %),311,597440,1921.03,151,838710,5554,-241270
2011-02-14,38 ( -1.81 %),105,262500,2500,167,733820,4394,-471320
2011-02-11,38.7 ( -0.51 %),83,171350,2064.46,86,222770,2590,-51420
2011-02-10,38.9 ( -0.26 %),105,535310,5098.19,175,493990,2823,41320
2011-02-09,39 ( -0.51 %),161,465170,2889.25,263,775930,2950,-310760
2011-02-08,39.2 ( 1.29 %),175,657570,3757.54,233,640880,2751,16690
2011-01-28,38.7 ( 0 %),118,446070,3780.25,157,564200,3594,-118130
2011-01-27,38.7 ( 2.65 %),168,728510,4336.37,161,595830,3701,132680
2011-01-26,37.7 ( 0.53 %),140,329590,2354.21,68,276460,4066,53130
2011-01-25,37.5 ( -1.32 %),167,413130,2473.83,114,463910,4069,-50780
2011-01-24,38 ( -1.04 %),155,271240,1749.94,160,495210,3095,-223970
2011-01-21,38.4 ( -0.26 %),150,488670,3257.8,175,541470,3094,-52800
2011-01-20,38.5 ( 0 %),157,521730,3323.12,267,701180,2626,-179450
2011-01-19,38.5 ( 2.94 %),190,587450,3091.84,284,736250,2592,-148800
2011-01-18,37.4 ( 0.27 %),114,334880,2937.54,134,430260,3211,-95380
2011-01-17,37.3 ( 0.54 %),120,363900,3032.5,124,432460,3488,-68560
2011-01-14,37.1 ( 0 %),161,519590,3227.27,78,371590,4764,148000
2011-01-13,37.1 ( 0.54 %),98,297540,3036.12,83,396450,4777,-98910
2011-01-12,36.9 ( -0.54 %),117,192830,1648.12,68,220180,3238,-27350
2011-01-11,37.1 ( -1.07 %),104,214540,2062.88,81,326950,4036,-112410
2011-01-10,37.5 ( -0.53 %),86,228190,2653.37,95,316100,3327,-87910
2011-01-07,37.7 ( 1.34 %),163,203450,1248.16,107,284890,2663,-81440
2011-01-06,37.2 ( -1.06 %),187,292390,1563.58,96,335730,3497,-43340
2011-01-05,37.6 ( -2.34 %),137,225930,1649.12,145,476080,3283,-250150
2011-01-04,38.5 ( -0.52 %),98,189070,1929.29,95,363630,3828,-174560
2010-12-31,38.7 ( 0 %),86,356370,4143.84,120,437320,3644,-80950
2010-12-30,38.7 ( 0 %),125,487700,3901.6,107,486200,4544,1500
2010-12-29,38.7 ( -0.26 %),82,282040,3439.51,152,498040,3277,-216000
2010-12-28,38.8 ( -0.26 %),119,326150,2740.76,127,466480,3673,-140330
2010-12-27,38.9 ( 0 %),92,267130,2903.59,147,525110,3572,-257980
2010-12-24,38.9 ( -0.26 %),119,491600,4131.09,195,457820,2348,33780
2010-12-23,39 ( -0.26 %),168,578840,3445.48,218,678510,3112,-99670
2010-12-22,39.1 ( -0.26 %),146,499450,3420.89,273,950490,3482,-451040
2010-12-21,39.2 ( 0.51 %),153,697910,4561.5,235,634840,2701,63070
2010-12-20,39 ( -0.26 %),121,359580,2971.74,191,422860,2214,-63280
2010-12-17,39.1 ( 0.26 %),157,628710,4004.52,276,777150,2816,-148440
2010-12-16,39 ( -0.51 %),205,725040,3536.78,217,585350,2697,139690
2010-12-15,39.2 ( -0.76 %),128,410310,3205.55,316,655710,2075,-245400
2010-12-14,39.5 ( -0.25 %),157,456380,2906.88,438,849650,1940,-393270
2010-12-13,39.6 ( 3.94 %),361,1031660,2857.78,360,1025450,2848,6210
2010-12-10,38.1 ( 3.81 %),193,637440,3302.8,246,531950,2162,105490
2010-12-09,36.7 ( 3.09 %),223,434910,1950.27,125,299160,2393,135750
2010-12-08,35.6 ( -3 %),248,303060,1222.02,164,347680,2120,-44620
2010-12-07,36.7 ( -3.42 %),275,597220,2171.71,170,560980,3300,36240
2010-12-06,38 ( -1.3 %),174,384530,2209.94,244,583920,2393,-199390
2010-12-03,38.5 ( -0.26 %),274,386290,1409.82,235,653750,2782,-267460
2010-12-02,38.6 ( 0.52 %),223,471760,2115.52,165,521190,3159,-49430
2010-12-01,38.4 ( 1.32 %),191,386350,2022.77,154,477070,3098,-90720
2010-11-30,39.9 ( -0.25 %),396,626510,1582.1,339,938480,2768,-311970
2010-11-29,40 ( 4.17 %),172,459060,2668.95,116,442630,3816,16430
2010-11-26,38.4 ( -0.52 %),131,244800,1868.7,125,292980,2344,-48180
2010-11-25,38.6 ( 0.26 %),160,341760,2136,154,335700,2180,6060
2010-11-24,38.5 ( 0.52 %),129,357310,2769.84,147,404180,2750,-46870
2010-11-23,38.3 ( 2.41 %),171,477780,2794.04,160,504000,3150,-26220
2010-11-22,37.4 ( 0.81 %),142,351320,2474.08,154,448850,2915,-97530
2010-11-19,37.1 ( 0 %),167,303830,1819.34,139,504660,3631,-200830
2010-11-18,37.1 ( 1.64 %),224,443420,1979.55,105,290550,2767,152870
2010-11-17,36.5 ( -2.41 %),160,271940,1699.62,102,378040,3706,-106100
2010-11-16,37.4 ( -1.06 %),91,174390,1916.37,125,286410,2291,-112020
2010-11-15,37.8 ( -0.26 %),101,265550,2629.21,102,306610,3006,-41060
2010-11-12,37.9 ( -0.26 %),167,390430,2337.9,148,429550,2902,-39120
2010-11-11,38 ( -2.31 %),149,230860,1549.4,106,430420,4061,-199560
2010-11-10,38.9 ( 0 %),162,297360,1835.56,99,332760,3361,-35400
2010-11-09,38.9 ( -1.52 %),143,200170,1399.79,109,334980,3073,-134810
2010-11-08,39.5 ( -0.75 %),124,226100,1823.39,165,396160,2401,-170060
2010-11-05,39.8 ( 1.53 %),91,491780,5404.18,295,662260,2245,-170480
2010-11-04,39.2 ( -0.51 %),76,164080,2158.95,183,234550,1282,-70470
2010-11-03,39.4 ( 0.51 %),88,220520,2505.91,174,317610,1825,-97090
2010-11-02,39.2 ( 0 %),144,264000,1833.33,116,187430,1616,76570
2010-11-01,39.2 ( 0 %),79,167230,2116.84,157,294510,1876,-127280
2010-10-29,39.2 ( 0.26 %),97,231170,2383.2,160,355810,2224,-124640
2010-10-28,39.1 ( 0 %),76,223910,2946.18,136,279100,2052,-55190
2010-10-27,39.1 ( -0.76 %),111,314190,2830.54,228,599140,2628,-284950
2010-10-26,39.4 ( 0.25 %),103,274230,2662.43,240,550750,2295,-276520
2010-10-25,39.3 ( 0.77 %),85,231580,2724.47,260,382540,1471,-150960
2010-10-22,39 ( 1.3 %),90,295530,3283.67,192,435690,2269,-140160
2010-10-21,38.5 ( 0.79 %),106,323870,3055.38,171,380640,2226,-56770
2010-10-20,38.2 ( -1.8 %),127,433300,3411.81,173,440750,2548,-7450
2010-10-19,38.9 ( -0.26 %),129,386700,2997.67,220,631590,2871,-244890
2010-10-18,39 ( 0 %),158,468120,2962.78,170,570610,3357,-102490
2010-10-15,39 ( 0.26 %),245,951560,3883.92,181,712470,3936,239090
2010-10-14,38.9 ( -0.26 %),173,588870,3403.87,215,727610,3384,-138740
2010-10-13,39 ( 0 %),179,673700,3763.69,179,650060,3632,23640
2010-10-12,39 ( -2.26 %),159,427810,2690.63,156,479040,3071,-51230
2010-10-11,39.9 ( 0.76 %),129,491670,3811.4,258,396350,1536,95320
2010-10-08,39.6 ( -0.25 %),109,314100,2881.65,305,538320,1765,-224220
2010-10-07,39.7 ( -0.25 %),150,519140,3460.93,373,642140,1722,-123000
2010-10-06,39.8 ( 0.76 %),150,699200,4661.33,439,1019710,2323,-320510
2010-10-05,39.5 ( 1.8 %),195,816510,4187.23,368,959280,2607,-142770
2010-10-04,38.8 ( 0.52 %),111,536910,4837.03,399,812080,2035,-275170
2010-10-01,38.6 ( 0.26 %),93,130850,1406.99,151,214940,1423,-84090
2010-09-30,38.5 ( -0.26 %),130,361000,2776.92,153,501870,3280,-140870
2010-09-29,38.6 ( 0 %),177,435820,2462.26,240,551320,2297,-115500
2010-09-28,38.6 ( 0.52 %),184,541440,2942.61,267,701260,2626,-159820
2010-09-27,38.4 ( -0.52 %),125,224140,1793.12,148,320310,2164,-96170
2010-09-24,38.6 ( 0 %),118,430840,3651.19,210,574540,2736,-143700
2010-09-23,38.6 ( 0 %),159,691170,4346.98,249,753300,3025,-62130
2010-09-22,38.6 ( 1.31 %),201,481840,2397.21,172,399520,2323,82320
2010-09-21,38.1 ( -4.51 %),245,558230,2278.49,247,656060,2656,-97830
2010-09-20,39.9 ( -0.25 %),179,375250,2096.37,417,643600,1543,-268350
2010-09-17,40 ( 4.99 %),247,978720,3962.43,274,582270,2125,396450
2010-09-16,38.1 ( 0.53 %),114,273410,2398.33,168,297770,1772,-24360
2010-09-15,37.9 ( 0.53 %),165,387920,2351.03,204,340170,1668,47750
2010-09-14,37.7 ( 0 %),174,410730,2360.52,193,483090,2503,-72360
2010-09-13,37.7 ( 0.27 %),167,264620,1584.55,236,293990,1246,-29370
2010-09-10,37.6 ( -3.59 %),161,345620,2146.71,242,447710,1850,-102090
2010-09-09,39 ( 0.26 %),167,429500,2571.86,249,569300,2286,-139800
2010-09-08,38.9 ( 0.78 %),218,549970,2522.8,252,544290,2160,5680
2010-09-07,38.6 ( -3.74 %),220,513330,2333.32,341,743690,2181,-230360
2010-09-06,40.1 ( 0.25 %),321,768390,2393.74,420,877250,2089,-108860
2010-09-01,40 ( 3.9 %),292,1070050,3664.55,547,1161060,2123,-91010
2010-08-31,38.5 ( 4.9 %),349,1272400,3645.85,434,1190740,2744,81660
2010-08-30,36.7 ( 4.86 %),297,959090,3229.26,192,526440,2742,432650
2010-08-27,35 ( 0 %),234,649660,2776.32,256,669340,2615,-19680
2010-08-26,35 ( 2.64 %),214,669430,3128.18,245,518380,2116,151050
2010-08-25,34.1 ( -2.85 %),177,522410,2951.47,247,493310,1997,29100
2010-08-24,35.1 ( -2.77 %),194,568150,2928.61,275,661660,2406,-93510
2010-08-23,36.1 ( 0.28 %),159,484250,3045.6,308,443940,1441,40310
2010-08-20,36 ( 3.15 %),94,448880,4775.32,223,355260,1593,93620
2010-08-19,34.9 ( -0.29 %),196,609480,3109.59,190,271170,1427,338310
2010-08-18,35 ( -0.85 %),214,629250,2940.42,228,467850,2052,161400
2010-08-17,35.3 ( -1.12 %),181,457780,2529.17,276,573000,2076,-115220
2010-08-16,35.7 ( 5 %),205,735080,3585.76,225,431660,1918,303420
2010-08-13,34 ( 2.41 %),207,818780,3955.46,246,734450,2986,84330
2010-08-12,33.2 ( -4.6 %),210,824160,3924.57,504,976430,1937,-152270
2010-08-11,34.8 ( -0.85 %),245,700270,2858.24,186,736140,3958,-35870
2010-08-10,35.1 ( -3.04 %),216,696920,3226.48,263,868630,3303,-171710
2010-08-09,36.2 ( -2.16 %),162,549000,3388.89,224,612940,2736,-63940
2010-08-06,37 ( 1.93 %),141,487750,3459.22,211,395700,1875,92050
2010-08-05,36.3 ( -1.36 %),153,261620,1709.93,166,323720,1950,-62100
2010-08-04,36.8 ( 1.1 %),159,591770,3721.82,246,640690,2604,-48920
2010-08-03,36.4 ( 1.68 %),203,749860,3693.89,274,807750,2948,-57890
2010-08-02,35.8 ( 0 %),128,424540,3316.72,121,427960,3537,-3420
2010-07-30,35.8 ( 1.13 %),300,661970,2206.57,181,711130,3929,-49160
2010-07-29,35.4 ( -3.54 %),298,690350,2316.61,175,827060,4726,-136710
2010-07-28,36.7 ( -1.87 %),171,452850,2648.25,136,506510,3724,-53660
2010-07-27,37.4 ( -1.32 %),286,699370,2445.35,131,714210,5452,-14840
2010-07-26,37.9 ( -0.26 %),181,422880,2336.35,128,249170,1947,173710
2010-07-23,38 ( -0.52 %),177,346520,1957.74,140,358690,2562,-12170
2010-07-22,38.2 ( -0.78 %),129,220760,1711.32,127,188960,1488,31800
2010-07-21,38.5 ( -1.03 %),216,420730,1947.82,138,330800,2397,89930
2010-07-20,38.9 ( -0.26 %),127,319630,2516.77,149,330710,2220,-11080
2010-07-19,39 ( 0 %),164,491830,2998.96,153,468680,3063,23150
2010-07-16,39 ( 0 %),141,368000,2609.93,195,367310,1884,690
2010-07-15,39 ( -0.51 %),181,412570,2279.39,182,335130,1841,77440
2010-07-14,39.2 ( -2 %),206,399710,1940.34,225,568470,2527,-168760
2010-07-13,40 ( 3.09 %),262,607890,2320.19,211,487170,2309,120720
2010-07-12,38.8 ( 0 %),170,408860,2405.06,195,443530,2275,-34670
2010-07-09,38.8 ( 0 %),215,372640,1733.21,164,477220,2910,-104580
2010-07-08,38.8 ( -1.02 %),168,245760,1462.86,106,333260,3144,-87500
2010-07-07,39.2 ( -2 %),97,182850,1885.05,100,355010,3550,-172160
2010-07-06,40 ( -2.44 %),172,438670,2550.41,134,391690,2923,46980
2010-07-05,41 ( 1.23 %),100,512700,5127,183,592850,3240,-80150
2010-07-02,40.5 ( -0.74 %),207,696200,3363.29,166,774460,4665,-78260
2010-07-01,40.8 ( -1.69 %),98,266080,2715.1,114,358180,3142,-92100
2010-06-30,41.5 ( 0.48 %),117,389220,3326.67,172,321720,1870,67500
2010-06-29,41.3 ( 0.73 %),110,492580,4478,201,575590,2864,-83010
2010-06-28,41 ( -0.49 %),95,343450,3615.26,112,315580,2818,27870
2010-06-25,41.2 ( -0.48 %),100,408350,4083.5,159,407410,2562,940
2010-06-24,41.4 ( -0.24 %),113,426660,3775.75,123,363470,2955,63190
2010-06-23,41.5 ( 0.24 %),92,227450,2472.28,108,186920,1731,40530
2010-06-22,41.4 ( 0.24 %),118,588510,4987.37,230,537050,2335,51460
2010-06-21,41.3 ( -0.24 %),148,479060,3236.89,148,440270,2975,38790
2010-06-18,41.4 ( 0 %),204,869830,4263.87,187,784510,4195,85320
2010-06-17,41.4 ( -0.48 %),129,431640,3346.05,149,424630,2850,7010
2010-06-16,41.6 ( -0.48 %),192,381930,1989.22,162,391230,2415,-9300
2010-06-15,41.8 ( 0.48 %),115,443600,3857.39,215,430100,2000,13500
2010-06-14,41.6 ( 0.24 %),105,387130,3686.95,169,277920,1644,109210
2010-06-11,41.5 ( 0 %),138,225600,1634.78,167,258180,1546,-32580
2010-06-10,41.5 ( 0.97 %),182,376880,2070.77,153,277410,1813,99470
2010-06-09,41.1 ( -0.48 %),178,611270,3434.1,148,827180,5589,-215910
2010-06-08,41.3 ( -1.2 %),220,523970,2381.68,197,1070560,5434,-546590
2010-06-07,41.8 ( -0.48 %),262,827590,3158.74,247,936550,3792,-108960
2010-06-04,42 ( 0 %),160,295310,1845.69,230,556460,2419,-261150
2010-06-03,42 ( 0 %),142,395160,2782.82,272,1088680,4002,-693520
2010-06-02,42 ( 0 %),122,356540,2922.46,180,402120,2234,-45580
2010-06-01,42 ( 0.24 %),183,481810,2632.84,120,222180,1852,259630
2010-05-31,41.9 ( -0.24 %),146,427630,2928.97,264,597110,2262,-169480
2010-05-28,42 ( 2.94 %),323,676780,2095.29,244,656660,2691,20120
2010-05-27,40.8 ( 0 %),168,491070,2923.04,149,558140,3746,-67070
2010-05-26,40.8 ( 3.29 %),234,552520,2361.2,114,245690,2155,306830
2010-05-25,39.5 ( -2.47 %),381,889640,2335.01,135,914180,6772,-24540
2010-05-24,40.5 ( 0 %),287,483050,1683.1,147,693680,4719,-210630
2010-05-21,40.5 ( -4.71 %),325,618570,1903.29,262,600990,2294,17580
2010-05-20,42.5 ( 4.42 %),305,722840,2369.97,154,306260,1989,416580
2010-05-19,40.7 ( -3.33 %),260,894710,3441.19,219,716730,3273,177980
2010-05-18,42.1 ( -0.94 %),205,548590,2676.05,122,420930,3450,127660
2010-05-17,42.5 ( -3.41 %),221,404020,1828.14,173,500800,2895,-96780
2010-05-14,44 ( 0 %),215,259640,1207.63,165,388090,2352,-128450
2010-05-13,44 ( 0.23 %),246,442270,1797.85,148,376110,2541,66160
2010-05-12,43.9 ( -2.23 %),339,519760,1533.22,218,650910,2986,-131150
2010-05-11,44.9 ( 0 %),328,453470,1382.53,157,492680,3138,-39210
2010-05-10,44.9 ( -1.1 %),371,907340,2445.66,280,1060200,3786,-152860
2010-05-07,45.4 ( -2.37 %),521,969780,1861.38,294,939830,3197,29950
2010-05-06,46.5 ( 0 %),430,747130,1737.51,286,976490,3414,-229360
2010-05-05,46.5 ( -2.31 %),433,805700,1860.74,355,974750,2746,-169050
2010-05-04,47.6 ( -0.21 %),389,548550,1410.15,348,782110,2247,-233560
2010-04-29,47.7 ( -1.45 %),439,673770,1534.78,490,1161880,2371,-488110
2010-04-28,48.4 ( 0.21 %),685,1345760,1964.61,769,2479650,3225,-1133890
2010-04-27,48.3 ( 5 %),1093,2873760,2629.24,518,2052500,3962,821260
2010-04-26,69 ( 0.73 %),395,1310320,3317.27,737,1524120,2068,-213800
2010-04-22,68.5 ( 1.48 %),344,1269910,3691.6,578,1203600,2082,66310
2010-04-21,67.5 ( 0 %),333,823030,2471.56,358,984660,2750,-161630
2010-04-20,67.5 ( 0 %),231,478960,2073.42,403,720690,1788,-241730
2010-04-19,67.5 ( 0 %),301,515640,1713.09,464,807970,1741,-292330
2010-04-16,67.5 ( -0.74 %),165,497690,3016.3,408,694770,1703,-197080
2010-04-15,68 ( 1.49 %),265,883190,3332.79,458,1107160,2417,-223970
2010-04-14,67 ( 0 %),196,715750,3651.79,422,946930,2244,-231180
2010-04-13,67 ( -0.74 %),203,987980,4866.9,487,1154310,2370,-166330
2010-04-12,67.5 ( 0 %),209,686570,3285.02,521,874880,1679,-188310
2010-04-09,67.5 ( 0 %),198,722650,3649.75,673,1067360,1586,-344710
2010-04-08,67.5 ( 0 %),213,648100,3042.72,581,977570,1683,-329470
2010-04-07,67.5 ( 0.75 %),211,1181830,5601.09,747,1175700,1574,6130
2010-04-06,67 ( 0 %),330,1160690,3517.24,886,1742030,1966,-581340
2010-04-05,67 ( 3.08 %),292,1126450,3857.71,514,973250,1893,153200
2010-04-02,65 ( 1.56 %),224,972930,4343.44,415,915580,2206,57350
2010-04-01,64 ( 2.4 %),291,1082240,3719.04,336,759810,2261,322430
2010-03-31,62.5 ( -1.57 %),323,889010,2752.35,264,1021210,3868,-132200
2010-03-30,63.5 ( -0.78 %),175,421330,2407.6,265,689860,2603,-268530
2010-03-29,64 ( 0 %),161,374780,2327.83,207,477560,2307,-102780
2010-03-26,64 ( 0.79 %),303,1070640,3533.47,243,522130,2149,548510
2010-03-25,63.5 ( -2.31 %),379,898640,2371.08,298,932130,3128,-33490
2010-03-24,65 ( 0.78 %),334,806250,2413.92,299,808520,2704,-2270
2010-03-23,64.5 ( -0.77 %),335,674140,2012.36,265,663200,2503,10940
2010-03-22,65 ( -1.52 %),347,642170,1850.63,279,794990,2849,-152820
2010-03-19,66 ( -0.75 %),304,789300,2596.38,330,798320,2419,-9020
2010-03-18,66.5 ( 2.31 %),434,1187860,2737,285,650870,2284,536990
2010-03-17,65 ( -2.26 %),453,1276550,2817.99,358,1094820,3058,181730
2010-03-16,66.5 ( -2.92 %),372,1546390,4156.96,634,1231780,1943,314610
2010-03-15,68.5 ( -0.72 %),306,978680,3198.3,609,1378840,2264,-400160
2010-03-12,69 ( 0 %),456,1187350,2603.84,695,1373830,1977,-186480
2010-03-11,69 ( 2.99 %),1483,4286190,2890.22,918,2537890,2765,1748300
2010-03-10,67 ( 1.52 %),315,1282110,4070.19,613,892230,1456,389880
2010-03-09,66 ( 0 %),364,1324400,3638.46,556,1335230,2401,-10830
2010-03-08,66 ( 2.33 %),232,757280,3264.14,455,840780,1848,-83500
2010-03-05,64.5 ( 0.78 %),237,1082900,4569.2,554,1047300,1890,35600
2010-03-04,64 ( 0 %),334,1115890,3340.99,624,1404310,2250,-288420
2010-03-03,64 ( 1.59 %),243,948440,3903.05,482,1094170,2270,-145730
2010-03-02,63 ( 2.44 %),397,1334040,3360.3,495,1040860,2103,293180
2010-03-01,61.5 ( 1.65 %),311,865540,2783.09,166,406980,2452,458560
2010-02-26,60.5 ( -1.63 %),316,768030,2430.47,181,651350,3599,116680
2010-02-25,61.5 ( -0.81 %),328,716720,2185.12,222,788910,3554,-72190
2010-02-24,62 ( 0 %),386,631920,1637.1,180,595020,3306,36900
2010-02-23,62 ( -3.12 %),389,780280,2005.86,180,613820,3410,166460
2010-02-22,64 ( -0.78 %),182,566370,3111.92,240,469490,1956,96880
2010-02-12,64.5 ( 0.78 %),187,904100,4834.76,264,494340,1872,409760
2010-02-11,64 ( 0 %),131,351910,2686.34,278,562560,2024,-210650
2010-02-10,64 ( 1.59 %),189,678270,3588.73,235,543030,2311,135240
2010-02-09,63 ( 0 %),218,996280,4570.09,260,561000,2158,435280
2010-02-08,63 ( 0 %),234,799780,3417.86,287,720890,2512,78890
2010-02-05,63 ( -2.33 %),294,843010,2867.38,508,1415350,2786,-572340
2010-02-04,64.5 ( 0 %),354,1416870,4002.46,680,1655050,2434,-238180
2010-02-03,64.5 ( 0.78 %),300,1377620,4592.07,807,1982420,2457,-604800
2010-02-02,64 ( 2.4 %),373,2190450,5872.52,960,1861620,1939,328830
2010-02-01,62.5 ( 4.17 %),297,1356700,4568.01,463,769210,1661,587490
2010-01-29,60 ( 1.69 %),320,846630,2645.72,476,898950,1889,-52320
2010-01-28,59 ( -1.67 %),321,593420,1848.66,205,423650,2067,169770
2010-01-27,60 ( -3.23 %),258,536500,2079.46,539,1041620,1933,-505120
2010-01-26,62 ( 4.2 %),450,875120,1944.71,244,571740,2343,303380
2010-01-25,59.5 ( 1.71 %),278,538820,1938.2,227,380240,1675,158580
2010-01-22,58.5 ( 0 %),431,1206420,2799.12,229,752860,3288,453560
2010-01-21,58.5 ( -2.5 %),323,752660,2330.22,390,823010,2110,-70350
2010-01-20,60 ( -0.83 %),265,800180,3019.55,436,902490,2070,-102310
2010-01-19,60.5 ( 2.54 %),415,958880,2310.55,253,727410,2875,231470
2010-01-18,59 ( -3.28 %),390,766990,1966.64,370,815500,2204,-48510
2010-01-15,61 ( -1.61 %),415,860870,2074.39,422,1053220,2496,-192350
2010-01-14,62 ( -1.59 %),450,653530,1452.29,342,1013960,2965,-360430
2010-01-13,63 ( 2.44 %),662,1756800,2653.78,483,1446470,2995,310330
2010-01-12,61.5 ( -3.91 %),514,1092430,2125.35,519,1406970,2711,-314540
2010-01-11,64 ( -1.54 %),504,1102030,2186.57,506,1385550,2738,-283520
2010-01-08,65 ( -4.41 %),515,1172640,2276.97,835,2311350,2768,-1138710
2010-01-07,68 ( 3.03 %),713,2621970,3677.38,903,2262050,2505,359920
2010-01-06,66 ( 3.12 %),819,2871390,3505.97,986,2498740,2534,372650
2010-01-05,64 ( 4.92 %),569,1656720,2911.63,411,1321320,3215,335400
2010-01-04,61 ( 4.27 %),466,1192730,2559.51,187,611310,3269,581420
2009-12-31,58.5 ( 0.86 %),460,1206650,2623.15,651,1426440,2191,-219790
2009-12-30,58 ( 3.57 %),645,1150870,1784.29,317,780260,2461,370610
2009-12-29,56 ( -2.61 %),566,957450,1691.61,367,1036140,2823,-78690
2009-12-28,57.5 ( -3.36 %),562,1030490,1833.61,472,1481920,3140,-451430
2009-12-25,59.5 ( 4.39 %),621,1268920,2043.35,403,1136190,2819,132730
2009-12-24,57 ( 1.79 %),547,1166510,2132.56,323,842420,2608,324090
2009-12-23,56 ( -0.88 %),489,886830,1813.56,272,744390,2737,142440
2009-12-22,56.5 ( 4.63 %),401,1366420,3407.53,449,979220,2181,387200
2009-12-21,54 ( 4.85 %),434,1096540,2526.59,147,354510,2412,742030
2009-12-18,51.5 ( 0 %),659,2357160,3576.87,270,1479270,5479,877890
2009-12-17,51.5 ( -2.83 %),395,1320520,3343.09,254,799640,3148,520880
2009-12-16,53 ( -4.5 %),206,689650,3347.82,400,993140,2483,-303490
2009-12-15,55.5 ( 0 %),234,641020,2739.4,330,539120,1634,101900
2009-12-14,55.5 ( 4.72 %),475,1107600,2331.79,252,651910,2587,455690
2009-12-11,53 ( -4.5 %),403,1062490,2636.45,484,1060510,2191,1980
2009-12-10,55.5 ( -2.63 %),412,1145660,2780.73,398,1128420,2835,17240
2009-12-09,57 ( -5 %),456,1029640,2257.98,462,1408090,3048,-378450
2009-12-08,60 ( -2.44 %),295,585850,1985.93,308,717860,2331,-132010
2009-12-07,61.5 ( 0 %),428,941280,2199.25,250,681400,2726,259880
2009-12-04,61.5 ( -0.81 %),537,1254410,2335.96,353,1289560,3653,-35150
2009-12-03,62 ( -0.8 %),448,1552750,3465.96,455,1199910,2637,352840
2009-12-02,62.5 ( -2.34 %),384,1199110,3122.68,634,1549530,2444,-350420
2009-12-01,64 ( 3.23 %),606,1308440,2159.14,427,1207750,2828,100690
2009-11-30,62 ( 4.2 %),401,1462480,3647.08,354,944210,2667,518270
2009-11-27,59.5 ( -0.83 %),828,1637540,1977.71,429,1363630,3179,273910
2009-11-26,60 ( -4.76 %),301,874760,2906.18,540,1648850,3053,-774090
2009-11-25,63 ( -4.55 %),725,1297070,1789.06,502,1998930,3982,-701860
2009-11-24,66 ( -1.49 %),841,1746360,2076.53,333,1492640,4482,253720
2009-11-23,67 ( -4.29 %),592,1262470,2132.55,426,1396660,3279,-134190
2009-11-20,70 ( -2.78 %),597,1307530,2190.17,629,1544140,2455,-236610
2009-11-19,72 ( 2.86 %),682,2030920,2977.89,889,2285560,2571,-254640
2009-11-18,70 ( 4.48 %),549,1850910,3371.42,525,1207500,2300,643410
2009-11-17,67 ( -0.74 %),505,1379680,2732.04,498,1511510,3035,-131830
2009-11-16,67.5 ( -2.88 %),451,875040,1940.22,535,1506480,2816,-631440
2009-11-13,69.5 ( 2.21 %),671,2400030,3576.8,705,2303620,3268,96410
2009-11-12,68 ( 3.82 %),744,2471510,3321.92,556,2019990,3633,451520
2009-11-11,65.5 ( 4.8 %),772,2744570,3555.14,363,1509230,4158,1235340
2009-11-10,62.5 ( -3.85 %),748,1742470,2329.51,595,2147660,3610,-405190
2009-11-09,65 ( -4.41 %),536,1097930,2048.38,478,1970640,4123,-872710
2009-11-06,68 ( -2.16 %),1021,2257850,2211.41,593,2486600,4193,-228750
2009-11-05,69.5 ( 0.72 %),1190,2481700,2085.46,396,2019720,5100,461980
2009-11-04,69 ( -2.13 %),833,2231030,2678.31,505,2437510,4827,-206480
2009-11-03,70.5 ( -4.08 %),952,3327630,3495.41,846,3849270,4550,-521640
2009-11-02,73.5 ( -4.55 %),515,1360800,2642.33,561,2490910,4440,-1130110
2009-10-30,77 ( 0 %),837,2924290,3493.78,662,2675200,4041,249090
2009-10-29,77 ( -1.91 %),1249,3959000,3169.74,1076,4411140,4100,-452140
2009-10-28,78.5 ( -1.26 %),670,1943970,2901.45,713,1985080,2784,-41110
2009-10-27,79.5 ( -1.85 %),1041,3652970,3509.1,1100,3588460,3262,64510
2009-10-26,81 ( -0.61 %),850,2635700,3100.82,1240,3683610,2971,-1047910
2009-10-23,81.5 ( 1.88 %),1135,5744200,5060.97,1274,3927070,3082,1817130
2009-10-22,80 ( 4.58 %),1089,5130940,4711.61,806,2460400,3053,2670540
2009-10-21,76.5 ( 2 %),932,3459330,3711.73,863,2323320,2692,1136010
2009-10-20,75 ( 2.04 %),653,2099610,3215.33,879,2192520,2494,-92910
2009-10-19,73.5 ( 0 %),620,1802430,2907.15,858,2357460,2748,-555030
2009-10-16,73.5 ( -2.65 %),529,2083690,3938.92,1134,3141820,2771,-1058130
2009-10-15,75.5 ( 2.03 %),717,3077860,4292.69,1401,4253590,3036,-1175730
2009-10-14,74 ( 3.5 %),640,3043040,4754.75,980,2504270,2555,538770
2009-10-13,71.5 ( -2.72 %),501,1700680,3394.57,1024,2064710,2016,-364030
2009-10-12,73.5 ( 4.26 %),690,3127410,4532.48,1335,3048500,2284,78910
2009-10-09,71.5 ( 1.42 %),431,1473760,3419.4,918,2052320,2236,-578560
2009-10-08,70.5 ( 0 %),499,1998800,4005.61,780,1958690,2511,40110
2009-10-07,70.5 ( 4.44 %),808,3979560,4925.2,437,1746040,3996,2233520
2009-10-06,67.5 ( 0 %),687,1527120,2222.88,368,1651640,4488,-124520
2009-10-05,67.5 ( -0.74 %),724,1951880,2695.97,500,2223900,4448,-272020
2009-10-02,68 ( -2.86 %),1071,3093330,2888.26,785,2990750,3810,102580
2009-10-01,70 ( -2.1 %),564,1559990,2765.94,746,2105900,2823,-545910
2009-09-30,71.5 ( -1.38 %),501,1485980,2966.03,760,2008750,2643,-522770
2009-09-29,72.5 ( 0.69 %),756,2902670,3839.51,952,2835050,2978,67620
2009-09-28,72 ( -0.69 %),838,2628870,3137.08,916,3151240,3440,-522370
2009-09-25,72.5 ( -0.68 %),856,2391430,2793.73,745,2396220,3216,-4790
2009-09-24,73 ( -1.35 %),746,2345930,3144.68,1118,3094870,2768,-748940
2009-09-23,74 ( 2.78 %),1151,4668400,4055.95,1707,4482940,2626,185460
2009-09-22,72 ( 0 %),1043,2439290,2338.72,1622,4798760,2959,-2359470
2009-09-21,72 ( 4.35 %),1572,5898220,3752.05,732,3681290,5029,2216930
2009-09-18,69 ( 0 %),807,1932500,2394.67,452,2037510,4508,-105010
2009-09-17,69 ( 0 %),842,2083800,2474.82,488,1953040,4002,130760
2009-09-16,69 ( -1.43 %),739,2350340,3180.43,567,2439940,4303,-89600
2009-09-15,70 ( -0.71 %),768,2089700,2720.96,777,2462160,3169,-372460
2009-09-14,70.5 ( -0.7 %),803,1960280,2441.2,671,2233960,3329,-273680
2009-09-11,71 ( -1.39 %),688,1717020,2495.67,820,2688900,3279,-971880
2009-09-10,72 ( -1.37 %),484,1353160,2795.79,983,2216330,2255,-863170
2009-09-09,73 ( 4.29 %),1258,4240550,3370.87,1296,4080930,3149,159620
2009-09-08,70 ( 4.48 %),667,2728940,4091.36,521,1108480,2128,1620460
2009-09-07,67 ( -0.74 %),595,1646600,2767.39,709,1370950,1934,275650
2009-09-04,67.5 ( -2.17 %),456,1337530,2933.18,907,2141050,2361,-803520
2009-09-03,69 ( -0.72 %),581,1943500,3345.09,673,1394730,2072,548770
2009-09-01,69.5 ( 0 %),677,1762250,2603.03,738,1706790,2313,55460
2009-08-31,69.5 ( -0.71 %),674,1772040,2629.14,689,2371730,3442,-599690
2009-08-28,70 ( 1.45 %),492,1160760,2359.27,579,1127140,1947,33620
2009-08-27,69 ( -0.72 %),544,1131030,2079.1,524,1439310,2747,-308280
2009-08-26,69.5 ( 0 %),453,1341110,2960.51,682,1658150,2431,-317040
2009-08-25,69.5 ( -1.42 %),547,1389030,2539.36,766,2160920,2821,-771890
2009-08-24,70.5 ( 1.44 %),512,1750740,3419.41,813,1754710,2158,-3970
2009-08-21,69.5 ( 0 %),538,1842500,3424.72,1084,2773000,2558,-930500
2009-08-20,69.5 ( 0 %),570,1669340,2928.67,769,1639460,2132,29880
2009-08-19,69.5 ( 2.96 %),569,1782540,3132.76,676,1466420,2169,316120
2009-08-18,67.5 ( 0 %),883,2435350,2758.04,797,1733890,2176,701460
2009-08-17,67.5 ( -1.46 %),687,1976800,2877.44,824,2331220,2829,-354420
2009-08-14,68.5 ( -1.44 %),736,2326820,3161.44,980,2481290,2532,-154470
2009-08-13,69.5 ( 1.46 %),661,1867660,2825.51,988,2267100,2295,-399440
2009-08-12,68.5 ( 1.48 %),726,1619590,2230.84,1003,2343340,2336,-723750
2009-08-11,67.5 ( 4.65 %),818,2688470,3286.64,1156,2139150,1850,549320
2009-08-10,64.5 ( 4.03 %),617,2214440,3589.04,1146,1958260,1709,256180
2009-08-07,62 ( 1.64 %),548,1988910,3629.4,1146,1897550,1656,91360
2009-08-06,61 ( 0 %),671,2663660,3969.69,1506,2683620,1782,-19960
2009-08-05,61 ( 1.67 %),545,2382200,4371.01,1118,2107770,1885,274430
2009-08-04,60 ( 1.69 %),438,1691690,3862.31,892,1707430,1914,-15740
2009-08-03,59 ( -0.84 %),417,1123330,2693.84,1058,1773060,1676,-649730
2009-07-31,59.5 ( 4.39 %),603,2316360,3841.39,634,1459160,2302,857200
2009-07-30,57 ( -1.72 %),795,1639250,2061.95,458,964190,2105,675060
2009-07-29,58 ( -1.69 %),584,1325590,2269.85,914,1770090,1937,-444500
2009-07-28,59 ( -4.07 %),617,1405710,2278.3,1790,2797190,1563,-1391480
2009-07-27,61.5 ( 3.36 %),876,3282580,3747.24,1799,3804490,2115,-521910
2009-07-24,59.5 ( 4.39 %),414,1832440,4426.18,539,793230,1472,1039210
2009-07-23,57 ( 3.64 %),583,1783810,3059.71,706,1252070,1773,531740
2009-07-22,55 ( 1.85 %),420,1386840,3302,720,1519040,2110,-132200
2009-07-21,54 ( 0.93 %),519,1243040,2395.07,403,860140,2134,382900
2009-07-20,53.5 ( -2.73 %),521,1019650,1957.1,466,884750,1899,134900
2009-07-17,55 ( 0 %),330,871020,2639.45,722,1075570,1490,-204550
2009-07-16,55 ( 0.92 %),357,930550,2606.58,777,1735340,2233,-804790
2009-07-15,54.5 ( 1.87 %),466,1108370,2378.48,563,1042650,1852,65720
2009-07-14,53.5 ( -0.93 %),747,1473160,1972.1,482,1220510,2532,252650
2009-07-13,54 ( -2.7 %),838,2539000,3029.83,445,1030160,2315,1508840
2009-07-10,55.5 ( -2.63 %),552,1496050,2710.24,721,1643050,2279,-147000
2009-07-09,57 ( 0.88 %),409,1119920,2738.19,827,1357710,1642,-237790
2009-07-08,56.5 ( 0 %),560,1943320,3470.21,786,1344580,1711,598740
2009-07-07,56.5 ( -1.74 %),696,1850880,2659.31,1278,2286560,1789,-435680
2009-07-06,57.5 ( 4.55 %),688,2101500,3054.51,832,1427370,1716,674130
2009-07-03,55 ( 0.92 %),605,2175510,3595.88,748,1436860,1921,738650
2009-07-02,54.5 ( 3.81 %),891,2646450,2970.2,659,1694420,2571,952030
2009-07-01,52.5 ( -2.78 %),1021,2346790,2298.52,793,1748450,2205,598340
2009-06-30,54 ( -4.42 %),916,1632500,1782.21,834,2609130,3128,-976630
2009-06-29,56.5 ( 0 %),460,1517000,3297.83,990,1966310,1986,-449310
2009-06-26,56.5 ( 1.8 %),697,1772050,2542.4,960,2185760,2277,-413710
2009-06-25,55.5 ( 0.91 %),945,2512720,2658.96,1128,2732970,2423,-220250
2009-06-24,55 ( 4.76 %),1477,3933540,2663.2,199,816830,4105,3116710
2009-06-23,52.5 ( -4.55 %),1198,3062080,2555.99,1097,3533870,3221,-471790
2009-06-22,55 ( -4.35 %),936,1821370,1945.91,925,2482010,2683,-660640
2009-06-19,57.5 ( 0 %),1263,2656600,2103.4,1151,3975250,3454,-1318650
2009-06-18,57.5 ( 0.88 %),1067,1788050,1675.77,755,2256530,2989,-468480
2009-06-17,57 ( 4.59 %),1945,4612640,2371.54,898,2604700,2901,2007940
2009-06-16,54.5 ( -4.39 %),1051,2042300,1943.2,1030,3385010,3286,-1342710
2009-06-15,57 ( -4.2 %),822,2131790,2593.42,940,2821710,3002,-689920
2009-06-12,59.5 ( -3.25 %),1762,3048520,1730.15,1146,3921750,3422,-873230
2009-06-11,61.5 ( 4.24 %),1846,4320870,2340.67,673,2905170,4317,1415700
2009-06-10,59 ( -4.84 %),1015,2939520,2896.08,1606,4615130,2874,-1675610
2009-06-09,62 ( 4.2 %),1484,4204890,2833.48,932,2954270,3170,1250620
2009-06-08,59.5 ( 4.39 %),1874,6474350,3454.83,278,2538360,9131,3935990
2009-06-05,57 ( 4.59 %),2347,8835460,3764.58,1061,7342840,6921,1492620
2009-06-04,54.5 ( 3.81 %),843,2607190,3092.75,1405,3422480,2436,-815290
2009-06-03,52.5 ( 0 %),673,1736850,2580.76,1517,2587100,1705,-850250
2009-06-02,52.5 ( 3.96 %),793,2523870,3182.69,1033,2602140,2519,-78270
2009-06-01,50.5 ( 4.12 %),567,1567670,2764.85,369,977640,2649,590030
2009-05-29,48.5 ( 1.46 %),600,1274730,2124.55,499,1435110,2876,-160380
2009-05-28,47.8 ( -3.43 %),1003,2112660,2106.34,571,1438670,2520,673990
2009-05-27,49.5 ( -1 %),842,1559260,1851.85,833,2264830,2719,-705570
2009-05-26,50 ( -2.91 %),899,1629990,1813.11,1138,3372210,2963,-1742220
2009-05-25,51.5 ( 4.04 %),757,1941650,2564.93,353,1091620,3092,850030
2009-05-22,49.5 ( -2.94 %),826,2152960,2606.49,700,1529040,2184,623920
2009-05-21,51 ( -2.86 %),867,1498890,1728.82,821,2060680,2510,-561790
2009-05-20,52.5 ( 5 %),1598,5641330,3530.24,968,4852740,5013,788590
2009-05-19,50 ( 1.01 %),944,2110650,2235.86,830,3549850,4277,-1439200
2009-05-18,49.5 ( -2.94 %),779,1531230,1965.64,773,2283070,2954,-751840
2009-05-15,51 ( 4.08 %),685,1928000,2814.6,707,2167620,3066,-239620
2009-05-14,49 ( 0 %),1035,2450070,2367.22,725,2188480,3019,261590
2009-05-13,49 ( -4.85 %),996,2194170,2202.98,997,3528220,3539,-1334050
2009-05-12,51.5 ( 3.41 %),1257,3177840,2528.11,642,2050610,3194,1127230
2009-05-11,49.8 ( 1.84 %),671,2221480,3310.7,848,3829790,4516,-1608310
2009-05-08,48.9 ( 1.24 %),1056,2639830,2499.84,896,2791060,3115,-151230
2009-05-07,48.3 ( 5 %),737,2968810,4028.24,400,1692760,4232,1276050
2009-05-06,46 ( 3.6 %),953,5445330,5713.88,1892,4725790,2498,719540
2009-05-05,44.4 ( 4.96 %),747,5002340,6696.57,208,422480,2031,4579860
2009-05-04,42.3 ( 4.96 %),459,3404000,7416.12,145,258290,1781,3145710
2009-04-29,40.3 ( 0.75 %),456,1621640,3556.23,647,1357710,2098,263930
2009-04-28,40 ( 1.27 %),442,1576130,3565.9,550,1369120,2489,207010
2009-04-27,39.5 ( -1.5 %),395,1148830,2908.43,779,1419310,1822,-270480
2009-04-24,40.1 ( -0.99 %),535,1428960,2670.95,626,1214010,1939,214950
2009-04-23,40.5 ( -0.98 %),483,1372270,2841.14,1060,2426100,2289,-1053830
2009-04-22,40.9 ( 4.87 %),724,2379090,3286.04,449,1587240,3535,791850
2009-04-21,39 ( 4.84 %),1209,2441710,2019.61,778,1897230,2439,544480
2009-04-20,37.2 ( -4.62 %),724,2159330,2982.5,1091,2093970,1919,65360
2009-04-17,39 ( -2.99 %),621,1868200,3008.37,1178,2259790,1918,-391590
2009-04-16,40.2 ( 4.96 %),823,2430890,2953.69,666,1834860,2755,596030
2009-04-15,38.3 ( -4.01 %),848,1875060,2211.16,1085,2683520,2473,-808460
2009-04-14,39.9 ( 2.31 %),1095,3057970,2792.67,852,2458900,2886,599070
2009-04-13,39 ( 4.84 %),377,1226340,3252.89,104,151470,1456,1074870
2009-04-10,37.2 ( 4.79 %),385,1883740,4892.83,119,195030,1639,1688710
2009-04-09,35.5 ( 0 %),887,1707230,1924.72,675,1896460,2810,-189230
2009-04-08,35.5 ( -4.31 %),1077,1731590,1607.79,967,2349530,2430,-617940
2009-04-07,37.1 ( 4.8 %),789,2071540,2625.53,626,1446300,2310,625240
2009-04-03,35.4 ( 4.73 %),411,1078440,2623.94,273,537550,1969,540890
2009-04-02,33.8 ( 4.97 %),541,1523320,2815.75,599,1297740,2167,225580
2009-04-01,32.2 ( 4.89 %),618,1290050,2087.46,397,1111100,2799,178950
2009-03-31,30.7 ( -1.29 %),506,1218490,2408.08,450,1030500,2290,187990
2009-03-30,31.1 ( -2.81 %),540,1008990,1868.5,528,898450,1702,110540
2009-03-27,32 ( 1.27 %),659,1962050,2977.31,808,1760850,2179,201200
2009-03-26,31.6 ( 4.98 %),592,1846590,3119.24,410,1000260,2440,846330
2009-03-25,30.1 ( 4.88 %),756,2658130,3516.04,879,1890220,2150,767910
2009-03-24,28.7 ( 4.74 %),409,1705790,4170.64,165,534140,3237,1171650
2009-03-23,27.4 ( -0.36 %),311,815200,2621.22,333,707170,2124,108030
2009-03-20,27.5 ( -1.08 %),318,529740,1665.85,295,567320,1923,-37580
2009-03-19,27.8 ( -4.79 %),446,934540,2095.38,584,1191470,2040,-256930
2009-03-18,29.2 ( 2.82 %),512,967960,1890.55,435,1370750,3151,-402790
2009-03-17,28.4 ( 4.41 %),524,1249360,2384.27,468,1121690,2397,127670
2009-03-16,27.2 ( 3.82 %),418,809220,1935.93,302,710620,2353,98600
2009-03-13,26.2 ( -0.76 %),202,257270,1273.61,185,407750,2204,-150480
2009-03-12,26.4 ( -3.65 %),231,484250,2096.32,349,623260,1786,-139010
2009-03-11,27.4 ( 4.18 %),334,659500,1974.55,304,650200,2139,9300
2009-03-10,26.3 ( 3.54 %),390,775620,1988.77,364,767030,2107,8590
2009-03-09,25.4 ( -0.39 %),268,476180,1776.79,135,319980,2370,156200
2009-03-06,25.5 ( 0 %),222,405080,1824.68,155,198520,1281,206560
2009-03-05,25.5 ( 2.41 %),195,389490,1997.38,278,395690,1423,-6200
2009-03-04,24.9 ( 0.81 %),197,289880,1471.47,109,153410,1407,136470
2009-03-03,24.7 ( -3.14 %),293,340560,1162.32,137,208330,1521,132230
2009-03-02,25.5 ( 0 %),180,255890,1421.61,172,199350,1159,56540
2009-02-27,25.5 ( 2 %),231,313470,1357.01,168,271270,1615,42200
2009-02-26,25 ( -1.96 %),208,272780,1311.44,239,473490,1981,-200710
2009-02-25,25.5 ( 4.94 %),335,659790,1969.52,169,460150,2723,199640
2009-02-24,24.3 ( -4.71 %),178,263830,1482.19,167,361260,2163,-97430
2009-02-23,25.5 ( -4.85 %),215,339540,1579.26,247,525360,2127,-185820
2009-02-20,26.8 ( -1.11 %),213,272470,1279.2,114,161110,1413,111360
2009-02-19,27.1 ( 1.12 %),230,446440,1941.04,246,416340,1692,30100
2009-02-18,26.8 ( -3.25 %),325,628150,1932.77,256,399320,1560,228830
2009-02-17,27.7 ( -4.15 %),347,595540,1716.25,245,592520,2418,3020
2009-02-16,28.9 ( -2.03 %),187,376430,2012.99,174,270900,1557,105530
2009-02-13,29.5 ( -0.67 %),145,151560,1045.24,179,269700,1507,-118140
2009-02-12,29.7 ( 0 %),162,195390,1206.11,200,230780,1154,-35390
2009-02-11,29.7 ( -0.67 %),271,453380,1672.99,263,280710,1067,172670
2009-02-10,29.9 ( 2.75 %),425,769180,1809.84,497,618970,1245,150210
2009-02-09,29.1 ( 4.68 %),311,735850,2366.08,155,341490,2203,394360
2009-02-06,27.8 ( 1.83 %),252,452900,1797.22,156,364190,2335,88710
2009-02-05,27.3 ( -3.87 %),203,370530,1825.27,193,417920,2165,-47390
2009-02-04,28.4 ( -3.4 %),301,431030,1431.99,150,455100,3034,-24070
2009-02-03,29.4 ( -2 %),161,324220,2013.79,173,276300,1597,47920
2009-02-02,30 ( -2.6 %),92,229620,2495.87,117,235890,2016,-6270
2009-01-23,30.8 ( 0.98 %),132,207100,1568.94,78,68160,874,138940
2009-01-22,30.5 ( 1.33 %),115,220520,1917.57,87,72290,831,148230
2009-01-21,30.1 ( -1.63 %),125,268400,2147.2,77,184130,2391,84270
2009-01-20,30.6 ( -0.33 %),111,262320,2363.24,120,197830,1649,64490
2009-01-19,30.7 ( -1.29 %),136,234260,1722.5,163,312020,1914,-77760
2009-01-16,31.1 ( -0.32 %),126,232300,1843.65,156,291990,1872,-59690
2009-01-15,31.2 ( -0.32 %),111,227180,2046.67,205,211220,1030,15960
2009-01-14,31.3 ( 0 %),185,446010,2410.86,232,437390,1885,8620
2009-01-13,31.3 ( -1.57 %),195,378170,1939.33,296,409750,1384,-31580
2009-01-12,31.8 ( 0 %),167,363510,2176.71,194,355500,1832,8010
2009-01-09,31.8 ( 0.32 %),253,721420,2851.46,268,552910,2063,168510
2009-01-08,31.7 ( -1.55 %),276,839930,3043.22,404,664630,1645,175300
2009-01-07,32.2 ( 3.21 %),269,1023170,3803.61,540,910980,1687,112190
2009-01-06,31.2 ( 1.63 %),213,542610,2547.46,220,463990,2109,78620
2009-01-05,30.7 ( -0.97 %),266,450340,1693.01,161,426100,2647,24240
2009-01-02,31 ( -1.59 %),196,230840,1177.76,173,306710,1773,-75870
2008-12-31,31.5 ( -1.56 %),285,539280,1892.21,430,828440,1927,-289160
2008-12-30,32 ( 3.23 %),296,957700,3235.47,498,830790,1668,126910
2008-12-29,31 ( 0 %),195,348020,1784.72,323,376640,1166,-28620
2008-12-26,31 ( 1.31 %),269,544140,2022.83,359,483500,1347,60640
2008-12-25,30.6 ( 0.33 %),260,333050,1280.96,271,409530,1511,-76480
2008-12-24,30.5 ( 0 %),302,582580,1929.07,181,392550,2169,190030
2008-12-23,30.5 ( -2.24 %),324,781740,2412.78,415,657510,1584,124230
2008-12-22,31.2 ( 3.31 %),318,619300,1947.48,427,701840,1644,-82540
2008-12-19,30.2 ( 0 %),378,804710,2128.86,373,758840,2034,45870
2008-12-18,30.2 ( 1 %),228,381410,1672.85,405,549710,1357,-168300
2008-12-17,29.9 ( 3.46 %),307,654830,2133,320,505570,1580,149260
2008-12-16,28.9 ( -4.93 %),201,296450,1474.88,408,623900,1529,-327450
2008-12-15,30.4 ( 4.83 %),361,694770,1924.57,274,482360,1760,212410
2008-12-12,29 ( 4.69 %),346,845570,2443.84,242,530470,2192,315100
2008-12-11,27.7 ( 1.84 %),268,374540,1397.54,193,232180,1203,142360
2008-12-10,27.2 ( -2.16 %),174,266680,1532.64,213,285320,1340,-18640
2008-12-09,27.8 ( 3.35 %),265,545710,2059.28,297,504430,1698,41280
2008-12-08,26.9 ( -4.95 %),261,448660,1719,310,588930,1900,-140270
2008-12-05,28.3 ( -2.75 %),372,452620,1216.72,248,443790,1789,8830
2008-12-04,30.1 ( 0.67 %),297,467230,1573.16,276,462940,1677,4290
2008-12-03,29.9 ( 0.34 %),229,296990,1296.9,205,282960,1380,14030
2008-12-02,29.8 ( -1.97 %),226,329560,1458.23,188,208020,1106,121540
2008-12-01,30.4 ( 0 %),353,525080,1487.48,299,488030,1632,37050
2008-11-28,30.4 ( 4.83 %),661,1095670,1657.59,201,629000,3129,466670
2008-11-27,29 ( -4.29 %),378,794130,2100.87,292,890640,3050,-96510
2008-11-26,30.3 ( -2.26 %),240,551230,2296.79,471,720350,1529,-169120
2008-11-25,31 ( 2.65 %),227,613990,2704.8,376,511500,1360,102490
2008-11-24,30.2 ( 1 %),275,580790,2111.96,403,703520,1746,-122730
2008-11-21,29.9 ( -0.66 %),637,1085950,1704.79,303,547990,1809,537960
2008-11-20,30.1 ( -4.75 %),636,852790,1340.86,329,1181530,3591,-328740
2008-11-19,31.6 ( -0.32 %),418,469660,1123.59,235,394610,1679,75050
2008-11-18,31.7 ( -3.06 %),498,808210,1622.91,276,492930,1786,315280
2008-11-17,32.7 ( -1.51 %),221,492130,2226.83,322,398370,1237,93760
2008-11-14,33.2 ( 2.15 %),348,584470,1679.51,409,621000,1518,-36530
2008-11-13,32.5 ( 1.56 %),858,1182520,1378.23,273,520330,1906,662190
2008-11-12,32 ( -4.19 %),509,860500,1690.57,429,828680,1932,31820
2008-11-11,33.4 ( -4.84 %),309,425100,1375.73,440,657810,1495,-232710
2008-11-10,35.1 ( 0.29 %),477,883110,1851.38,553,989870,1790,-106760
2008-11-07,35 ( -4.89 %),525,1304420,2484.61,1041,1560690,1499,-256270
2008-11-06,36.8 ( 3.66 %),924,2530210,2738.32,1331,2024360,1521,505850
2008-11-05,35.5 ( 4.72 %),746,2295630,3077.25,75,108120,1442,2187510
2008-11-04,33.9 ( 4.95 %),785,1563910,1992.24,367,521720,1422,1042190
2008-11-03,32.3 ( -0.62 %),922,1445710,1568.02,401,1119330,2791,326380
2008-10-31,32.5 ( 4.84 %),1395,2002700,1435.63,427,1047520,2453,955180
2008-10-30,31 ( -4.91 %),870,1087180,1249.63,382,1404230,3676,-317050
2008-10-29,32.6 ( 0 %),1315,1614490,1227.75,546,1664290,3048,-49800
2008-10-28,32.6 ( -4.96 %),776,1436890,1851.66,615,2228050,3623,-791160
2008-10-27,34.3 ( -4.99 %),161,164610,1022.42,474,1207020,2546,-1042410
2008-10-24,36.1 ( -5 %),456,439610,964.06,368,780860,2122,-341250
2008-10-23,38 ( -4.76 %),356,297700,836.24,440,661780,1504,-364080
2008-10-22,39.9 ( -3.86 %),581,729840,1256.18,311,579560,1864,150280
2008-10-21,41.5 ( 2.98 %),547,686930,1255.81,360,800600,2224,-113670
2008-10-20,40.3 ( -3.36 %),463,591230,1276.95,377,698460,1853,-107230
2008-10-17,41.7 ( 0.48 %),715,745500,1042.66,504,993640,1972,-248140
2008-10-16,41.5 ( -3.04 %),625,752510,1204.02,544,850520,1563,-98010
2008-10-15,42.8 ( 4.9 %),1138,1698150,1492.22,513,1301700,2537,396450
2008-10-14,40.8 ( 4.88 %),1207,2898300,2401.24,15,60510,4034,2837790
2008-10-13,38.9 ( -4.89 %),699,1063020,1520.77,712,1268310,1781,-205290
2008-10-10,40.9 ( -4.88 %),276,140250,508.15,581,1557410,2681,-1417160
2008-10-09,43 ( -4.87 %),1008,1433430,1422.05,821,1829220,2228,-395790
2008-10-08,45.2 ( -4.84 %),409,515490,1260.37,606,2271260,3748,-1755770
2008-10-07,47.5 ( -4.52 %),261,341910,1310,624,1709410,2739,-1367500
2008-10-06,49.9 ( -4.86 %),653,709650,1086.75,494,1221780,2473,-512130
2008-10-03,52.5 ( -2.78 %),1220,1582190,1296.88,394,1295630,3288,286560
2008-10-02,54 ( 0 %),1587,2075410,1307.76,394,1415640,3593,659770
2008-10-01,54 ( -3.57 %),1383,1933010,1397.69,576,2338690,4060,-405680
2008-09-30,56 ( -4.27 %),74,33240,449.19,1593,4642860,2915,-4609620
2008-09-29,58.5 ( -4.1 %),686,1643750,2396.14,990,3014510,3045,-1370760
2008-09-26,61 ( 3.39 %),707,2674960,3783.54,666,2490880,3740,184080
2008-09-25,59 ( 4.42 %),689,2005460,2910.68,537,1691250,3149,314210
2008-09-24,56.5 ( -3.42 %),602,1082250,1797.76,558,1344890,2410,-262640
2008-09-23,58.5 ( 1.74 %),1456,3127840,2148.24,1069,3246620,3037,-118780
2008-09-22,57.5 ( 4.55 %),1476,4561930,3090.74,20,8480,424,4553450
2008-09-19,55 ( 4.86 %),1338,3208910,2398.29,147,392460,2670,2816450
2008-09-18,52.5 ( -4.55 %),289,598990,2072.63,598,1498160,2505,-899170
2008-09-17,55 ( -3.51 %),908,1483270,1633.56,634,1253640,1977,229630
2008-09-16,57 ( -4.2 %),853,1118480,1311.23,925,1850520,2001,-732040
2008-09-15,59.5 ( 4.39 %),684,1590860,2325.82,598,783200,1310,807660
2008-09-12,57 ( -4.2 %),833,1468370,1762.75,840,2005580,2388,-537210
2008-09-11,59.5 ( -0.83 %),721,1609210,2231.91,604,956860,1584,652350
2008-09-10,61 ( -3.17 %),757,1231710,1627.09,580,905180,1561,326530
2008-09-09,63 ( 1.61 %),1077,1169180,1085.59,542,1088280,2008,80900
2008-09-08,62 ( -1.59 %),896,1503000,1677.46,814,1344000,1651,159000
2008-09-05,63 ( -4.55 %),906,1084670,1197.21,726,1491790,2055,-407120
2008-09-04,66 ( -2.22 %),850,1217290,1432.11,853,1683360,1973,-466070
2008-09-03,67.5 ( 4.65 %),1429,2155540,1508.43,385,1248270,3242,907270
2008-08-29,64.5 ( -4.44 %),536,1595250,2976.21,1519,2888810,1902,-1293560
2008-08-28,67.5 ( -4.93 %),185,282930,1529.35,1550,3081350,1988,-2798420
2008-08-27,71 ( -4.7 %),1805,2255680,1249.68,1821,4895650,2688,-2639970
2008-08-26,74.5 ( -3.25 %),1659,1812710,1092.65,1473,3585090,2434,-1772380
2008-08-25,77 ( 4.05 %),1781,2661040,1494.13,1248,2512020,2013,149020
2008-08-22,74 ( -4.52 %),1020,857910,841.09,1252,3069410,2452,-2211500
2008-08-21,77.5 ( 4.03 %),1540,3232050,2098.73,913,2450410,2684,781640
2008-08-20,74.5 ( 3.47 %),1557,2417510,1552.67,797,1932230,2424,485280
2008-08-19,72 ( 4.35 %),918,2759940,3006.47,795,2509160,3156,250780
2008-08-18,69 ( 4.55 %),1154,2285870,1980.82,341,1358890,3985,926980
2008-08-15,66 ( 2.33 %),907,2052390,2262.83,66,439890,6665,1612500
2008-08-14,64.5 ( 2.38 %),895,2280910,2548.5,288,1108450,3849,1172460
2008-08-13,63 ( 2.44 %),1258,2089520,1660.99,715,1776950,2485,312570
2008-08-12,61.5 ( 2.5 %),873,1682410,1927.16,468,1229320,2627,453090
2008-08-11,60 ( 2.56 %),905,2267810,2505.87,430,1244650,2895,1023160
2008-08-08,58.5 ( 2.63 %),979,2554630,2609.43,832,2193890,2637,360740
2008-08-07,57 ( 1.79 %),887,1674840,1888.21,277,1450540,5237,224300
2008-08-06,56 ( 2.75 %),775,1876910,2421.82,123,465350,3783,1411560
2008-08-05,54.5 ( -1.8 %),938,1719260,1832.9,893,1805090,2021,-85830
2008-08-04,55.5 ( -1.77 %),1999,3896240,1949.09,1394,3714840,2665,181400
2008-08-01,56.5 ( 2.73 %),848,2882070,3398.67,58,208390,3593,2673680
2008-07-31,55 ( 2.8 %),813,2800730,3444.93,118,287780,2439,2512950
2008-07-30,53.5 ( 2.88 %),1030,3579980,3475.71,105,170770,1626,3409210
2008-07-29,52 ( 2.97 %),1281,4972310,3881.58,18,12930,718,4959380
2008-07-28,50.5 ( 2.23 %),880,3199380,3635.66,22,88300,4014,3111080
2008-07-25,49.4 ( 2.92 %),1069,1992690,1864.07,324,778910,2404,1213780
2008-07-24,48 ( -2.04 %),1519,3076780,2025.53,686,2088150,3044,988630
2008-07-23,49 ( -2.97 %),65,129160,1987.08,777,2485680,3199,-2356520
2008-07-22,50.5 ( -2.88 %),31,110610,3568.06,1066,3358100,3150,-3247490
2008-07-21,52 ( -2.8 %),449,974650,2170.71,752,1892870,2517,-918220
2008-07-18,53.5 ( 2.88 %),921,2500890,2715.41,347,1916440,5523,584450
2008-07-17,52 ( 2.97 %),1022,3636720,3558.43,19,55510,2922,3581210
2008-07-16,50.5 ( 2.02 %),1246,3965910,3182.91,348,2030700,5835,1935210
2008-07-15,49.5 ( 2.91 %),1382,3336200,2414.04,26,242300,9319,3093900
2008-07-14,48.1 ( 3 %),1314,3127600,2380.21,36,306700,8519,2820900
2008-07-11,46.7 ( 2.98 %),1257,3605780,2868.56,82,1049900,12804,2555880
2008-07-10,63.5 ( 2.42 %),550,737980,1341.78,119,604480,5080,133500
2008-07-09,62 ( 2.48 %),487,704950,1447.54,91,579310,6366,125640
2008-07-08,60.5 ( 2.54 %),447,792150,1772.15,286,650540,2275,141610
2008-07-07,59 ( 2.61 %),562,972690,1730.77,271,864490,3190,108200
2008-07-04,57.5 ( 2.68 %),395,1247540,3158.33,38,148900,3918,1098640
2008-07-03,56 ( 2.75 %),315,1227960,3898.29,14,13250,946,1214710
2008-07-02,54.5 ( 2.83 %),260,789050,3034.81,19,34980,1841,754070
2008-07-01,53 ( 2.91 %),300,628960,2096.53,11,19840,1804,609120
2008-06-30,51.5 ( 3 %),195,490010,2512.87,11,3590,326,486420
2008-06-27,50 ( 2.25 %),327,622950,1905.05,138,234710,1701,388240
2008-06-26,48.9 ( 2.95 %),257,669010,2603.15,233,428850,1841,240160
2008-06-25,47.5 ( 2.81 %),199,920960,4627.94,24,128600,5358,792360
2008-06-24,46.2 ( 2.9 %),164,371310,2264.09,20,173310,8666,198000
2008-06-23,44.9 ( 2.98 %),119,284340,2389.41,55,145430,2644,138910
2008-06-20,43.6 ( -2.9 %),86,119010,1383.84,89,165580,1860,-46570
2008-06-19,44.9 ( -2.81 %),86,255790,2974.3,191,385600,2019,-129810
2008-06-18,46.2 ( -1.91 %),239,726080,3037.99,311,571710,1838,154370
2008-06-17,47.1 ( 1.95 %),309,937590,3034.27,9,14950,1661,922640
2008-06-16,46.2 ( 1.99 %),225,754640,3353.96,10,23850,2385,730790
2008-06-13,45.3 ( 1.8 %),235,552430,2350.77,30,156960,5232,395470
2008-06-12,44.5 ( 1.83 %),227,364540,1605.9,72,164890,2290,199650
2008-06-11,43.7 ( -1.8 %),128,323680,2528.75,118,334390,2834,-10710
2008-06-10,44.5 ( -1.98 %),7,1010,144.29,106,317010,2991,-316000
2008-06-09,45.4 ( -1.94 %),8,10500,1312.5,121,346950,2867,-336450
2008-06-06,46.3 ( -1.91 %),7,17320,2474.29,131,370000,2824,-352680
2008-06-05,47.2 ( -1.87 %),3,7550,2516.67,149,385430,2587,-377880
2008-06-04,48.1 ( -1.84 %),3,15600,5200,166,373700,2251,-358100
2008-06-03,49 ( -2 %),3,3840,1280,155,335270,2163,-331430
2008-06-02,50 ( -1.96 %),6,2200,366.67,148,315510,2132,-313310
2008-05-30,51 ( -1.92 %),13,5480,421.54,133,304610,2290,-299130
2008-05-29,52 ( 0 %),0,0,0,0,0,0,0
2008-05-28,52 ( 0 %),0,0,0,0,0,0,0
2008-05-27,52 ( 0 %),0,0,0,0,0,0,0
2008-05-26,52 ( -1.89 %),6,9280,1546.67,173,329160,1903,-319880
2008-05-23,53 ( -1.85 %),24,202170,8423.75,227,524760,2312,-322590
2008-05-22,54 ( -1.82 %),8,69270,8658.75,239,555520,2324,-486250
2008-05-21,55 ( -1.79 %),16,103620,6476.25,170,303330,1784,-199710
2008-05-20,56 ( -1.75 %),17,8540,502.35,119,183540,1542,-175000
2008-05-19,57 ( -1.72 %),74,208380,2815.95,143,306650,2144,-98270
2008-05-16,58 ( -1.69 %),203,414120,2040,223,501500,2249,-87380
2008-05-15,59 ( -1.67 %),8,9580,1197.5,207,568120,2745,-558540
2008-05-14,60 ( -1.64 %),13,88220,6786.15,246,557370,2266,-469150
2008-05-13,61 ( -1.61 %),5,770,154,268,580950,2168,-580180
2008-05-12,62 ( -1.59 %),7,26200,3742.86,246,498520,2027,-472320
2008-05-09,63 ( -1.56 %),20,22500,1125,211,525080,2489,-502580
2008-05-08,64 ( -1.54 %),22,154750,7034.09,179,526860,2943,-372110
2008-05-07,65 ( 0 %),112,393010,3509.02,320,531980,1662,-138970
2008-05-06,65 ( 1.56 %),187,479910,2566.36,219,336020,1534,143890
2008-05-05,64 ( 1.59 %),197,547780,2780.61,93,228270,2455,319510
2008-04-29,63 ( 1.61 %),238,624870,2625.5,82,237360,2895,387510
2008-04-28,62 ( 1.64 %),170,567100,3335.88,56,170340,3042,396760
2008-04-25,61 ( -1.61 %),131,227350,1735.5,175,314650,1798,-87300
2008-04-24,62 ( -1.59 %),70,138950,1985,227,449660,1981,-310710
2008-04-23,63 ( -1.56 %),16,38940,2433.75,233,371570,1595,-332630
2008-04-22,64 ( -1.54 %),25,54010,2160.4,128,194310,1518,-140300
2008-04-21,65 ( -1.52 %),27,47050,1742.59,84,181520,2161,-134470
2008-04-18,66 ( -1.49 %),107,165550,1547.2,175,332550,1900,-167000
2008-04-17,67 ( 0.75 %),231,373860,1618.44,189,535010,2831,-161150
2008-04-16,66.5 ( -1.48 %),14,22380,1598.57,202,513300,2541,-490920
2008-04-11,67.5 ( -1.46 %),16,9750,609.38,239,694240,2905,-684490
2008-04-10,68.5 ( -1.44 %),24,70310,2929.58,246,585970,2382,-515660
2008-04-09,69.5 ( -1.42 %),191,294700,1542.93,209,478110,2288,-183410
2008-04-08,70.5 ( 1.44 %),381,1170890,3073.2,289,688200,2381,482690
2008-04-07,69.5 ( 1.46 %),322,1140250,3541.15,6,3280,547,1136970
2008-04-04,68.5 ( 0.74 %),406,1302750,3208.74,3,50,17,1302700
2008-04-03,68 ( 0.74 %),427,1554660,3640.89,8,70110,8764,1484550
2008-04-02,67.5 ( 0.75 %),371,1512890,4077.87,8,58210,7276,1454680
2008-04-01,67 ( 0.75 %),300,1207320,4024.4,7,13020,1860,1194300
2008-03-31,66.5 ( 0.76 %),271,945610,3489.34,9,78650,8739,866960
2008-03-28,66 ( 0.76 %),326,1022530,3136.6,15,138690,9246,883840
2008-03-27,65.5 ( 0.77 %),198,499380,2522.12,24,179300,7471,320080
2008-03-26,65 ( 3.17 %),395,864350,2188.23,199,438080,2201,426270
2008-03-25,63 ( -4.55 %),48,38680,805.83,208,294800,1417,-256120
2008-03-24,66 ( -4.35 %),67,114000,1701.49,163,398740,2446,-284740
2008-03-21,69 ( -4.83 %),285,314580,1103.79,182,437090,2402,-122510
2008-03-20,72.5 ( -1.36 %),424,500930,1181.44,113,296190,2621,204740
2008-03-19,73.5 ( 0 %),276,365470,1324.17,193,280030,1451,85440
2008-03-18,73.5 ( -4.55 %),213,293180,1376.43,221,325160,1471,-31980
2008-03-17,77 ( -4.94 %),193,139170,721.09,180,495140,2751,-355970
2008-03-14,81 ( -1.82 %),211,187820,890.14,146,273350,1872,-85530
2008-03-13,82.5 ( 0.61 %),235,248390,1056.98,166,362500,2184,-114110
2008-03-12,82 ( 1.86 %),256,431540,1685.7,227,456930,2013,-25390
2008-03-11,80.5 ( -0.62 %),201,298460,1484.88,404,550660,1363,-252200
2008-03-10,81 ( 4.52 %),538,859860,1598.25,173,420740,2432,439120
2008-03-07,77.5 ( 4.73 %),802,1553300,1936.78,46,428080,9306,1125220
2008-03-06,74 ( 4.96 %),381,859520,2255.96,17,25170,1481,834350
2008-03-05,70.5 ( -3.42 %),157,364910,2324.27,244,332750,1364,32160
2008-03-04,73 ( -4.58 %),59,107190,1816.78,225,360900,1604,-253710
2008-03-03,76.5 ( -4.97 %),132,202220,1531.97,201,375870,1870,-173650
2008-02-29,80.5 ( -2.42 %),169,227220,1344.5,147,240960,1639,-13740
2008-02-28,82.5 ( -0.6 %),130,160480,1234.46,114,132450,1162,28030
2008-02-27,83 ( 1.22 %),148,290930,1965.74,130,135740,1044,155190
2008-02-26,82 ( -3.53 %),172,341810,1987.27,308,435020,1412,-93210
2008-02-25,85 ( 4.94 %),252,477270,1893.93,79,237020,3000,240250
2008-02-22,81 ( -3.57 %),252,389640,1546.19,204,306280,1501,83360
2008-02-21,84 ( -4.55 %),97,62400,643.3,124,258620,2086,-196220
2008-02-20,88 ( -4.86 %),187,112830,603.37,155,236900,1528,-124070
2008-02-19,92.5 ( -0.54 %),293,214860,733.31,76,147800,1945,67060
2008-02-18,93 ( -4.12 %),333,259140,778.2,120,297700,2481,-38560
2008-02-15,97 ( -0.51 %),143,231320,1617.62,212,356720,1683,-125400
2008-02-14,97.5 ( 0.52 %),173,291120,1682.77,110,196060,1782,95060
2008-02-13,97 ( -3 %),131,175660,1340.92,175,318440,1820,-142780
2008-02-12,100 ( -0.99 %),112,125100,1116.96,174,222540,1279,-97440
2008-02-01,101 ( 3.06 %),189,256720,1358.31,235,338200,1439,-81480
2008-01-31,98 ( -2 %),218,171730,787.75,184,254040,1381,-82310
2008-01-30,100 ( 4.71 %),363,510680,1406.83,118,362700,3074,147980
2008-01-29,95.5 ( 2.14 %),215,207880,966.88,136,189750,1395,18130
2008-01-28,93.5 ( 0.54 %),128,94800,740.62,106,117900,1112,-23100
2008-01-25,93 ( 0 %),196,184670,942.19,89,129680,1457,54990
2008-01-24,93 ( 0.54 %),144,144980,1006.81,182,238350,1310,-93370
2008-01-23,92.5 ( -4.64 %),201,151700,754.73,178,207990,1168,-56290
2008-01-22,97 ( -3 %),263,243240,924.87,132,157330,1192,85910
2008-01-21,100 ( -1.96 %),146,125320,858.36,125,150290,1202,-24970
2008-01-18,102 ( 2 %),251,365090,1454.54,132,206490,1564,158600
2008-01-17,100 ( -4.76 %),180,185630,1031.28,300,574660,1916,-389030
2008-01-16,105 ( 3.96 %),353,587190,1663.43,218,621060,2849,-33870
2008-01-15,101 ( -4.72 %),113,306310,2710.71,406,702120,1729,-395810
2008-02-19,92.5 ( -0.54 %),293,214860,733.31,76,147800,1945,67060
2008-02-18,93 ( -4.12 %),333,259140,778.2,120,297700,2481,-38560
2008-02-15,97 ( -0.51 %),143,231320,1617.62,212,356720,1683,-125400
2008-02-14,97.5 ( 0.52 %),173,291120,1682.77,110,196060,1782,95060
2008-02-13,97 ( -3 %),131,175660,1340.92,175,318440,1820,-142780
2008-02-12,100 ( -0.99 %),112,125100,1116.96,174,222540,1279,-97440
2008-02-01,101 ( 3.06 %),189,256720,1358.31,235,338200,1439,-81480
2008-01-31,98 ( -2 %),218,171730,787.75,184,254040,1381,-82310
2008-01-30,100 ( 4.71 %),363,510680,1406.83,118,362700,3074,147980
2008-01-29,95.5 ( 2.14 %),215,207880,966.88,136,189750,1395,18130
2008-01-28,93.5 ( 0.54 %),128,94800,740.62,106,117900,1112,-23100
2008-01-25,93 ( 0 %),196,184670,942.19,89,129680,1457,54990
2008-01-24,93 ( 0.54 %),144,144980,1006.81,182,238350,1310,-93370
2008-01-23,92.5 ( -4.64 %),201,151700,754.73,178,207990,1168,-56290
2008-01-22,97 ( -3 %),263,243240,924.87,132,157330,1192,85910
2008-01-21,100 ( -1.96 %),146,125320,858.36,125,150290,1202,-24970
2008-01-18,102 ( 2 %),251,365090,1454.54,132,206490,1564,158600
2008-01-17,100 ( -4.76 %),180,185630,1031.28,300,574660,1916,-389030
2008-01-16,105 ( 3.96 %),353,587190,1663.43,218,621060,2849,-33870
2008-01-15,101 ( -4.72 %),113,306310,2710.71,406,702120,1729,-395810
2007-12-13,90.5 ( -3.72 %),249,182610,733.37,162,332320,2051,-149710
2007-12-12,94 ( 1.08 %),461,486410,1055.12,172,412950,2401,73460
2007-12-11,93 ( -4.62 %),361,211120,584.82,128,265010,2070,-53890
2007-12-10,97.5 ( -4.41 %),367,204190,556.38,106,237570,2241,-33380
2007-12-07,102 ( -2.86 %),250,176820,707.28,114,255910,2245,-79090
2007-12-06,105 ( 0.96 %),217,186390,858.94,144,207070,1438,-20680
2007-12-05,104 ( -0.95 %),192,137060,713.85,110,160150,1456,-23090
2007-12-04,105 ( -0.94 %),249,166680,669.4,141,197040,1397,-30360
2007-12-03,106 ( 0 %),226,134200,593.81,123,175550,1427,-41350
2007-11-30,106 ( -0.93 %),245,188490,769.35,129,208560,1617,-20070
2007-11-29,107 ( 0 %),211,200840,951.85,139,270950,1949,-70110
2007-11-28,107 ( 1.9 %),312,292080,936.15,136,209270,1539,82810
2007-11-27,105 ( -3.67 %),577,321170,556.62,194,443350,2285,-122180
2007-11-26,109 ( -0.91 %),377,251380,666.79,120,210290,1752,41090
2007-11-23,110 ( -3.51 %),291,188900,649.14,176,314060,1784,-125160
2007-11-22,114 ( 0 %),353,445410,1261.78,255,454980,1784,-9570
2007-11-21,114 ( 3.64 %),353,445410,1261.78,255,454980,1784,-9570
2007-11-20,110 ( -4.35 %),108,58710,543.61,329,937040,2848,-878330
2007-11-19,115 ( -4.96 %),120,120480,1004,351,930730,2652,-810250
2007-11-16,121 ( -4.72 %),330,248510,753.06,434,928450,2139,-679940
2007-11-15,127 ( 0 %),1201,1698140,1413.94,932,2214710,2376,-516570
